uid,name,friends_count,followers_count,listed_count,statuses_count,pff,pfr,gcf,gcr,description,tweets,total_fake,total_real,net_trust,total_news,fake_prob,net_trust_norm,fake
1172796973,PTorresTV,548,1117,25,12136,0,0,23,2851,i cover et lifestyle music sports accesototalaz earned emmy awards counting my work,"chris pratt files divorce from anna faris^the story oprah winfrey her rock stedman graham other great love her life^josh duhamel fergie relationship best place after split^kourtney kardashian sofia richie other celebs attend malibu chili cook off^inside kylie jenner travis scott relationship a timeline their romance^mel b under investigation witness intimidation divorce drama continues^brad pitt quitting drinking divorcing angelina jolie fighting his kids there no love without loss^daytime emmy awards winners the complete list^brad pitt gave angelina jolie heads up about gq interview is committed having healthy relationship^kourtney kardashian sofia richie other celebs attend malibu chili cook off^katy perry compliments taylor swift american idol but was it actually shade^inside kylie jenner travis scott relationship a timeline their romance^kim kardashian responds claims she was ''attacked '' los angeles ''such weird rumors ''^christina aguilera did n't quit the voice because gwen stefani^jennifer aniston is back black justin theroux the leftovers premiere^christina aguilera did n't quit the voice because gwen stefani^remember that time the arrangement josh henderson was the ashlee simpson show let him elain ...^jessica simpson ashlee simpson ross kids steal show with generations red carpet^newly single mariah carey nick cannon come together celebrate easter with their twins^kourtney kim khloe kardashian battle it out twitter after kuwtk fight^katy perry compliments taylor swift american idol but was it actually shade^brad pitt ''devastated shock '' over deaths chris cornell brad grey^kourtney kardashian tells scott disick they are never getting back together we just need move on^step inside kylie jenner private world with e new docu series life kylie^eminem escapes from asylum bloody framed music video teaser^jon snow pretends be dragon hilarious game thrones outtake^kate middleton looks gorgeous favorite lace dress kids party palace^chicago fire star dushon monique brown cause death revealed^louis tomlinson not eected be charged airport paparazzi altercation^alex rodriguez wishes jennifer lopez ''all happiness '' while celebrating birthdays bahamas^kim kardashian met gala looks through years^christina el moussa dating tv host ant anstead^see first photos serena williams alexis ohanian their wedding day^jimmy kimmel asks the bachelorette rachel lindsay juicy questions lie detector test^emily ratajkowski sebastian bear mcclard cuddle up first red carpet since wedding^the art public apology how celebrities fared after saying sorry their scandals^lady gaga dear friend sonja durham dies following cancer battle^insta beauty week yara shahidi sunrise inspired makeup^gisele b ndchen reveals she reason tom brady maintains strict diet^jade roper carly waddell have adorable bachelor baby photo shoot^cara delevingne is latest celebrity shave her head^solange gets apology after calling out evening standard magazine photoshopping her braid off cover^meet hilarious real life inspiration behind nbc great news creator tracey wigfield mom kathy^best beauty met gala selena gomez rihanna amp more^laverne cox drops ultimate orange is new black season tease just seconds^kendall jenner makes cheeky appearance coachella^real housewives atlanta kim zolciak biermann says you wo n't see kenya moore get under her skin anymore this se^why southern charm shep rose is ready settle up with new dating spinoff relationshep^giuliana rancic is returning co host e news with jason kennedy^marc anthony love life is becoming one giant mystery^jamie foxx is still not idea getting married^real housewives new jersey star dina manzo boyfriend dave cantin brutally beaten during home robbery^scorned off court athlete caught cheating scandals^orlando bloom will never live down his nude paddle boarding photos my poor son ...^it been one year since michael strahan announced he was leaving live a timeline^alex rodriguez confesses jennifer lopez is much better athlete than me^chrissy metz thanks fans after mtv amp tv awards appearance had body shamers uproar^dolly parton tells all new book shocking revelations about suicide sex so much more^very cavallari shannon coaches taylor her big uncommon james interview but will it be enough land her the^how baby no helped give tori spelling dean mcdermott new beginning^farrah abraham elains why she walked off marriage boot camp after confrontation with mom debra danielsen^teen mom briana dejesus shows off body transformation after plastic surgery^mean girls daniel franzese his fianc call off their engagement^corinne olympios is ''most likely '' heading bachelor paradise but is still going strong with her mystery man^starbucks christmas tree frappuccino sparks social media frenzy^freddie prinze jr reveals secret his successful marriage with sarah michelle gellar^channing tatum jenna dewan tatum majorly hint onstage reunion magic mike live las vegas show^exes chris evans jenny slate reunite red carpet first time after their split^this is what happens when archdiocese shows up ryan white the keepers reddit ama^the mystery is gone katy perry managed make her feud with taylor swift incredibly uninteresting^why was n't eliza dushku buffy vampire slayer reunion^the bachelorette rachel lindsay does her best whaboom impression it adorable but was she forced keep him^police obtain search warrant chris soules investigation continues^real housewives new york city luann d'agostino defends her ''tumultuous '' marriage tom d'agostino^gigi hadid lana del rey kendall jenner have all given this jacket designer their stamp approval^lisa rinna fashion line is more than trend how real housewives star found huge success qvc^death kisses riverdale stars preview road finale^adam levine jokes blake shelton has three balls gwen stefani reaction is priceless^prince remembered one year after his death usher salma hayek questlove more^john legend sings about hour long erections carpool karaoke the series^gabrielle union throws shade her ''hilarious '' online haters calling out their bad spelling^girl top round vote sweet now^katy perry releases swish swish with nicki minaj is it about taylor swift^hoda kotb celebrates daughter haley joy first kentucky derby cutest way^then now see stars first oscars vs. their looks^arrow star tyler ritter announces birth his first child^aaron hernandez fianc e shayanna jenkins hernandez tearfully breaks silence about his death^fitness guru jackie warner arrested slapped with assault dui hit run charges^bachelor paradise season casting guide who heading mexico^behind scenes lauren conrad festival fashion campaign^inside hilary duff jason walsh playful new york city reunion^beyonc turned down role beauty beast^horses sunsets white gowns galore a look kim zolciak biermann fairy tale vow renewal^marc anthony gets playful with girlfriend raffaella modugno^justin bieber got stephen baldwin permission before proposing hailey baldwin^brad pitt ''devastated shock '' over deaths chris cornell brad grey^super bowl commercials watch ads running during game^inside meghan markle new life with prince harry the honeymoon honoring princess diana plans royal bab^is harry styles dating tess ward things know about singer rumored girlfriend^a comprehensive guide throwing shade your ex told drake salty af dating life^cristiano ronaldo girlfriend georgina rodriguez shares heartfelt message days after giving birth^nikki reed may have just revealed sex her baby with ian somerhalder right before our very eyes^jimmy fallon daughters winnie frances steal show his ride opening^jurassic world fallen kingdom teaser has chris pratt running his life^watch what happens live shadiest guests revealed patti lupone vivica a fox more stars who spill tea^la toya jackson is near tears after hearing michael jackson final thoughts hollywood medium^accesototalaz rip here lies everything that so over^fixer upper star chip gaines sued former partners more than 1 million^ja rule says all fyre festival guests are safe refund forms have been sent^switched birth series finale how did it all end^the evolution jamie foxx katie holmes mysterious relationship^shaun white calms jimmy kimmel fears after discussing heart condition he baby billy share^big sean girlfriend jhene aiko finalizes divorce from dot da genius^game thrones spinoffs we 'd be happy watch^april giraffe newborn calf gets name meet tajiri^fear factor revived mtv ludacris host^you 're doing it wrong removing gel nail polish^well the keepers sure looks like it 'll be your next netflix true crime obsession^the challenge cory wharton cheyenne floyd reveal they have baby together^amber heard wears new mera costume new aquaman photos^questions about jonben t ramsey murder case we hope netflix new documentary answers^katy perry faces criticism comparing her black hair barack obama^britney spears sam asghari celebrate one year together see their cutest moments^sorry the office fans splitting up together oliver hudson is ready become jenna fischer new jim^mel b sister slams stephen belafonte you are sorry excuse man^kanye west surprises kim kardashian with clouds flowers wedding anniversary^kerry washington ashley judd mark ruffalo more stars share whywewearblack golden globes^enrique iglesias premieres steamy nsfw music video el ba o feat bad bunny^scandal end after season report^gigi hadid gets some throwback love from bella hadid rest her famous family nd birthday^josh duhamel dishes how he keeps his years long romance with fergie alive billboard music awards^izombie best brains ever we ranked every single one^hoda kotb savannah guthrie awkward throwback pic battle may be today greatest gift^lena dunham mourns sudden death her cat gia^prepare ariana grande the tonight show takeover with best her past appearances^meghan markle prince harry photographed arriving pippa middleton wedding reception^kaia gerber is '80 glam wednesday addams tom ford^is taylor swift look what you made me do secretly theme song arya stark^lauren conrad loves these 30 shorts from zara^jennifer aniston only likes justin theroux beard up point^robin wright had no fear demanding equal pay house cards^fact checking feud bette joan episode the real reason joan crawford was hospitalized recast^beauty beat songstress justine skye signature highlighter is n't your average shade^casey affleck has been ''treated abominably '' metoo era kenneth lonergan says^uh oh lana is furious with rusev before their wedding bulgaria find out why this total divas clip^american idol winner scotty mccreery cited trying carry loaded gun through airport^raven home finally has disney channel premiere date^bethenny frankel confirms she once dated alex rodriguez^ivanka trump changed her eye color no one noticed^all fashion details meghan markle christmas debut^cate blanchett confirmed star lucille ball biopic written aaron sorkin^justin timberlake shares sweet photo with jessica biel she got my back^christina aguilera shares rare glimpse into her private life new music seems closer than ever^emilio estevez may still be most profitable hollywood actor^elsa hosk takes e q just try not develop major crush^bristol palin future baby girl already has matching ensembles with big sister sailor^first look paul bettany elizabeth olsen characters kiss marvel avengers infinity war^you 're going want sneakers like sofia richie^young sheldon officially meets old sheldon cbs fall schedule^kylie jenner reveals her kim kardashian new lipstick collaboration would n't be kim collab without nudes^johnny depp was not drunk premiere despite reports^sugar bear completely loses his cool eletive filled fight with mama june daughter pumpkin^bella hadid amp emily ratajkowski are twinning cannes film festival^allow crazy ex girlfriend donna lynne champlin regale you with her stalking story^find out how old chewbacca really is new solo a star wars story trailer^kayla cox shares shocking secret with faven liuget wags miami what she told me crazy as f k^kourtney kardashian showcases hot bikini styles italy trip with younes bendjima kids^celebrity hair coloring trends try this winter^prince harry hangs out bidens barack obama invictus games^kate middleton dons fascinator she heads pippa middleton wedding with prince william^celebs ''toast for a cause '' with mo t amp chandon th golden globe awards^ashton kutcher elains his son dimitri name why wyatt might kill her brother^mama pope is no joke scandal season finale bellamy young warns^nick cannon thinks his kids will end up entertainment industry ''they love attention ''^bill cosby breaks his silence confirm he blind^our moms react ryan seacrest becoming kelly ripa new live co host^melania trump channels princess belle state dinner england^you 'll never guess how jimmy fallon looked his prom hint it awkward^why katy perry ended her feud with calvin harris^inside tristan thompson life before khloe kardashian girlfriends scandals his road nba riches^jennifer morrison leaving once upon time after season^rumer willis reveals she just celebrated six months sobriety^amber portwood wild reality tv journey from pregnant sex tape negotiations^how get rid scratches your sunglasses in easy steps^wizards waverly place star david henrie marries longtime girlfriend maria cahill^survivor zeke smith knew he could n't win after jeff varner cruelly outed him^from big black diem brown reflecting legacies fallen mtv stars^rashad jennings dancing with stars finale game face is simple all smiles^michael bubl reveals sex baby no^kristen bell performs families hurricane irma shelter helps jennifer carpenter loved ones escape storm^orlando bloom son has cutest reaction seeing pirates caribbean first time^school rock star brian falduto reflects pressure being ''young gay figurehead ''^will grace trailer reunites your favorites with musical twist^sean penn reunites with ex wife robin wright new york city^kiernan shipka is mermaid irl critics choice awards^erin andrews shares stunning photos from ''fairytale '' wedding jarret stoll^olivia palermo has warning about ugly shoes^it official jax taylor brittany cartwright are getting vanderpump rules spinoff^kendra wilkinson baskett feels blamed being alive by her mom marriage boot camp^here why today show viewers are already toasting hoda kotb big return^the return macaulay culkin putting aside his rocky relationship with fame be there paris jackson^pregnant heidi montag gushes over dad be spencer pratt says he will be ''great role model ''^javier bardem becoming pablo escobar his new film loving pablo reuniting with penelope cruz onscreen^pregnant beyonc celebrates easter with her family see how more stars are ringing holiday^eva mendes gets candid about balancing work motherhood ''nobody warns you about guilt ''^tori spelling returns social media after alleged nervous breakdown^kevin hart wife eniko parrish eecting their first child together^these met gala video portraits will take your breath away^a day life unbreakable kimmy schmidt titus andromedon kimmy schmidt amp jacqueline white^luis fonsi reveals secrets behind despacito that surprise justin bieber remix^scheana reveals email she sent mike shay after their harsh vanderpump rules reunion^heath ledger is all smiles new heartwarming footage from i am heath ledger documentary^may horoscopes big shifts new clothes ahead^ready baby wags l.a. nicole williams reveals when she plans get pregnant with her first child^inside pippa middleton beautiful traditional wedding ceremony^what happens the abbey premiere recap brandi glanville tori spelling hot hookups amp so much more watch^modern family renewed more seasons abc^irina shayk walks first red carpet since welcoming newborn daughter^emma stone andrew garfield reunite governors awards^derek jeter admits he unprepared fatherhood hannah jeter joins him jersey retirement ceremony^jessica simpson ashlee simpson ross kids steal show with generations red carpet^elizabeth smart shares first photo baby no easter sunday^meghan markle preps pippa middleton wedding with 325 facial^demario jackson calls the bachelor host chris harrison a hole^game thrones season trailer promises the great war is here^teen mom kailyn lowry talks ''emotional '' graduation her plans future^harry styles announces world tour dates^pippa middleton james matthew unforgettable wedding told superlatives^alpha male madness bob morley sam heughan the winner sounds off^emily ratajkowski little black dress is full hidden tricks^reese witherspoon holds back tears while honoring her ''idol '' goldie hawn hollywood walk fame^meghan markle spend christmas with prince harry royal family^star trek discovery first look is finally here amp it is gorgeous^how will grace said goodbye shelley morrison rosario^pregnant pippa middleton dons baby blue dress prince louis christening outfit details revealed^kylie jenner steps out with kendall jenner bella hadid celebrate travis scott birthday^nick gordon appears court after domestic violence arrest^kourtney kardashian ex scott disick celebrate son mason th birthday^nbc just ordered its first new shows season^bella hadid summertime ponytail is your next day party^kevin hart spares no eense eniko parrish lion king themed baby shower even if he ballin budget^pretty little liars stars promise completely satisfying ending series^ruby rose admits ''being mean does n't suit me '' after slamming katy perry new music^blake shelton gwen stefani cozy up during family lake trip^kim kardashian proves she daddy girl with her latest kimoji drop just time father day^irina shayk spotted public first time since baby news^the walking dead season promotes series regular^busy philipps loses it after being mistaken sarah huckabee sanders are you f king kidding me^erika jayne unicorn mirrorball trophy may be best gift she received from dancing with stars^normani kordei reveals why she opened up about cyber bullying dancing with stars it very scary thing^emmy rossum shares stunning photos from honeymoon rwanda with sam esmail^lea michele is freaking out over c line dion billboard music awards i 'm obsessed with her^see stunning vanity fair oscars after party portraits^happy days stars reunite honor erin moran^serena williams is pregnant with her first child shares photo baby bump^riverdale celebrates holidays with festive behind scenes pics^how beauty beast belle made this young girl dreams come true prepare grab some tissues^tom hanks rita wilson open up about their th wedding anniversary plans working with emma watson^kim kardashian celebrates instagram milestone with personal stories behind her most liked photos^mike the situation sorrentino sounds off his brother coming out gay i celebrated^jay z teases his :44 album with adnis^princess love pranks ray j april fool day pretending her water broke^mtv movie amp tv awards full list nominees^dance moms abby lee miller sentenced year prison^dance moms abby lee miller reveals what scares her most about year long prison sentence watch^the bachelorette luke pell holly allen break up again^tom cruise really is that bootylicious valkyrie^britney spears concert caused israel delay election^mandy moore trainer reveals how get rid weight anger^taylor swift sends fans flowers their wedding day after unknowingly playing special part proposal^snl tackles harvey weinstein sexual harassment assault scandal^alanis morissette is almost unrecognizable with short hair see her new look^teen mom star briana dejesus gives birth second child^logan huntzberger are you father matt czuchry holds answer gilmore girls mystery^this is us justin hartley marries chrishell stause^laguna beach star jason wahler wife ashley slack welcome baby girl^jennifer lawrence best blunt responses over years i 'm not going apologize^nbc delays bye bye birdie live musical event find out why^a christmas prince is basically compilation your favorite princess movies^how will mark ballas lindsey stirling top their perfect dancing with stars performance^jaden smith just brought his hair date met gala^caitlyn jenner opens up about her changed relationship with her kids^farrah who catelynn lowell teen mom og cast sound off farrah abraham^delta passenger kicked off plane using bathroom during minute tarmac delay^watch this goose attack police officer over over again^jimmy kimmel returning host oscars^eco friendly beauty products celebs are loving^pirates caribbean practical magic more leaving netflix december^broadway ruthie ann miles will return stage after her daughter death losing her unborn baby^stars who lost jobs when their roles were recast^david schwimmer wife zoe buckman are taking some time apart^ireland baldwin teases alec about his rude thoughtless little pig voicemail^nikki bella gets some important news about going wrestlemania total bellas sneak peek^will smith chops off jaden smith hair tries it on^orange is new black season just how much can happen days^all hidden met gala details you 're missing^girls series finale how did it all end^kylie jenner home is one step closer becoming farm thanks her new pet chicken^teen mom kailyn lowry steps out with new man days after revealing father her third child^french montana dragged after calling black woman dusty rusty ass hoe twitter^carrie underwood husband mike fisher shuts down split rumors^nick cannon reveals most diva thing he seen mariah carey do^kris jenner alleged stalker arrested her hidden hills home^giuliana rancic gets message her best friend christina el moussa connects with her grandma hollywood m^how chris brown went from super talented teen star one most polarizing entertainers ever^wine lovers rejoice you can now buy ros ounce bottle^will amp grace debra messing says even politicians are pitching themselves her revival^the bachelor sean catherine lowe celebrate their son first birthday^these spring sandals are under 100 just cute gigi hadid^teen mom maci bookout admits she fears ex ryan could die drug overdose^grab tissues hoda kotb makes emotional return today celebrate years with kathie lee gifford^ryan seacrest congratulates julianne hough her wedding brooks laich^celebs share photos from inside met gala^ed sheeran says beyonc changes her email address every week^tiger woods arrested dui charge florida^bachelor paradise carly waddell evan bass are eecting their first child together^uh oh nikki bella john cena wedding knowledge might be cause concern^dear white people creator elains what netflix racially charged satire is really all about^we 'll never get over uncle jesse aunt becky from full house^katy perry announces witness album tour dates^princess diana getting hbo documentary with prince harry prince william interviews^kendall jenner bardot swimsuit is high fashion water^tina knowles proves there no drama between beyonc tiffany haddish^watch jimmy fallon lin manuel miranda sing about their matching goatees^kendall kylie jenner droptwo shop their second collection now^miley cyrus thanksgiving birthday plans with liam hemsworth revealed^lea michele gets behind wheel getaway car why her new love song is one her absolute favorites^what happens the abbey cast breaks down ultimate bar do don'ts tip your f king bartenders^meet pearl mackie doctor who cool new companion^inside mel b stephen belafonte twisted divorce elosive allegations love gone wrong from start^june horoscopes it time change your circumstances your clothes^meghan markle vs. kate middleton comparing their first royal engagements^olivia palermo rocks knits like you 've never seen them before^harry potter sorcerer stone gets magical animated kindle edition^meghan markle dad suffers heart attack reportedly plans skip royal wedding amid paparazzi scandal^elle king opens up about ptsd depression battle^jennifer aniston style decoded plus more celeb uniforms^ed sheeran engaged girlfriend cherry seaborn^ed sheeran is not engaged girlfriend cherry seaborn^here where george clooney amal clooney hope raise their twins^luann de lesseps accuses russell simmons groping her^the short tragic life aaron hernandez inside violent downfall^all details inside jennifer lopez alex rodriguez met gala date night^superman back tyler hoechlin is officially returning supergirl^faven liuget husband corey is n't happy about her clothing business wags miami i need some attention too^ellen degeneres oscar selfie has officially been dethroned this tweet about chicken nuggets^c line dion perform ''my heart will go on '' billboard music awards honor titanic th anniversar^things know about lea michele fianc zandy reich^paris hilton happy it girls like kendall jenner cop her style^prepare meet eva longoria empire character she kind feels like sarah palin^unsolved the murders tupac biggie josh duhamel says show is about more than just murder cases^bella hadid just added this summer trend your shopping cart^former melrose place star antonio sabato jr. is running congress california^ben higgins amp lauren bushnell call off their engagement so which bachelor nation couples are even still together^what julianna margulies misses about the good wife alicia florrick^sofia richie gives scott disick love his th birthday during st. barth vacation^what is kevin probably saves world jason ritter answers our important questions^billboard music awards everything you did n't see on tv^why rachel lindsay was able announce she engaged before the bachelorette even started^watch demi lovato surprise these aspiring musicians with free studio time^kim kardashian learned skin care trick from kris jenner that super easy^why nick viall is rejuvenated after nearly getting eliminated from dancing with stars^serena williams admits she accidentally announced her pregnancy news social media^noah cyrus says miley cyrus has n't changed one bit ahead billboard music awards appearance^luann de lesseps reveals uneected problem she faced jail^is this new off shoulder top zoe saldana thinks so^the arrangement recap kyle west learns disturbing secret from megan morrison past^ryan lochte fianc e kayla rae reid celebrates baby shower with lavish party^world dance is here what eect jennifer lopez olympics dance^riverdale new surprising romances are coming season^why bow wow vicki gunvalson more stars got dragged their social media fails^see hollywood biggest stars their first cannes film festivals^harry styles epic carpool karaoke got romantic emotional but like cool way^here how you can score college scholarship from beyonc^met gala see all met gala arrivals^heidi montag spencer pratt are eecting here how we know baby speidi will be photo shoot sensation^law order svu renewed landmark season^the lindsey morgan says we should be very worried about raven^knives needles five figure price tags the official guide real housewives plastic surgery confessions^jimmy kimmel reveals his targets oscars and matt damon is n't alone^selena gomez meets fans children hospital orange county prom^talk shows endorsement deals dancing with stars examining shelf life olympic fame^charlie murphy dies actor comedian brother eddie murphy was^ariana grande breaks her silence following deadly manchester arena elosion^did scott disick just confirm those sofia richie dating rumors^here what chrissy teigen was doing during john legend billboard music awards performance^carrie underwood surprises mike fisher singing national anthem before his hockey playoff game^scott disick sofia richie vacation cabo together^/20 anchor elizabeth vargas announces exit from abc news^lena dunham jack antonoff break up after five years^is katy perry going be american idol judge her face says it all^watch what happens live welcomes kim kardashian west kris jenner will they plead fifth^anne with e introduces anne green gables netflix generation^did carmelo anthony impregnate another woman before la la anthony separation^nick jonas ex girlfriend delta goodrem reunite matching outfits^the grey anatomy spinoff finds its captain everything we know about still untitled shondaland series^the cw renews izombie the originals makes our dreams come true^wags miami stars ashley nicole roberts marries philip wheeler^uh oh the arrangement megan morrison is serious trouble with institute committing criminal fraud^pepsi pulls commercial starring kendall jenner amid backlash clearly we missed mark^kendra wilkinson plays video games drunk after filing divorce^jenna dewan tatum jessica alba discuss struggle being working mom^todd chrisley pays tribute savannah chrisley her boyfriend luke kennard^amanda de cadenet talks time up movement ''celebration sisterhood '' golden globes^taylor swift photographed first time months^elle king celebrates her wedding anniversary after years drama^simone biles named honorary houston texans cheerleader watch her receive legendary red boots^amanda stanton tweets about unhappy people amid robby hayes drama^savannah guthrie talks ups downs daughter vale adjusting life big sister^candace cameron bure shares update jodie sweetin since messy split she being trooper^bill pullman recites independence day speech college graduation^a group adorable toddlers just put jennifer lopez james corden dance moves test^drink it sink it celebrities weigh in new unicorn frappuccino^modern bathroom essentials upgrade your space^they dated real housewives who will shock you with their past romantic relationships^michael phelps celebrates boomer phelps first birthday with gold medal worthy bash^what do ray liotta cat nor'easter have common let unbreakable kimmy schmidt stars elain^justin bieber shows off hours tattoo work new shirtless selfie^shahs sunset mike shouhed divorce is finalized i am single^bethenny frankel says she definitely thinking about getting back dating game^justin bieber remixes luis fonsi amp daddy yankee despacito it amazing^miley cyrus pens sweet message liam hemsworth their dog dora^kylie jenner not average naked dress is turning heads met gala^twin peaks who who what heck just happened parts^so long krystal arie luyendyk jr. elains why he sent the bachelor most polarizing contestant home^beyonc enjoys bora bora babymoon with jay z inside their private island getaway^demi lovato calls time editors hypocrites honoring donald trump alongside metoo women^best dressed mtv movie amp tv awards hailee steinfeld zendaya amp more^spencer pratt heidi montag ring their th wedding anniversary while preparing baby^snooki responds mommy shamers i 'm damn good mom^the story oprah winfrey her rock stedman graham other great love her life^prince deliverance ep removed from itunes streaming services^celebrity wedding trends try^danica patrick best espys hosting moments^e announces new series wags atlanta find out when you can watch^lin manuel miranda has celebrities singing hamilton cause^things know about pippa middleton fianc james matthews^how work out eat like shakira according her trainer anna kaiser^american idol officially returning abc season^nicki minaj is so freaking happy met gala it has nothing do with fashion^johnny depp wins small victory lawsuit against business managers^fixer upper chip gaines addresses rumors he joanna gaines are divorcing^chris pratt returns with what my snack this time he rapping^allison williams end girls how do you say goodbye something like that^dwayne ''the rock '' johnson admits he seriously considering run president^april giraffe calf still needs name top revealed^american vandal creators reveal how they convinced netflix let them satirize their greatest true crime hits^lifetime create tv movie about prince harry meghan markle royal romance^how met gala became hollywood couples official event go public red carpet^hilary duff adopts adorable new dog she needs your help naming him^stylish eco friendly labels that do good^katy perry gets basted kneaded served skin baring slightly creepy ''bon app tit '' music video^whirlwind romances crushing heartbreak inside jennie garth struggle find love^kate middleton shows baby bump flowing dress bafta film awards^tiger woods life has n't been same since his cheating scandal all highs amp lows leading up his dui arres^why unbreakable kimmy schmidt acknowledged sexual assault season^what starring star wars the last jedi means kelly marie tran^janet jackson goes shopping spree after confirming her separation^melania trump stuns yellow dior gown her donald trump dinner with australian pm^remembering prince a tribute legend groundbreaking career^former porn star claims drake got her pregnant here his surprising response^gal gadot reflects her amazing wonder woman year^this is us season trailer see cast surprise real life fans with emotional twist^second wives club shiva safai is n't bothered fianc mohamed hadid year age difference ''i 'm old soul ''^brie bella dishes pregnancy nikki amp john cena talk marriage amp more total bellas season sneak peek watch^pippa middleton undergoing bridal body boot camp ahead wedding^john cena nikki bella celebrate engagement party^billboard music awards see music biggest stars hit red carpet style^the internet is determined solve ihop upcoming name change ihob^cheeky little norwegian prince dabs during king queen birthday celebrations^lfo singer devin lima undergoes surgery after finding massive tumor^julia roberts paints accurate picture parenthood george clooney he awaits birth his twins^prince harry reveals why he finally opened up about his grief mental health after princess diana death^tom hanks helps man propose his superfan girlfriend texas book festival^kylie jenner surprises high school students their prom^will twisted ankle impact normani kordei dancing with stars finale redemption^dancing with stars edyta sliwinska gives birth baby no with alec mazo^justin bieber selena gomez fly seattle date are doing great^why mariska hargitay considers law amp order svu her calling^prince william kate middleton attend first royal garden party with queen elizabeth prince philip^brie larson reveals how emma stone jennifer lawrence ''saved my life ''^summer shoes every budget shop now^everything you want know about butt implants^creating harry potter j.k. rowling journey struggling single mother world first billionaire author^will smith dj jazzy jeff are reuniting their first official shows years^drake makes history billboard music awards lets ''love his life '' nicki minaj steal show^chrissy teigen kim kardashian kourtney kardashian families are having fanciest easter together^why katy perry deserves have glorious night met gala after her rough weekend^mohamed hadid pleads no contest charges involving ,000 square foot mansion^armie hammer will make broadway debut straight white men^keri yara shahidi master mom daughter fashion^alicia silverstone husband christopher jarecki split^rosario dawson eric andre break up^ben higgins reacts bachelor paradise scandal reflects his relationship with show producers^britney spears jamie lynn spears their kids pose sweet family photo^american idol renewed second season abc^kate middleton prince william prince harry are cutest cheerleaders london marathon^dancing with stars sharna burgess dating pierson fod not bonner bolton^paris hilton majorly shades lindsay lohan when asked about infamous girls night out with britney spears^chris pratt anna faris a timeline their last year together^with stranger things season noah schnapp became star^kelly rowland wants second boob job because her nipples are size frisbees^the good fight bosses tease season musicals cliffhangers power law^flip flop vegas stars bristol amp aubrey marunde are ready take el moussas flip off^the originals boss julie plec talks beginning end mikaelson family^big brother jessica graf cody nickson get engaged ahead the amazing race finale^carrie coon star villain avengers infinity war^james matthews best man compares pippa middleton dog wedding toast^spencer pratt kisses heidi montag growing baby bump new pregnancy pics^meghan markle is destined be duchess find out your royal title using our name generator^marvel is bringing squirrel girl tv new warriors show anna kendrick are you listening^kellan lutz brittany gonzales are engaged reports^what happened chyna the solitary downfall wrestling ''ninth wonder world ''^caroline manzo wants justice sister dina after brutal burglary^dan shay singer dan smyers weds abby law^wonder woman sneak peek see photos from movie^kylie jenner tyga party separately coachella amid split rumors^katy perry iggy azalea have girls night in paris hilton extravagant home^inside harry styles relationship with tess ward ''they 're great match ''^kourtney kardashian is seeing younes bendjima scott disick is not happy about it^from hopeful australia beginnings tragic hollywood end heartbreaking moments from i am heath ledger^how kylie jenner got great shape by basically doing nothing^austin jones arrested child pornography charges more biggest youtube star scandals^khloe kardashian makes first public appearance since pregnancy news^found the holy grail acne spot treatments^harry styles dishes liam payne new life dad whether he 'll be godfather his son^airport security violently drags passenger off overbooked united airlines flight^game thrones stark family reunites ew cover shoot^kelly ripa teases live co host announcement trust me^ashton kutcher pays tribute mila kunis their kids emotional speech^nina dobrev nails prisoner chic orange bomber jacket^kim kardashian reflects her first trip paris since robbery i feel calm^caitlyn jenner talks diane sawyer /20 highlights from her personal interview^robert pattinson was nearly fired from twilight^black panther is changing marvel cinematic universe you know it^alpha male madness vote final round^inside george amal clooney first week parents they 're elated^bella thorne celebrates her th birthday by licking youtuber tana mongeau tongue^one direction liam payne niall horan share heartfelt reunion wango tango music festival^jennifer love hewitt looks back her first pregnancy with never before seen photo^chrissy teigen beyonc bite the problem is i love everybody involved^shakira new album el dorado has very personal songs about gerard piqu we were hiding from world^nick lachey finds wife vanessa wedding ring trash^melania trump settles with daily mail parent company over escort story^the bachelor chris soules pleads not guilty leaving scene fatal accident^meet ines rau playboy first transgender playmate^fashion police met gala style poll vote best amp worst dressed stars now^love island sophie gradon dead^mariah carey nick cannon twins celebrate th birthday disneyland^we really need talk about how good alexis bledel is the handmaid tale^jim carrey challenges mother late girlfriend cathriona white over wrongful death lawsuit^justin theroux removes wedding ring after jennifer aniston split^best memorial day sales^which american idol judges should return revival^dwayne johnson kicks back '90s when he had flattop turtleneck fanny pack^jenna dewan tatum promises her channing tatum are n't perfect ''we fight like other couples ''^rob kardashian daughter dream says ''hi dad '' sweet video^find out what cindy crawford modeling advice is daughter kaia gerber^beyonc showcases sexy outfits coachella all about her styles^ariana grande suspends remainder dangerous woman tour after deadly manchester arena elosion^teen mom kailyn lowry confirms chris lopez is father her third child^teen mom jenelle evans documents her road mtv video music awards^how do everyday makeup less than minutes^reign series finale brings mary journey end did the cw follow history books^maria bello joins ncis season series regular^how get pippa middleton wedding beauty look with 30^ryan seacrest american idol throwback post may leave simon cowell randy jackson blushing^chris evans may be best ex boyfriend ever^meghan markle arrives london pippa middleton wedding^the view alum jedediah bila marries jeremy scher^what wear stagecoach^the real jeannie mai elains why she gained lbs three months^jenelle evans takes son jace on horseback riding trip after custody battle^station jason george dishes action packed grey anatomy spinoff^which taylor swift reputation lyrics are about joe alwyn tom hiddleston calvin harris^the bachelorette rachel lindsay reveals she engaged i am getting my happy ending^riverdale kj apa amp cole sprouse say season finale ending is so big that it was top secret set^here why shia labeouf is now living alone remote cabin finland^miranda kerr son flynn looked very excited her evan spiegel wedding^inside scott disick wild nights partying with bella thorne ella ross^ryan seacrest confirms american idol revival talks but will he return host^prince william prince harry join forces with canadian prime minister justin trudeau honor fallen soldiers^bristol palin looks ready pop she reveals she days away from giving birth^america got talent season adds laverne cox guest judge^big little lies author teases season ... and what it would be about^pirates caribbean dead men tell no tales reviews draw comparisons the curse black pearl^john mcenroe refuses apologize serena williams over sexist remarks^pirates caribbean dead men tell no tales premieres^is the keepers netflix next making murderer it even better^amber heard misses her dog while filming australia after declaring she would avoid down under^is david hasselhoff hiring the bachelor twins his personal assistants^flared jeans celeb inspired ways wear them^what vault doctor who season mystery is solved but trouble is just beginning^amanda bynes returns twitter stops to smell flowers^laura dern billie lourd more kick off golden globes weekend moet moment film festival^liam payne not sure he wants marry cheryl cole^man with knife arrested outside buckingham palace amid heightened security following manchester attack^amy schumer channels judge judy day result is just dramatic you 'd eect^katy perry officially joins american idol revival as its first judge^coldplay cancels houston concert after hurricane harvey^jordin sparks eecting baby boy with dana isaiah^ashley graham poses nude v magazine recalls her christian upbringing^hilary duff is pregnant things know about boyfriend matthew koma^christina grimmie family reaches out las vegas shooting victims ''we are beyond devastated ''^fantasia barrino tells story how she married herself really^victoria beckham opens up about her famous family spice girls^how kaley cuoco karl cook are settling into married life like total pros^justin theroux doing high kicks american cheese snakes are all wacky at home with amy sedaris trailer^inside hamptons mystique why beyonc gwyneth paltrow jennifer lopez amp more really flock east end^ben higgins answers bachelor nation most pressing questions after his lauren bushnell breakup^ariana grande reunites with mac miller florida after manchester bombing^nicki minaj will open billboard music awards^robert wilson dies luke wilson owen wilson father was^white denim outfits your can wear this memorial day weekend^oscar isaac elains viral cheetos chopsticks photo^justin bieber looks back his dui mug shot with hopeful message ''thank god i 'm not where i used to be ''^moana hits netflix today so let celebrate with this adorable year old singing her heart out^man taylor swift stalking case found unfit stand trial^why kate hudson thinks oprah winfrey weight loss journey is so important^daddy yankee shares rare photo celebrate wedding anniversary^kylie jenner takes pic with baby encounters protesters among her hundreds fans las vegas event^chipotle new queso dip may just change your order forever^kate upton jimmy fallon face off unique dance battle^chris brown wishes daughter royalty happy third birthday adorable instagram^the beckhams the wilsons amp more celeb couples who do charity work together^golden globes predictions who will be big tv winners^james corden orlando bloom show off their racy office moves it guys^property brothers drew scott talks ''tough '' wedding planning what duo thinks hoopla surrounding third^edgar ramirez has fully transformed into gianni versace everything we know about season american crime story^ryan phillippe slams katy perry dating rumors stop flying helicopters over my house^brian lancaster dead mtv road rules star was^hollywood hottest moms must have skincare products^how kim kardashian kanye west are trying give north west normal life^riskiest looks mtv movie tv awards justina valentine more^real housewives new york city bethenny frankel ramona singer feud you have n't seen anything yet^vin diesel my kids had blast guardians galaxy vol set^the bachelor chris soules arrested after deadly crash everything we know^chris soules hires new high powered legal team after fatal car crash^jennifer lopez katy perry join james corden carpool karaoke primetime special^mandy moore wore loafers they 're not gucci slides^the bachelorette becca kufrin is independent woman new promo^alpha male madness vote final round^alpha male madness vote final round^jenelle evans talks juggling three kids her custody battle life beyond teen mom^kim zolciak biermann jokingly offers oral sex meet john legend here how chrissy teigen responded^bachelor paradise stars evan bass carly waddell get married in mexico amid show drama^this must see video dame judi dench rapping is both hilarious impressive^mel b elains her america got talent drink throw what you see is what you get^vanessa hudgens joins so you think you can dance judge^naya rivera all smiles first public event since domestic battery arrest^this gilmore girls a year life twist just changed everything emmys^kim kardashian defends her kanye west decision use surrogate^fast furious spinoff being considered with dwayne the rock johnson charlize theron jason statham^john cena nikki bella have heartbreaking marriage talk total bellas ''i 'm not sure we should go through wit^roseanne reveals sarah chalke new role it has do with becky no^duffer brothers apologize after being accused verbal abuse set stranger things^david letterman compares amy schumer richard pryor ''she real breakthrough ''^younger nico tortorella partner marry genderbending outfits^kylie jenner best friend jordyn woods opens up about their relationship new life kylie teaser^hgtv by numbers find out which stars rule roost^chad michael murray learns his late grandmother possible murder was actually suicide hollywood medium^david spade naya rivera spotted dinner date he really likes her source says^ghostbusters ghostbusters ii coming netflix march^beauty beast crosses 1 billion worldwide^dwayne the rock johnson emotionally elains how he jimmy fallon made fan cry^jennifer lopez world dance judges look stunning new photos^this is us fans we 're going learn how jack died season^jinger duggar gives birth baby girl named felicity^did riverdale really just kill spoiler boss breaks down that finale twist^bethenny frankel ramona singer real housewives new york city fight heats up^elle fanning more stars first vogue covers^saturday savings lucy hale cute muscle tank is only 43^shay mitchell just wore wildest red carpet look mtv movie amp tv awards^inside miley cyrus liam hemsworth taco tuesday date night^barack obama michelle obama purchase their washington d.c rental home^zeke smith says survivor gave him unprecedented autonomy how his outing was handled^harry styles reveals special present adele gave him his st birthday^kylie jenner travis scott take baby duty break with miami getaway^katy perry best candid tmi moments from her live stream^zoe saldana was inspired her children create bese inspire latinx community with untold stories^girls series finale elained everyone trying figure out^kim kardashian goes shirtless suit lacma art film gala^janet jackson wissam al mana split what stake^jesus christ superstar is nbc next live musical^j.k. rowling sorry killing beloved harry potter character^taylor swift helped homeless pregnant fan buy house^eva marcille is engaged see real housewives atlanta star stunning ring^babies movies music more one direction solo firsts^this full body workout is kim kardashian approved^is harry connick jr returning american idol abc^ariana grande gives surprise performance coachella amid comeback^how recreate selena gomez bold lips^mike the situation sorrentino says he months sober tax case looms^see cover whitney cummings new book^scott disick model ella ross spotted out together several times^prince harry adorably catches pint sized popcorn thief invictus games^kourtney kardashian younes bendjima conclude their hotel getaway with steamy makeout session^ian somerhalder birthday tribute pregnant wife nikki reed will restore your faith love^who winning award season the good bad inspiring far^kylie jenner sparks engagement rumors with giant diamond ring^the bachelorette season meet rachel lindsay men including tickle monster whaboom^mission impossible fallout cast ees real tom cruise^ladies london star annabelle neilson cause death revealed^the flash keiynan lonsdale comes out bisexual^kim kardashian cries she describes paris robbery the ellen degeneres show^savannah guthrie ca n't wait have hoda kotb happiness joy back today^inside colton haynes jeff leatham star studded wedding^why elizabeth smart lifetime movie could n't have happened more relevant time^southern charm cast sounds off ashley disgusting blowup kathryn she was enjoying it^here why salma hayek loved her seat oscars^eva marcille joins real housewives atlanta cast season^taco bell is ditching drive thru sell alcohol new restaurants^how jessica simpson got ultimate revenge from reality tv ditz role model billion dollar businesswoman^harry styles dance moves just stole show during jimmy fallon saturday night live flash mob^ryan murphy monica lewinsky joan collins anjelica huston american horror story american crime story upda^ellie kemper amp tituss burgess play unbreakable kimmy schmidt word association you wo n't believe what they said^mineral sunscreens start using this summer^rooney mara did n't eat her first pie until age^taylor swift wears snake boots hugs superfans reputation secret sessions^kanye west just out kanye 'd himself with poop inspired song called ''lift yourself ''^angelina jolie brings kids telluride film festival receives warm welcome^prince harry meghan markle are cousins according this family tree^it end bloodline but what about damages revival^charlie hunnam recalls terrible painful eensive year marriage age^how southern charm became sleeper hit bravo^marc anthony nicky jam amp more stars raising funds hurricane maria victims puerto rico^millie bobby brown comes face face with new creatures godzilla king monsters trailer^gwyneth paltrow hamptons home is precisely organized you 'd eect^angelina jolie drops 25 million historic cecil b. demille home how brad pitt affected her decision^kim khloe kourtney kardashian look like futuristic girl group tokyo^kylie jenner makes second post pregnancy outing friend baby shower^celebrity second acts when hollywood takes backseat multimillion dollar business empire real power^dietland kitty is finding her voice badass julianna margulies speech^meghan markle shows skin chic pink outfit buckingham palace balcony debut^sasha farber scares simone biles the ellen degeneres show reaction is priceless^the bachelor sarah herron reveals how heartbreak reality tv led her greater purpose^george clooney amal clooney return red carpet months after twins births^aaron paul wife lauren reveals sex their first child^shawn mendes shares source his anxiety^tarek el moussa jokes about christina el moussa but she not laughing^farrah abraham stirs controversy with bollywood inspired look mtv movie tv awards^girl scout troop leader allegedly steals 15,000 worth cookies then disappears^from the one american idol inside abc eternal quest hit singing competition^tony awards complete list nominations^how janet jackson got her post baby body^jamie bell talks marriage kate mara ''netflix chill date night ''^pregnant serena williams dons swimsuit gets cozy with alexis ohanian babymoon^james woods reports my retirement are greatly exaggerated^amy schumer makes red carpet debut with husband chris fischer tony awards^tv top couple vote round now^hilary duff loves smelling like this 2 product^camila mendes wears this nail polish every episode riverdale^jax taylor rap sheet revealed a history his misdeeds vanderpump rules^steven tyler is grandfather again meet mia tyler son axton^best dressed met gala selena gomez katy perry amp more^playboy bunny halloween costumes that are super sexy irl^tv top couple vote elite now^today kathie lee gifford reveals when she really started falling love with hoda kotb^lady gaga margot robbie jason sudeikis more spotted toronto international film festival^how get meghan markle signature beauty look^brooklynn prince new age social media child stars^kim zolciak biermann pens touching letter husband kroy after kash hospitalization^maryse struggles with fate chateau marmiz while lana worries about her career total divas^billie lourd inherit mom carrie fisher estate^second wives club recap katie cazorla throws shawna craig unforgettable pool party celebrate her dirty^jonas brothers other celebs party pre grammys bashes^is jersey shore reunion really works mike the situation sorrentino says he gotten call^tamar braxton files divorce from vincent herbert^ivanka trump booed berlin summit says she used it^scott porter wife kelsey mayfield eecting baby no^nikki reed showcases chic maternity style while out with ian somerhalder^megan seeks revenge ihm during the arrangement shocking season finale i 'm gon na burn whole thing down^these couples ignited met gala red carpet over years^ouch kurt russell ca n't stop beating up james corden^selena gomez shares how she handles crush while returning radio disney^emmy nominations complete list nominees^gigi hadid just wore tank tops ... same time^emma stone responds teen viral la la land inspired promposal^tori spelling now owes 220,000 default judgment^pink husband carey hart gushes over his ''bad ass wife '' before her saturday night live appearance^what pinhead shia labeouf flies into rage pinz bowling alley^what bachelorette rachel lindsay is wearing find love^mark hamill celebrates carrie fisher fun spirit star wars the last jedi premiere^woody allen elains why he should be poster boy metoo movement^the surprising story behind lily aldridge red carpet hairstyle^katie holmes jamie foxx step out new york city dinner date^la la anthony carmelo anthony separate after years report^liam payne gushes about baby boy bear music video premiere^meghan trainor spills details about her sex life with boyfriend daryl sabara why he ''best kisser ever ''^lisa vanderpump brings extra dash glamour beverly hills dog show^matthew perry reveals which friends storyline he nixed what he does with his residuals^tv scoop awards vote saddest cancellation best series finale now^ariana grande manchester benefit concert recruits justin bieber miley cyrus more^reasons why should parents be required watch with their kids^moonlight ashton sanders amp jharrel jerome win best kiss mtv movie amp tv awards this represents more than kis^amy schumer boyfriend ben hanisch split after almost years dating^the bachelorette premiere awards the best worst amp most embarrassing moments^how music motherhood are getting janet jackson through her public divorce^vanessa hudgens reveals her favorite memory with ashley tisdale and it totally involves high school musical^which new tv shows look worth your time our ranking is here help you out^joseph gordon levitt wife tasha mccauley pregnant with baby no^wwe hall famer ric flair hospitalized placed into medically induced coma^the unstoppable rise clean beauty celebs betting their careers movement an insider look^pawn stars richard harrison dead the old man was^how cover up acne hide pimples^ben higgins sheds light ''tough '' split from lauren bushnell ''life was getting more difficult ''^i got celebrity nose job here everything you did n't know^tv top couple vote final round now^nick carter aaron carter mourn sudden death dad robert carter^miranda kerr road altar how supermodel found her happily ever after with evan spiegel^everything you need know about coachella told one photo vanessa hudgens^the mummy london premiere canceled after manchester bombing^nickelodeon kids choice sports winners the complete list^chris cornell private funeral plans revealed music community mourns his death^madonna covers britney spears toxic after responding meme^john cena plays his entire family and slimes kisses himself kids choice awards^giant bunny bought from former playboy model dies united airlines flight^gal godot unleashes her inner warrior final wonder woman trailer^new girl end after season^kate upton justin verlander return spotlight after wedding^meek mill what good nicki minaj cuddles up nas flirty instagram photo^a definitive ranking met gala most talked about looks from nearly naked most bundled up^luis fonsi vows party after performing despacito the voice finale^fuller house season trailer has so many spoilers a proposal pregnancy trip tokyo^farrah abraham arrested beverly hills hotel fight^tamar braxton deletes instagram after vincent herbert drama^nick lachey vanessa lachey having three kids ''we 're truly outnumbered now ''^here what guy ritchie has say about will smith playing genie aladdin live action remake^prince harry meghan markle dazzle they arrive royal wedding reception^amy schumer is overflowing with confidence i feel pretty trailer^joanna gaines calls her fifth pregnancy total surprise^mistakes american idol revival abc has avoid^outlander season adds downton abbey veterans pivotal roles^liam payne admits your life is changed forever once you welcome baby^why this new richard simmons photo message make his disappearance even more confusing^guardians galaxy chris pratt gets real about intense dieting cheat meals^the bachelorette week the race conversation begins no one can spell^the very real troubles that have plagued kids the real housewives franchise^melania trumps style secrets decoded with simple rules^bow wow says there scientific method my madness after twitter ees his private jet lie^wonder woman gal gadot lynda carter reunite premiere^amanda seyfried reflects becoming mom i could n't be more awe my life^priyanka chopra sings taylor swift does baywatch run more vogue questions video^ariana grande has tattoo dedicated pete davidson dad who died /11^katy perry recalls lessons her everything does n't have end marriage^sienna miller prefers her postpartum nipples they look like fighter pilots thumbs^jimmy kimmel gets emotional when announcing his son birth health complications^why wait game thrones final season just got whole lot longer^andy cohen spills all the real housewives craziest moment most demanding star more^oscars puppy predictions see adorable dogs that will help predict best picture winner^cardi b says she not pregnant she just getting fat^kate middleton talks prince william prince harry about princess diana death^why miss usa kara mccullough uses 5 bar soap get acne free skin^juiciest stories from alec baldwin memoir nevertheless^jessica simpson i 'm not pregnant^a comprehensive guide celebrity lipsticks lip products^seth meyers host cfda fashion awards^the king netherlands reveals he has been living secret life years^here sneak peek demi lovato luis fonsi song echame la culpa^sarah hyland addresses anorexia allegations amid difficult year^botched doctors terry dubrow paul nassif give patients back their confidence season premiere watch^goldie hawn hollywood did n't want me back after years away^tiger woods breaks silence after dui arrest^kate middleton begins children hospice week with inspirational psa^the perils prying can true crime go too far^scarlett johansson romain dauriac reunite amid divorce^prince harry meets first lady melania trump ahead invictus games^rita ora turns heads while channeling cher black thong billboard music awards^ariana grande pete davidson are cutest shopping couple^hold up drake just performed inside bellagio massive fountain display billboard music awards^let glow take you back time when alison brie was professional wrestler^the sexy outfit eva longoria other pregnant celebrities love^what going between carmen electra tommy lee exes reunite coachella multiple occasions^nikki reed ian somerhalder are eecting their first child a look back their road parenthood^taking care britney spears the shocking sequence events that led her decade long conservatorship^ramona singer amp dorinda medley preview the real housewives new york city double dose party drama^newly single leonardo dicaprio is living his best life cannes film festival^joanna krupa romain zago separate after less than years marriage^revisit julia roberts people most beautiful covers^where does paul pk kemsley rank among the real housewives shadiest significant others^spring summer premiere calendar when watch your new old favorite shows^hugh grant eecting his fifth child with girlfriend anna eberstein^john stamos caitlin mchugh are married^becca kufrin reveals she engaged but why are bachelorettes allowed spoil their season^carmelo anthony is all smiles first pics following la la anthony split^leslie mann judd apatow preparation met gala could bring any couple closer together^john legend chrissy teigen baby girl turns inside luna fabulous first year life^the mindy project ike barinholtz is recovering from broken neck after movie stunt accident^tlc spills their first album years find out how lisa ''left eye '' lopes will be included^kim zolciak biermann daughter brielle gets booze filled pi ata^here most popular halloween candy your state^scott disick remains silent he asked about his cannes women^alec baldwin brings his best dance partner interview with ellen degeneres his year old daughter^katharine mcphee david foster relationship history revealed how american idol sparked unlikely bond^did selena gomez just debut brand new hairstyle the queen instagram teases a major chop you 've got ta see for^the finale changes everything all you need know about season^russell brand marries laura gallacher mother their child^tiffany haddish shows pains not shopping local super bowl commercial^liam payne rita ora tease sexy fifty shades freed collaboration^the ultimate guide curling your hair^celeb salaries then now kaley cuoco 900k payday could have been just 1,500 '60s^miss district columbia k ra mccullough crowned miss usa^miss usa see all contestants their swimsuits evening gowns before winner is crowned^jennifer lopez amp alex rodriguez couple workout revealed^khloe kardashian praises kanye west new album that contains tristan thompson lyric^kourtney kardashian meets with congressional leaders about cosmetics reform^kelly clarkson claims she lost out millions after rejecting writing credit with dr. luke^jeff goldblum emilie livingston welcome son river joe^grey anatomy just set wheels motion another doctor departure^lucy hale kate spade femininity fanny packs skin care^all clues steve from blue clues went from beloved nickelodeon star shameless hipster^the walking dead season premiere just introduced new mystery we 're not sure what make it^what is american gods everything you need know if you have n't read book^kristen bell makes frozen themed promposal dream come true^tom holland flashes his six pack abs british gq^elton john recovering after brief hospitalization ''unusual bacterial infection ''^mel b files divorce from stephen belafonte after nearly years marriage^nikki bella finds out her wrestlemania fate brie bella chooses birthing plan total bellas^chrissy metz hits back body shamers after mtv movie amp tv awards ''i wear what i want when i want ''^tyga rumored flame jordan ozuna jet mexico nsfw getaway^another the real housewives new york city cheating bombshell what does ramona singer know^best shampoos amp conditioners based celebrity hair textures^lauren conrad shares her must have accessories fall^jennifer lopez makeup artist swears these face wipes^will weight loss surgery stick mama june a status update stars who went under knife before her^dance moms abby lee miller breaks her silence after prison sentencing how she coping^is this the voice most formidable coaching line up yet^zac efron grandparents are cutest baywatch fans ever^new spring beauty products you need try before they sell out^arrow star stephen amell just absolutely crushed american ninja warrior celebrity edition^jersey shore mike ''the situation '' sorrentino reveals he was ''heavily using '' show^why once upon time should follow jennifer morrison lead amp end with season^reba mcentire teases acm awards performance with kelly clarkson^celebrity botox what it looks like years later^days ways olivia palermo bomber jacket is having moment^la la anthony pays sweet tribute year old son kiyan amid carmelo anthony split^matthew rhys keri russell discuss their real life romance^harvey weinstein confirmed be treatment amid sexual assault harassment scandal^rashad jennings his dancing with stars season win i 'm beside myself^nelly furtado secretly split from demacio castellon after years marriage^queen south jon ecker opens up about his role growing up with famous father^miss usa k ra mccullough why she ''thankful '' controversy over health care comments^peta murgatroyd maksim chmerkovskiy heather morris shocking dancing with stars elimination is awful^why the marvelous mrs. maisel duo is just so damn dynamic^iggy azalea says she lost lbs one week from twerking^corinne olympios is heading bachelor paradise but why is she nervous^hackers threaten leak upcoming pirates caribbean film unless disney pays ransom^chris harrison congratulates the bachelor juan pablo galavis his wedding osmariel villalobos^is daisy ridley finally used star wars fame^remembering david cassidy life pictures from the partridge family emmy nominee^the weeknd gets teary during emotional coachella performance ''call out my name ''^twin peaks how secrets were kept set tv most mysterious revival^veronika obeng calls tania mehra fake second wives club^the keepers director ryan white surprising personal connection murder sister cathy^christina aguilera mourns death dog stinky with video tribute^gigi hadid says she does n't want any more friends ... taylor swift calls her inclusive person^bet awards red carpet arrivals kat graham dascha polanco more stars^kate spade laid rest hometown funeral^days ways emma roberts proves orange really is new black^nicole brown sister tanya reacts o.j simpson parole hearing there nothing we can do about it^mcdonald pulls new commercial after accusations eloiting children grief^this 5 beauty tool saves ashley graham feet red carpet^drugs partying nude photos more the biggest falls from beauty queen grace^ellen degeneres looks back coming out episode with oprah winfrey laura dern^laura dern met gala dress has removable train so she can dominate dance floor^stacey dash withdraws from congressional race over concerns health family^kristen bell mom surprises her the ellen degeneres show^the bachelor chris soules checked kenneth mosher pulse call reveals^prince charles wife camilla felt like prisoner her own home after their affair was made public^a shot love with tila tequila star ashley mcneely found dead^stranger things season everything we know so far^psych reunion movie is officially happening usa^erika jayne reveals it costs 40,000 month be her^teen mom jenelle evans david eason are married all details their wedding day^all best moments from riverdale raucous party^ed sheeran james corden preview carpool karaoke with sing castle hill^laguna beach talan torriero is eecting his first child^kim kardashian kourtney kardashian friends go absolutely wild mexico^kate hudson gets mom goldie hawn spill details why she took year break from hollywood^jamie oliver puts end longtime feud with gordon ramsay^radiohead eeriences major technological issues during coachella performance^adam rippon boyfriend jussi pekka kajaala make their red carpet debut^where does girls rank among tv best amp worst series finales all time^one married at first sight season couple decides divorce ahead decision day^gwyneth paltrow talks big life big loss being ''ruthless ''^chris rock gets refreshingly candid about his divorce infidelity ''i was piece s t^miley cyrus deletes all instagram photos here are the craziest fan theories^catelynn lowell gets christmas gift from first child carly after leaving treatment^the fall tv schedule is officially here^survivor jeff probst is part rare essential breed the reality tv hosts who 've become so much more^when royal family really has scandal they do n't mess around^dancing stars week who will compete finals after another shocking elimination^beyonc in homestretch inside her third trimester pregnancy with twins^father daughters pens candid letter ariana grande after manchester arena bombing take care you first^luann de lesseps accepts plea deal following palm beach arrest^rose mcgowan faces arrest warrant alleged drug possession^get in depth look kate middleton flair photographing her children^john mayer recovering from emergency appendectomy postponing upcoming shows^kim kardashian hailey baldwin more ca n't stop wearing this coat^orange is new black jamie denbo was told she too old play year old man wife^everything we know about pippa middleton wedding dress designer^fifth harmony normani kordei falls onstage handles it like boss^kendra wilkinson baskett confronts her mom social media habit that feels like knives jabbed me^julia roberts is world most beautiful most fashionable woman look back her most iconic red carpet^best dressed stars cannes film festival bella hadid elle fanning amp more^coulson is finally waking up framework this agents s.h.i.e.l.d sneak peek^second wives club star katie cazorla freaks out over idea getting married fianc walter afanasieff^pippa middleton james matthews forgoing typical honeymoon they 're calling it 'the escape '^karlie kloss is buttoned up this new boots trend^chrissy teigen steals our hearts by taking daughter luna work^did pete davidson ariana grande get new apartment together singer drops hint^bobby moynihan leaving saturday night live my life dream was be that show^paris hilton chris zylka show pda red carpet moca gala^united airlines announces policy changes response passenger removal incident^priyanka chopra spends fourth july with nick jonas family^is luke perry really leaving riverdale^the end kardashian era inside decision close dash eansion family brand^abigail breslin elains why she did n't report her sexual abuse ''i was in relationship with my rapist ''^kim kardashian kanye west enjoy family day disneyland ahead year wedding anniversary^corey feldman made ''promise '' corey haim ee alleged sexual abuse^beauty products essential long lasting summer party face^rihanna new 6.8 million mansion hollywood hills is stunning^demi moore is surprise guest bruce willis comedy central roast^disney channel battle vote final round your favorite tv series^today anchors reveal what employers asked them change about their appearance^major raven home casting scoop and father raven kids is ...^sonny with chance star brandon mychal smith arrested dui charge^luann de lesseps return cabaret stage after weeks rehab^carmelo anthony sends his love estranged wife la la anthony amid split drama^sara gilbert roseanne cancellation i 'm sad people who lost their jobs ... i do stand behind decision^watch mama june break down tears after pumpkin surprise doctor^arrested development jason bateman has officially signed season^miley cyrus liam hemsworth take st patrick day next level^spicy skittles spicy starbursts are totally thing now^james corden performs with backstreet boys again showcases killer dance moves^claire holt husband files divorce just before couple year wedding anniversary^lady gaga beautiful tribute cancer stricken friend coachella will make you cry^taylor swift entirely focused making new music she continues break from spotlight^chanel apologizes gabourey sidibe after actress says she may have been racially profiled store^paris jackson gets new ''applehead '' tattoo to honor late father michael jackson^pippa middleton james matthews take their love new heights while honeymooning australia^hoda kotb ca n't help but gush over motherhood ''i 'm exhausted overjoyed ''^western inspired pieces every fashion girl should own^megan agent accuses her sleeping with nate the arrangement infidelity is breach^serena williams would consider quitting tennis if she had another baby^moments billboard music awards history that still give us chills^ciara final days pregnancy documented beautiful video before baby sienna birth^melania trump ivanka trump don chic looks saudi arabia forgo headscarves^fiercer than ever watch kim kardashian fam recreate keeping up season one opening credits years later^vince vaughn arrested suspicion dui^paris hilton dream diamond revealed 2 million engagement ring^things we hope happen if rihanna drake reunite billboard music awards^mtv movie amp tv awards winners the complete list^beauty hacks you need do allergy season per celeb skin eert^here fishtail braid you can actually do^how roseanne revival came together according laurie metcalf^latin american music awards red carpet arrivals see stars strut their stuff^how taylor swift keeps her relationship with joe alwyn private^other grey anatomy spin offs we would 've loved see^how becca kufrin night one dress ranks among the bachelorette best worst premiere looks ever^heather morris her dancing with stars elimination i was very happy last time be amazing^tina turner son craig turner dead from suicide^kim kardashian corset is uneected daytime choice^pussycat dolls say kaya jones prostitution ring allegations are false^look back meghan markle dad drama more famous family feuds^kylie jenner cuddles babies health clinic during philanthropic trip peru^why lucy hale quit drinking what finally made her say ''i do n't give f k ''^we ranked celebrity ex run ins from least awkward omg^mobb deep rapper prodigy honored during star studded funeral^matt damon octavia spencer amanda seyfried more attend venice film festival^reasons why katherine langford dylan minnette reveal their hopes season^was mixed signals one the flash best episodes ever^robin williams last movie absolutely anything gets u.s. release date^take your kids work day celebrity edition^miranda kerr marries snapchat evan spiegel intimate ceremony^jennifer lopez may have called drake ''bootycall '' a history stars shading their exes^is broke girls canceled not even beth behrs knows^how james matthews is keeping pippa middleton calm before their wedding^candace cameron bure flexes her abs bloats her belly this hilarious instagram video^olivia newton john postpones tour dates due breast cancer^riverdale finally reveals who killed jason blossom see how cast reacted^busy philipps i was almost murdered random dude uber^you got ta see jay z cradling beyonc baby bump clippers game^tom sandoval ariana madix guide kentucky derby how eat drink party all weekend long^music groups bands you probably forgot existed lw s club dream more^watch first look kylie jenner new e series life kylie^adriana lima barely avoids embarrassing wardrobe malfunction met gala^keira knightley returns pirates caribbean new international trailer dead men tell no tales^zac efron baywatch workout routine was more intense than you imagined^stassi schroeder says she stays thin by trying starve myself^will ben higgins be the bachelor again after breaking up with lauren bushnell chris harrison says ...^gwyneth paltrow chris martin reunite celebrate apple birthday museum ice cream^matthew morrison eecting first child with wife renee puente^snooki weighs why sammi ''sweetheart '' is n't coming back jersey shore revival^prince philip retires from royal duties with queen elizabeth ii full support^here proof that carrie underwood is mike fisher nashville predators biggest cheerleader^baywatch movie reviews are they 're not great^melania trump wardobe no longer includes fur^j.r. smith brings prematurely born baby girl dakota home from hospital nicu^saturday savings madelaine petsch weekend ready track pants are off^the flash goes very depressing but enlightening future^meet husbands e second wives club^cher turns back time steals show billboard music awards^how the bachelor franchise became impervious spoilers^late author wrote dating profile her husband before her death how her family is responding^meet tinsley mortimer your new real housewives new york city star^the rihanna lupita nyong'o heist movie that internet dreamed up is really happening^seth rogen his wife just realized justin timberlake jessica biel are ''better looking version '' them^viola davis john legend riz ahmed more stars land covers time most influential people^johnny depp issues apology joking about assassinating president donald trump^jeremy meeks chloe green show more pda ex celebrates birthday without hot convict^billie lourd taylor lautner break up after months dating^chris pine still uses his flip phone more stars who do n't follow technology latest trends^law amp order svu first look benson heads the newsroom ripped from headlines case^second wives club katie cazorla gives shawna craig pretty woman makeover ''except you do n't have f k me ''^jennifer lopez alex rodriguez show pda date after she spends time with ex marc anthony^how kim kardashian new diet fitness routine left her feeling stronger tighter^how jason sudeikis is supporting immigrant heritage month^rob amp big rob dyrdek speaks out after sudden death christopher ''big black '' boykin^too poor make it coachella this year here our guide nochella^kendall jenner goes braless see through dress cannes film festival^harry styles 8.5 million hollywood hills bachelor pad is up sale^incredibles trailer released disney pixar oh baby^grey anatomy puts all focus miranda bailey stunning amp emotional episode^eva longoria shows baby bump tank top hangs with olivia munn over christmas^botched patient nose is reborn without horns shocking episode see results^sandwich shop sign says liam neeson eats here for free he shows up collect^ellen degeneres came out time years ago today how she paved way others^roseanne might be next show return from dead^mark hamill makes one unforgettable han solo bad lip reading star wars the force awakens^pamela anderson trades signature bombshell style slicked back look cannes^how get that gucci look budget^richard curtis gets new hosting gig after live with kelly also has his eye american idol^kim kardashian panics during one her first public outings since paris attack it gives me such anxiety^billboard music awards just validated your favorite lazy hairstyles^inside chris cornell lifelong struggle with fame the soundgarden frontman battled demons he became rock god^second wives club star katie cazorla forever fianc walter afanasieff thinks she trouble^nicki minaj responds nas dating rumors i 'm celibate i might make exception^farrah abraham visits grave her daughter father derek underwood his birthday^selena gomez releases sexy new music video fetish^khloe kardashian steps out loose fitting top amid pregnancy rumors^big black ex wife shannon mother daughter isis speaks out after his death^ariana grande resumes world tour after manchester bombing with emotional concert stop paris^chrissy teigen pretends be ballerina gets grief it^the real housewives beverly hills reunion trailer is here amp everyone is each other throats^outlander season teaser is already here^ways organize your closet like celeb^check out what your favorite musicians from '90s look like now^elle king reveals she secretly got married is now separating from her ''best friend ''^james gunn announces guardians galaxy vol passionate message fans^real housewives beverly hills dorit kemsley amp lisa rinna tease what comes next after that awkward las vegas enc^kendall jenner weighs in caitlyn dissing kardashians her memoir you raised them^this quick trick will make your blowout stay place good^grab my ass twist my nipple what happens the abbey cast reveals worst bar etiquette they 've encountere^nicki minaj joe jonas ashley graham wear h amp m met gala^kelly clarkson helps her biggest fan pull surprise proposal during meet greet^famous sisters who prove kate middleton does n't have steal show pippa middleton wedding^hollywood walk fame class revealed steve irwin more set receive stars^megan fox gets emotional message about picking up pieces her love life hollywood medium^elle king skipped out my wedding^reasons why star ross butler welcome your tape memes backlash season^brad pitt shah rukh khan i would never make it bollywood^tess holliday boycotts uber after claiming driver body shamed her ''i 'm fat i also have fat wallet ''^kylie jenner travis scott appear cozy houston rockets game^brie bella talks about fitness journey after giving birth ''i have zero shame my postpartum belly ''^james corden riz ahmed heated rap battle features several mic drop moments^ben affleck lindsay shookus enjoy comedy date while jennifer garner strolls with his mom^riverdale big birthday party definitely does not go as planned^bill clinton george w. bush brag about their grandchildren bilingual talents^demi lovato gets sweet th birthday tributes from her mom nick jonas other stars^kathy griffin tearfully defends herself amid donald trump photo controversy he broke me^all must see looks from haute couture paris fashion week f/w '17^this is us sterling k. brown delivers another amazing speech after winning best drama actor sag awards^watch teen mom catelynn lowell reveal her pregnancy news family^ellie kemper says allison williams face calms down her baby boy^cynthia nin delayed subway ... her way fix subway^the bachelor lace morris gushes over boyfriend russell recalls grant kemp split^kelly clarkson totally transforms with new blonder bang hairstyle^inside deena cortese wedding what jersey shore reunion^how celine dion prepared be turned away from her first met gala ''i would 've started singing ''^the weeknd just dropped almost 20 million hidden hills mansion it pretty epic^nick jonas new single remember i told you is perfect memorial day weekend jam^chrissy teigen gets tramp stamp tattoo response john legend dancing with fan^john legend singing about costco is sexiest thing you 've ever heard^vanessa hudgens wore this crazy affordable brand coachella^things new baywatch swimsuits reveal about movie^alexa penavega opens up about motherhood her marriage going back work^kim kardashian answers big question met gala where kanye west^famous female entrepreneurs who make it look easy^inside jenelle evans ''amazing '' reunion with son jace after custody battle^pitch perfect is probably last bellas as we know them^how maksim chmerkovskiy vanessa lachey bonded over emotional dancing with stars performance^johnny depp his missing millions who blame^liam payne is about drop new single that already got us dancing^beyonc is pregnant queen red gown flower crown mom gala^chrissy teigen john legend have first date night after welcoming son miles^hate reasons why justin prentice he more than fine with that^sunglasses all celebs are wearing^inside miley cyrus journey from lunatic pop princess just being miley again^chris cornell ended his final performance with song about death^adam scott childhood dream comes true when mark hamill surprises him jimmy kimmel live^bristol palin celebrates sarah palin birthday back alaska after dakota meyer split^new miley cyrus music is coming everything we know about malibu upcoming album^beauty products help you celebrate national women health week^amy schumer slips dirty joke today after savannah guthrie warns her stay classy^ivanka trump is all smiles sister law lara trump baby shower new york city^celebrate selena quintanilla legacy what would 've been iconic singer th birthday^music festival items that will make your coachella instagrams pop^queer eye aj brown drey are married^val kilmer i did have healing cancer^grey anatomy tackles whole bunch heartbreak once^katy perry serves up another hit song with bon app tit feat migos^does kate middleton have more babies brain^kylie jenner shows off her stormi inspired manicure^kendra wilkinson baskett opens up about benefits therapy you can inspire yourself^was brad pitt gq interview his version beyonc lemonade e investigates^jessica alba gives birth actress cash warren welcome baby no^girl meets world boss reveals scrapped season plans^meghan markle makes her big arrival pippa middleton wedding reception alongside prince harry^newly single mariah carey nick cannon come together celebrate easter with their twins^alexa chung first ever runway show is happening now watch livestream^woman gives birth mid flight this cabin crew helped deliver baby like total bosses^who is rachel lindsay fianc we pick top contenders based their bachelorette questionnaire answers^why selena gomez likes taylor swift boyfriend joe alwyn^miley cyrus releases new single malibu after lengthy hiatus^how wear hailey baldwin hoodie different ways^joanna krupa romain zago finalize divorce^demi lovato gets new massive lion tattoo no she did n't ''copy '' anyone^these game changing new products are giving celebs virgin hair again^nikki bella is putting her wedding backburner again total bellas i need work me^real housewives new york city luann d'agostino daughter victoria arrested dwi^dj khaled month old son wore 2,000 gucci suit mtv vmas^is the bachelorette lee garrett racist offensive tweets eed^the bellas are back things we learned from pitch perfect teaser trailer^halle berry goes buck naked instagram^kendra duggar gives birth first child with joseph duggar^maryse debuts her pregnancy wwe while nikki bella makes her dancing with stars debut total divas^was the bachelorette lee garrett apology for offensive tweets sincere he could be full s t^classic celeb wedding dresses similar meghan markle gown^jamie lynn spears reflects ''almost losing '' daughter maddie months after atv accident^leonardo dicaprio brad pitt strike pose first photo once upon time hollywood^how katy perry is ''starting over '' it not all about orlando bloom^meryl streep rose mcgowan i did not know about weinstein crimes^cop pippa middleton fitness style^roseanne ratings revival premiere are huge even bigger than original series finale^cmt music awards winners the complete list^you 're doing it wrong getting ready spray tan^michael nance life after the bachelorette^vanessa grimaldi updates fans moving l.a. be with nick viall post bachelor^pretty little liars stars look back their first season selves adorable new featurette^noah cyrus big sean perform mtv movie amp tv awards^jimmy kimmel calls end celebrity promposals impassioned speech^the insane way models get ready shoots it not exercise^wissam al mana quotes quran is he sending message janet jackson^second wives club shawna craig name drops husband lorenzo lamas awkward meeting with potential agent^ariana grande visits manchester victims hospital shortly before benefit concert^did cara delevingne just release song summer listen now^iheartradio much music video awards winners the complete list^beyonc showcases fierce looks family feud video behind scenes pics^serena williams makes her first red carpet appearance met gala following pregnancy news^angelina jolie kids bond with jon voight amid brad pitt divorce^camila cabello matthew hussey are dating inside relationship that took her surprise^we dare you not laugh channing tatum gives hollywood most famous hunks stripper names^ozark season premiere date trailer revealed what is endgame^fact checking feud bette joan finale was it really that depressing^orlando bloom had biggest crush cate blanchett she had no idea^a snake surprise las vegas vows shaved head revisiting britney spears most shocking moments^kesha talks about being body shamed says internet contributed her eating disorder^from mug shot model meet prison bae mekhi alante lucky^pippa middleton top secret wedding dress design revealed^prince william prince harry meet winners diana award charity inaugural legacy awards^prince william lady gaga facetime join forces mental health awareness^the marie avgeropoulos elains why tonight episode is her favorite why it might be yours too^zack snyder thanks fans ''outpouring support '' during family tragedy^all proof that kate beckinsale loves good bikini selfie^prince harry prince william spotted see all arrivals pippa middleton wedding^jessie james decker says season eric amp jessie will showcase her amazing family life plus what off limits^michael bubl son celebrates his th birthday with spider man themed party^zendaya textured curls more celebrity hair trends making comeback^all details royal family blue christmas card outfits where you 've seen them before^days ways kourtney kardashian goes full ros all day these sunnies^former couples who once rocked billboard music awards together^game thrones season finale director is spilling all tea that steamy jon amp dany sex scene^idris elba recalls awkward met gala with taylor swift kanye west^summer movie preview wonder woman baywatch more^why serena williams no longer wants be size^patti lupone more stars who dared cross madonna^steve harvey closed door policy is just beginning revisit celebrities craziest real rumored demands^kaya scodelario takes e q pirates caribbean dead men tell no tales star shares her secrets^mama june is down lbs so she celebrating with second baywatch themed swimsuit shoot^erika jayne hospitalized dancing with stars injury^bottoms up what happens the abbey cast reveals which cocktails match their personalities^watch c line dion dance sing along cher billboard music awards performance^ludacris vanessa hudgens dish co hosting billboard music awards^all ways cardi b hid her pregnancy until her baby bump reveal^real housewives new jersey danielle staub is engaged marty caffrey^prince harry barack obama reunite discuss manchester attack^blake griffin ex accuses him fawning over kendall jenner palimony suit^bulletproof windows four pools car garage will beyonc jay z move into hollywood most lavish home^sense8 canceled why netflix is finally pulling plug shows^new teen mom star briana dejesus confronts boyfriend possible mistress season premiere^would ryan murphy do housewives season feud american horror story^demario jackson issues statement bachelor paradise my character has been assassinated^scandal alternate universe episode was truly wild^carly rae jepsen dropped new song called ''cut feeling '' fans are losing it^here what happened morning after channing tatum seduced jenna dewan tatum sombrero^kfc follows these twitter accounts spice girls herbs^watch taylor swift go behind scenes her delicate music video^teen mom og star ryan edwards has checked into rehab^miley cyrus crashes the tonight show hashtag panda before sitting with seth meyers band^tv scoop awards vote saddest death actor exit^creative arts emmys complete list winners^cindy crawford celebrates daughter kaia gerber passing her driver test^amy schumer can feel free be relationship just herself next time after breakup with ben hanisch^tv shows that could get canceled odds they 'll survive^beyonc pregnancy style costs at least 53,000 ... far^teen mom amber portwood freaks out after hearing matt baier shocking polygraph test results^scream queens officially done fox but what about legacy^ava phillippe kaia gerber christian combs every celeb kid taking modeling world by storm^catherine zeta jones has 2,600 worth skin care inside her bathroom cabinet^danielle panabaker says the flash savitar reveal will make total sense^mel b has spice girls party her house with her niece^nick jonas is dating georgia fowler but how serious are they^tracy morgan staying alive is not therapy session legendary comedian you hear^sofia richie scott disick reunite malibu she reiterates they are just friends^can botched doctors give rupaul drag race detox abs his dreams^richard gere plays coy over alejandra silva marriage reports^dodgeball ben stiller vince vaughn reunite cause they want you join their teams^liam payne niall horan louis tomlinson celebrate one direction year anniversary amid reunion rumors^the good doctor get ready twists turns season^drake brings basketball reporter rosalyn gold onwude his date nba awards^sorry american idol kelly clarkson joins the voice season coach instead^man arrested criminal trespassing rihanna apartment building^shia labeouf man down sells three tickets earning total 26 u.k^kylie jenner helps bff jordyn woods honor her late father with touching motorcycle ride life kylie^ashley tisdale lucas grabeel reunite perform high school musical classic^kate middleton looks elegant she curtsies queen royal easter sunday service^which family members janet jackson is leaning after her separation from wissam al mana^check out all couples met gala red carpet^meghan markle amp patrick j. adams might be saying goodbye suits before season^ren e zellweger rep slams harvey weinstein sexual favors claim^idris elba shows us some skin cover entertainment weekly^watch sofia vergara get discombobulated pronouncing ellen degeneres word day^mark salling child pornography case dismissed following his death^did selena gomez just make flip flops chic^megan fox shares rare photos her beautiful boys^katie holmes is smoking hot all night long met gala^steve harvey skips his show wrap party amid memo controversy report^from drake miley cyrus much more here are billboard music awards numbers^chester bennington autopsy reveals traces alcohol his system^luann de lesseps tom d'agostino deny allegations abuse infidelity^anna wintour daughter bee shaffer debuts engagement ring met gala^what time is it time watch zac efron search love mtv room raiders^lol guardians galaxy vol cast plays guess guardian^thal a enjoys picture perfect vacation with kids husband tommy mottola^jurassic world fallen kingdom debuts first trailer^jennifer lawrence just changed up her hair see her new bangs^liam hemsworth gets serious birthday love from miley cyrus^this signature grammy week cocktail recipe is viewing party must have^alanis morissette ex manager sentenced years prison embezzling millions^search warrants reveal prince had mislabeled pills paisley park^ghosted could be bromantic grown up stranger things you did n't know you were waiting for^steve harvey new set alleged staff rules combat being ambushed will make your head spin^actresses who moonlight activists^jimmy kimmel drags matt damon into united airlines bad press^prince harry secretly visits meghan markle ahead easter^here what eiza gonz lez had say when asked about liam hemsworth^kendra wilkinson asks fans dating sex advice after hank baskett split^luann de lesseps checks into rehab will miss real housewives new york city reunion^drugstore hair products celebrity hairstylists ca n't live without^hugh hefner daughter sons dine together night after his death^the originals season finale was absolutely filled emotional goodbyes^will nikki bella be able return wwe ring brie waits hear news this total divas clip^jimmy fallon announces that the tonight show will donate 1 million hurricane harvey relief^is this new photo liam payne cheryl cole baby^demi lovato fans perform atlantic city show their support her absence^kim zolciak biermann says all is good with son kash after dog bite^mckayla maroney says she revealed larry nassar sex abuse^lady antebellum dave haywood welcomes baby no with wife kelli^mtv star clay adler dead^cher perform live award show first time years you better believe it^chris brown karrueche tran migos quavo spark love triangle drama^miley cyrus teases new music video malibu will perform song billboard music awards^disney channel battle vote round your favorite tv series^jetblue kicks family off plane over ... cake^the bachelor ben higgins lauren bushnell break up^kelly clarkson shares photos son remington st birthday bow tie included^arie luyendyk jr. lauren burnham announce their wedding date location^harry styles takes flight walks water sign times music video^the gifted trailer shows off whole new world superheroes fox marvel series^leslie jones plays truth lie with dr. phil jimmy fallon^how meghan markle is preparing make big splash pippa middleton wedding^omg watch hollywood medium tyler henry react his mom mortifying underwear story you could see her butt^accesototalaz ryan lochte gets rushed protesters after dancing with stars performance^ryan lochte gets rushed protesters after dancing with stars performance^serena williams baby alexis olympia are twinning before easter^becky g diego boneta talk about hosting latin american music awards^total divas star renee young marries wwe dean ambrose secret ceremony^hollywood medium recap watch brooke burns brett eldredge shanola hampton touching readings with tyler henry^tom felton goes incognito among all muggles harry potter concert screening^vogue cover girls who 've never been met gala^charlie murphy laid rest dave chappelle other comedians say goodbye^dorothy mengering david letterman mom late show regular dies^dwayne johnson reveals what was behind his feud with vin diesel^maksim chmerkovskiy reveals what makes peta murgatroyd best mom it adorable^you can own pair anna wintour signature chanel sunglasses^rob kardashian gushes over dream kardashian while daddy duty^beyonc gives birth twins with jay z^north west sings kanye west song adorable video^why casting jonben t used unknowns tell jonben t ramsey murder case^ricky martin talks wedding plans amp moments he felt gianni versace presence^inside kourtney kardashian romantic night out with younes bendjima his th birthday^blac chyna gets her dance while celebrating best friend treasure baby shower^homeland season finale just killed off beloved character^erika jayne looks fabulous af pretty mess book cover^royal staff reportedly called buckingham palace emergency meeting^tarek el moussa christina el moussa are all smiles red carpet daytime emmy awards^burt reynolds still considers sally field love his life^law amp order true crime the menendez murders edie falco is already prepared say goodbye that wig^baseball cat is miami marlins new unofficial mascot hero^hot mama alert christina el moussa hops into bikini tropical easter vacation^solange gets sweetest st birthday messages from mom tina^mtv vj jesse camp reported missing^are nick cannon mariah carey getting back together here where friendly exes stand today^meghan markle considered princess diana role model new book claims^tv scoop awards vote for best reality talk show star^remembering met gala best moments with side booze^kylie jenner responds photoshop police after underwear selfie is called question^kylie jenner freaks out before met gala life kylie i 'm f king nervous ''^ellen degeneres grills sandra bullock over penis facials^chris pratt bryce dallas howard visit london children hospital get exclusive details^alpha male madness vote sweet now^alpha male madness vote sweet now^dancing with stars halloween night was no treat thanks surprise double elimination^wilmer valderrama spotted visiting demi lovato one day after singer overdose^legendary comedian don rickles dies^kendall jenner wears off shoulder top cool new way^a ros toast cannes film festival fashion^teen mom mackenzie edwards is pregnant eecting first child with husband ryan^gisele b ndchen tom brady are twinning black suits before met gala^anne hathaway puts her vocal talents display while singing google translated songs^katharine mcphee her relationship with david foster people can say whatever they want^reasons why boss offers up first season details will there be more tapes^see melania trump ivanka trump more leaders fashion statements state union^watch out megan kyle ex lisbeth admits she still love with him the arrangement^jamie lynn spears honors britney spears during surprise appearance radio disney music awards^simone biles claims she was sexually abused larry nassar^tracee ellis ross reveals what met gala was really like^jessica biel introduces her killer new role the sinner^prince pleasure prince pain paisley park is still spilling secrets year after iconic artist death^wags barbie blank autumn ajirotutu get their butts vacuumed ''it kinda sucks your butt just keeps suck^meghan markle officially baptized private ceremony report^pippa middleton james matthews wedding by numbers celebrity guests venue costs more^celeb couples who troll each other social media blake lively ryan reynolds help bring cuteness^untangling jodi arias lies how she got caught her own web after murder travis alexander^watch what happens the abbey star elizabeth confront kyle after being unintentionally body shamed by him^kylie jenner travis scott continue their houston getaway with surprise trip local mall^the illusion dress is alive well billboard music awards^leann rimes pens touching tribute eddie cibrian stepsons sixth wedding anniversary^chrissy teigen john legend son miles cutest moments^a history vogue obsession with sports stars^vanderpump rules finally answers question we 've all been asking is james kennedy hooking up with bff logan^emily ratajkowski is proud be both sex symbol feminist ''why does it have be one other ''^the bachelor recap hometown heartbreak^why taylor swift latest approach romance is right move her^chris brown punches photographer florida nightclub^meet ladies vying title miss usa^on set unbreakable kimmy schmidt season now with more character growth beyonc homages^colin farrell manscaping story is so funny it brings ellen degeneres near tears^scott disick takes sofia richie snowy aspen vacation over new year holiday^will ferrell singing whitney houston during his commencement speech is what every college grad deserves^christina el moussa nutritionist breaks down her diet spoiler margaritas are allowed^hilary duff shares matthew koma relationship update has her mom approved^alec baldwin calls twitter feud with donald trump surreal^venus williams denies responsibility wrongful death lawsuit^second wives club veronika obeng opens up katie cazorla about her husband affair^will ferrell makes first appearance since being hospitalized after car accident^bradley cooper makes his first tv appearance since becoming father^how gal gadot is going save batman franchise^thor ragnarok teaser trailer debuts superhero has face off against the hulk^things know about jack schlossberg jfk only equally dreamy grandson^neil patrick harris david burtka twins win easter with hilariously scary prank^from gwen stefani kristen stewart most cringe worthy ways cheating scandals were unearthed^scott disick sofia richie step out froyo date^patti lupone calls madonna movie killer says she dead behind eyes^white button down shirts will never be basic again thanks these celebs^princess madeleine sweden reveals name baby no adrienne josephine alice^eva longoria joins anna faris overboard film remake^steve wilkos charged with dui after serious car crash^we thought this shirt style had died 'til chrissy teigen wore it^victoria beckham receives obe from prince william i 'm proud be british^kevin hart plans run against dwayne johnson president^get know e live hosts what oscars moments are they most excited see^billboard music awards how miley cyrus zayn malik more stars are celebrating big firsts^cher most iconic amp controversial fashion moments all time^inside unbreakable kimmy schmidt uneected crossover with orange is new black^bet awards winners the complete list^watch vin diesel surprise musical debut with nicky jam billboard latin music awards^around world with scott disick sofia richie relive couple romantic getaways^kylie jenner holds baby stormi 820 gucci baby carrier^tiger woods reveals he is receiving professional help following dui arrest^kendall jenner face cleanser is perfect busy lazy people^taylor swift ex boyfriend turned her into ''quasimodo '' bff todrick hall says^north west penelope disick get joint moana themed birthday party^acm awards red carpet fashion see every look stars arrive^the real reason fifth harmony opened their mtv vma performance with that fifth member jumping off stage^brad pitt answers stephen colbert big questions hilarious late night tv return^dance moms abby lee miller opens up about her prison sentence mistakes she has pay for^no food no water no luxury tents the 12,000 per ticket disaster that was short lived fyre festival^selena gomez cast reasons why get matching tattoos what their semicolons mean^inside big black final years his relationship with rob dyrdek his daughter fans^tristan thompson throws khloe kardashian surprise birthday party^gotham jessica lucas is engaged alex jermasek^kendra wilkinson hangs with jersey shore stars tori spelling after divorce filing^you wo n't believe some america most misspelled words^lindsay lohan launches lifestyle website share all her secrets^what pippa middleton wedding dress might look like^ja rule says fyre festival was not a scam following reports chaos^mama june gushes over new boyfriend he is very very awesome^stranger things star shannon purser comes out bisexual^kerry washington reveals one thing from scandal th episode she just had keep herself^espys nominations michael phelps simone biles more nominees revealed^how vanessa hudgens lost lbs one month dropped more by doing this exercise twice day^bachelor nation take note how ben higgins is handling public breakup right way^bob harper heard from almost everyone the biggest loser after his heart attack^hot hunk ryan phillippe shaking up brooklyn nine nine gina baby daddy^pippa middleton gives james matthews brother spencer one last warning no pranks watch booze^million dollar listing agent josh altman gives tour daughter nursery^vanderpump rules cast supports lala kent her father funeral^watch this reenactment selena quintanilla last days^brad pitt gave angelina jolie heads up about gq interview is committed having healthy relationship^rihanna wants time travel day she lost her virginity^liam payne cheryl split ''we are going our separate ways ''^long island medium theresa caputo husband larry split^how make holidays nice according dorinda medley^tony awards the full winners list^life size sequel is officially happening with tyra banks^pippa middleton james matthews go jogging they continue wedding preparations^former bachelor paradise contestant leah block weighs on show controversy^pippa middleton is about marry into family with major money^demi lovato splits from mma fighter guilherme ''bomba '' vasconcelos^jesse williams awarded joint physical custody children divorce^bella hadid just brought this '90s hairstyle back^piers morgan apologizes ariana grande praises manchester benefit concert^katie cazorla hosts second wives club mermaid themed pool party we 're going be ariel^tyga dinner date jordan ozuna breaks her silence those romance rumors^ed sheeran made his game thrones debut internet had a lot thoughts^dancing with stars athletes cast revealed did random people know who any them are^prince george princess charlotte are adorable ever pippa middleton wedding^this highlighter trick can help hide wrinkles^heidi montag is pregnant eecting first child with spencer pratt^jimmy kimmel pranks justin theroux with jennifer aniston help^hilary duff admits son luca basically bald haircut was accident^there speculation that harry styles wrote two ghosts about taylor swift internet is losing it^jennifer aniston justin theroux separate after less than years marriage^omg megan begins treatment institute the arrangement it gon na blow your mind^jennifer garner ben affleck whirlwind glance rehab reconciliation rumors divorce^the real housewives beverly hills reunion part delivers one thing we want answers about bunny^nick jonas priyanka chopra have date night india^kim kardashian sisters visit planned parenthood show their support amazing place^a ap rocky grabs kendall jenner butt met gala her family snaps photos^chrissy teigen gets her nintendo switch back after twitter plea^taylor swift sends couple bottle champagne sweet note their wedding day^the chainsmokers alex pall steps out with katelyn byrd months after cheating scandal^anna faris hilariously live tweets chris pratt guardians galaxy vol premiere day^vanderpump rules season premiere shocking hookup is far from its first a timeline cheating rumors^not even twin peaks cast had any idea what eect before premiere but we asked them anyway^ryan murphy elains feud ending^amber rose victim hour home invasion while she slept^jennifer lopez wears 1,148 tracksuit every celeb owns^johnny galecki central california home burns down large fire^yolanda hadid moves new york be close gigi hadid bella hadid^justin bieber hanging out with baskin champion but what about selena gomez^katherine heigl reveals month weight loss after giving birth joshua jr^teen mom amber portwood breaks her silence sex tape negotiations^mandy moore admits her wedding could happen moment notice^pippa middleton james matthews honeymoon paradise^angelina jolie heads disneyland with family friends celebrate daughter shiloh th birthday^channing tatum jenna dewan tatum split what stake financially^chicken leg bitch watch cory murray have elosive argument what happens the abbey^teen mom og tyler baltierra is ready another baby catelynn lowell not so much^ruby rose drags katy perry new music through social media mud^tracee ellis ross talks sex beauty inspiration vogue questions video^katie holmes suri cruise enjoy easter getaway filled with family love gratitude^prince william pays tribute victims manchester attack fa cup final^a john wick tv series is coming starz^shahs sunset asa soltan rahmati gushes over her baby boy he so handsome it insane^survivor zeke smith actor nico santos are dating^oprah winfrey celebrates her birthday with bread ros more favorite things^josh brolin joins deadpool sequel cable^cma awards nominations announced miranda lambert taylor swift more nominees^rihanna meets up with hassan jameel grammys after party^mama june walks her first red carpet since losing over lbs^celine dion finds it very difficult picture her life with another man after ren ang lil death^zoe saldana not mad britney spears over accidental twins announcement^katy perry wants be your late night snack^kourtney kardashian hopes her kids will ''motivate '' scott disick be ''at his best ''^teen mom jenelle evans reacts ex nathan griffith arrest^ciara is homestretch pregnancy singer showcases baby bump polka dot dress^carrie underwood brad paisley team up host cma awards th year row^cmt artists year special set become night hope healing with jason aldean more^paris jackson continues leave her mark fashion world with first met gala appearance^zooey deschanel jacob pechenik welcome son charlie wolf^jason aldean brittany kerr are eecting baby boy^kate upton gets into sexy schoolgirl mode ... baby one more time performance lip sync battle^logan paul youtube channel removed from google preferred after suicide forest video^miss usa kara mccullough makeup bag must haves^the final kardashian christmas card is finally here without kylie jenner^harry styles opening monologue the late late show has dad jokes galore^here what suzette quintanilla has say about kim kardashian amp demi lovato selena costumes^justin theroux was completely moved how the leftovers ends^kim kardashian puts shimmering bra display raciest outfit months^stephen belafonte wants visitation rights mel b eddie murphy year old daughter angel^the bachelorette contestant bryce powers is already internet dog house transphobic comment^playboy model sparks outrage over nude photo atop sacred mountain^jennifer lopez makes first red carpet appearance with her ''macho bello '' alex rodriguez met gala^christopher big black boykin dead everything we know about rob amp big star passing^survivor moves on after zeke smith shares his story with new tribe mates^priyanka chopra is rooting prince harry meghan markle wedding^ellen degeneres favorite fashion moment was this dress^inside kourtney kardashian scott disick family vacation^how create emily ratajkowski glitter eye minus fallout^how george clooney wife amal are counting down until arrival their twins^second wives club shawna craig elains why husband lorenzo lamas has financial problems^vanderpump rules stars lala kent james kennedy feud gets elosive twitter^kim kardashian son saint west was hospitalized pneumonia^southern charm fans prepare for humble kathryn dennis season people can change^billie lourd honors mom carrie fisher late star st birthday with mother daughter twinning photo^mel b under investigation witness intimidation divorce drama continues^sarah michelle gellar gets real her struggle postpartum depression^kylie jenner bike shorts are now 70^george clooney shows off photo his twins suburbicon after party^here why eugenio derbez likes revisit his star hollywood walk fame^kendall jenner is basically naked met gala^how veep caused this politician end up with black eye amp stitches^lipsticks you should spend your paycheck^see who is playing elizabeth smart lifetime movie about her abduction^american idol abc tough one for fox but felt it extremely fraudulent bring back soon^meghan markle scored invite pippa middleton wedding^this is us cast shares some hopefully fake spoilers season red nose day^lena dunham cancels lenny irl tour due worsening endometriosis^adele heartbroken cancel final two shows her tour after damaging vocal cords^praise be the handmaid tale renewed season hulu^tv scoop awards vote best villain best guest star^espys winners the complete list^harry styles never felt need define his sexuality^tamar braxton is not finished with the real i will accept emmy^the assassination gianni versace american crime story finally has premiere date^vanderpump rules stassi schroeder breaks down most notorious murder mysteries^la la anthony removes her wedding ring after carmelo anthony split^justin timberlake works out with son silas burn thanksgiving calories^inside faith hill tim mcgraw 145 million empire private islands record breaking tours more^it alternate scandal universe new th episode promo plus did huck survive^tom brady pulls tom hiddleston with i heart gisele shirt^what feud kelly ripa ryan seacrest slam rumors live tension over american idol return^sean penn his famous friends hit new york city haiti takes root charity event^wonder woman gal gadot is obsessed with this red lipstick^iman shares rare photo her david bowie year old daughter alexandria honor her birthday^reasons why ayesha curry may be real mvp nba finals^flip flop christina el moussa reveals her must have items any summer home^celine dion rocks faux leather overalls sparkling shades paris^the brady bunch cast reunites today talk aging modern tv losing florence henderson^hollywood medium recap tyler henry gives pauly d closure after his best friend fatal motorcycle accident^taylor swift wins song year cma awards little big town accepts her behalf^here your first look cast bobbi kristina brown made tv biopic^tv scoop awards vote saddest cancellation best series finale^pippa middleton wedding everything we know so far^pippa middleton wedding everything we know so far^this american horror story season teaser will give you nightmares^it been years since lauren conrad heidi montag friendship ended looking back what went down^deadpool goes all out apologize david beckham^will smith talks play genie disney live action reboot aladdin^judd apatow supports daughter maude she follows his director footsteps^lindsay lohan channels grace kelly iconic look gives career update^what up blaine izombie david anders talks playing one very complicated dude^rose mcgowan slams meryl streep actresses who will wear black ''silent protest '' golden globes^cheryl burke is strict dance moms but says girls have been traumatized^inside this is us elosive therapy session what comes next^professional golfer rory mcilroy marries erica stoll star studded ceremony ireland^grey anatomy just gave meredith her first patient meet cute seasons with scott speedman^kendall jenner gives major elizabeth taylor vibes th anniversary cover harper bazaar^lana carmella are moving could use little more help from their men total divas^kendall jenner wore ,000 crystals met gala everything else you should know^anna faris was n't into chris pratt love making mixtape i was embarrassed^how prince harry meghan markle keep their romance under such tight wraps^neve campbell reveals she adopted baby boy with jj feild^black panther chadwick boseman recalls his eeriences with racism^you 're doing it wrong drying your hair^chris soules spotted public first time since hit run arrest^the bachelorette picks her fantasy suite dates^leonardo dicaprio foundation donates 1 million support victims hurricane harvey^janet jackson shares first photo her baby boy introducing eissa al mana^kim kardashian tells vogue india what she loves hates about her family^spider man homecoming trailer iron man upgrades peter parker suit mixed results^inside real lives basketball wives^rubber face masks you have try right now^vanderpump rules watch jax taylor go off brittany cartwright after more cheating claims^riverdale casts mark consuelos veronica dad^spencer pratt heidi montag talk future play dates with the hills kids^former fox news ceo roger ailes dead^kim zolciak biermann shares photo son kash dog bite stitches in no time he will heal up perfectly^kim kardashian dresses up aaliyah madonna halloween while kourtney is michael jackson^vin diesel takes e q further proves he cuddliest action star ever^here why internet is flipping out about posting pictures red swimsuit^janet jackson turns how she facing her first birthday year ahead single mom^how does abc dirty dancing remake cast compare original movie stars^billboard music awards craziest red carpet looks^things you need know about the mummy annabelle wallis^the first descendants trailer amp music video are here dove cameron sofia carson more stars sound off^padma lakshmi visits top chef contestant fatima ali before cancer surgery^the night king takes over new game thrones season poster it scary good^ben affleck surprises year old batman fan battling terminal cancer^c line dion is attending her first ever met gala this year ''this is like having job first time ''^meghan markle price fame how prince harry prepared her royal life^ben affleck is not dating just yet following divorce from jennifer garner^farrah abraham goes house hunting with her ex simon teen mom og it ends disaster^you 'll never guess how much jessica simpson airport outfit costs^pairs block heels that are beyond easy walk in^pregnant serena williams aces zebra print maternity wear during pit stop monaco grand prix^how dancing with stars changed normani kordei it helped me discover myself^ashley graham takes tumble time gala red carpet^did reese witherspoon just announce big little lies season^bryan singer fired from directing queen biopic bohemian rhapsody^mtv video music awards returning l.a.^real housewives atlanta reunion shocker are phaedra parks shemar moore dating^kim kardashian wishes kanye west happy year anniversary reminisces about wedding^james corden harry styles ca n't stop singing inappropriate times^jillian michaels heidi rhoades break up call off their wedding^ace cakes star duff goldman reveals dramatic month weight loss^ripped denim pants you can literally wear anywhere^d j vu alert kate middleton is doting big sister pippa middleton wedding^conrad hilton arrested allegedly violating restraining order again^versace american crime story adds max greenfield his one kind mustache^netflix updates reasons why warnings as discussion over subject matter increases^jackass star bam margera is heading rehab after dui arrest^mtv floribama shore first look wiccans plungers jesus candle oh my^britney spears announces final piece me shows las vegas^let talk about biggest pretty little liars fan theories^from chris soules nene leakes find out which your favorite reality tv stars have criminal pasts^iheartradio fiesta latina watch livestream featuring camila cabello cnco ricky martin more stars^tiffany haddish recreates cardi b snl baby bump performance mtv movie amp tv awards^britney spears has come long way years after head shaving incident^your tv reboot revival guide from roseanne dynasty everything between^star wars the last jedi sneak peek see vanity fair four exclusive covers^queen elizabeth ii visits manchester arena attack victims hospital^how jennifer lopez alex rodriguez kids spent easter together dominican republic^kate spade avicii verne troyer more stars we lost^daytime emmy awards winners the complete list^daytime emmy awards winners the complete list^dutch game show asks male contestants guess if women are fat pregnant^colorful faux fur jackets under 100^abc dirty dancing remake will reveal what happened baby johnny after original movie ended^francia raisa debuts new boyfriend instagram things know about chris adkins^ellen degeneres scares matt lauer with savannah guthrie impersonator now i wet my suit^worst dressed mtv movie amp tv awards holland roden shannon purser amp more^melania trump ivanka trump don black veils meet pope francis vatican^jamie foxx criticized allegedly making fun sign language^eddie redmayne wife hannah welcome baby no^adele unites with jennifer lawrence cameron diaz women march^inside angelina jolie first mother day since her divorce from brad pitt^selena gomez reunites with timoth e chalamet before oscars^sophia bush birthday message hilarie burton makes us want one tree hill reunion right now^celebs are saying yes thigh high slit this summer^the art instagram relationship taught by celeb couples^best th july sales^blake lively ryan reynolds are golden couple met gala red carpet^april giraffe newborn calf sex revealed^we betcha did n't know miley cyrus was in guardians galaxy^jodie sweetin ex justin hodak violates restraining order again police called actress home again^harry styles others confirmed victoria secret fashion show performers^kobe bryant performs slam poem about steve urkel that you wo n't want miss^the unsolved murder tupac shakur untangling epic layers mystery surrounding case^scarlett johansson colin jost make first public appearance together snl party attended beyonc^sugar bear denies mama june abuse allegations she ''pissed '' over my marriage jennifer lamb^does hollywood hate easter bunny^check out emma watson impromptu harry potter reunion the circle tribeca film festival premiere^protesting too much why celebrity couples try deny their breakups long possible^every bachelor nation contestant kicked off show past relationship drama^los angeles district attorney declines prosecute ed westwick alleged sexual assault^jesse williams minka kelly are dating inside their private romance^jennifer lawrence has justin theroux emma stone over dinner^madison beer is bringing back bandeau^once upon time renewed season^donald trump jr. cuddles with daughter after vanessa files divorce^still star crossed royalty medalion rahimi takes e q after googling covfefe that is^cute amp surprisingly sexy halloween costumes^paris jackson reveals she was mistaken homeless person while set^kourtney kardashian poses bikini egypt see more pics celebs summer vacation^j balvin releases new single music video mi gente^ashley graham her met gala look ''we had make it very ashley ''^eva longoria latest film lowriders is all about family american dream yes some very sexy cars^road rules star danny dias dead^where is chris soules bachelor star involved deadly crash remains hiding arraignment date nears^how lifetime michael jackson searching neverland cast compares their real life counterparts^lady antebellum earth wind amp fire more musical pairs perform cmt music awards^mom be brie bella thanks fans their support after hospital ''scare ''^the ultimate betrayal marie avgeropoulos sounds off devastating end conclave^kris jenner plays coy over kylie jenner daughter name^angelina jolie wears silver gown brings shiloh zahara annie awards^sunscreens that celeb makeup artists love layer with makeup^khloe kardashian includes pregnancy photos her top pics^game thrones cast most hilarious behind scenes moments^who will play princess diana feud the latest from ryan murphy^get ready impending bethenny frankel ramona singer battle real housewives new york city^mommy amp me fashion inspired north west kim kardashian^did scandal fall finale really just kill spoiler^kim kardashian shares cutest video yet chicago west^busy philipps says she earned more from social media posts than acting i 'm not above it^kendall jenner blake griffin almost make things red carpet official^sharon stone sons are all grown up rare red carpet appearance^why lala kent boyfriend randall emmett thinks she not just reality star^joe jonas admits it would ''dream '' do duet with kacey musgraves^roseanne is officially returning home with revival abc^chrissy teigen shares luna beauty obsession it adorable^urinating sketchy dog statue appears next fearless girl wall street^the voice season is ready make some noise with miley cyrus jennifer hudson adam levine blake shelton^supreme court declines hear appeal making murderer brendan dassey^serena williams pens emotional note her unborn baby you gave me strength i did n't know i had^brie larson captain marvel costume is n't what fans eected^ellen degeneres baby name ideas eva longoria will make you laugh out loud^kim kardashian reunites with real todd kraines he has message fans please stop^naked kourtney kardashian gets wet wild nsfw video from mexico^teen mom star amber portwood engagement matt baier is on hold^deadpool is coming tv thanks donald glover fxx^emma watson says tom hanks is all things you want him to be^parenthood erika christensen opens up about her relationship with scientology^lady gaga debuts new single the cure gets much love coachella^steve harvey ex wife sues him 60 million dollars alleges torture child endangerment more^riverdale lili reinhart gets real about her cystic acne^law order svu mariska hargitay pens touching tribute her show crew^ryan reynolds blake lively make cameo snl melissa mccarthy makes mom superstar^are lea michele criss cross sandals ugly fashionably ugly^cardi b came through dripping style billboard latin music awards^hgtv star nicole curtis shane maguire custody battle gets uglier^jamie foxx singing bitch better have my money opera is something you just have hear^yvonne strahovski struggled turn off her empathy the handmaid tale^was zendaya high school musical fan star dishes her zac efron shared disney past^courtney love takes center stage haunting menendez blood brothers trailer^ben stiller enjoyed pizza italy trip before he christine taylor announced split^chance rapper is engaged kirsten corley watch surprise proposal^fun facts we bet you did n't know about meghan markle^surprising celebrities who 've voiced characters kids shows^c line dion year old twins look all grown up parisian shopping trip^kylie jenner cuts off all her hair again amid pregnancy rumors^mtv movie amp tv awards moments you did n't see tv^leonardo dicaprio gets cozy with year old model camila morrone coachella^you 're doing it wrong kim kardashian clear skin met gala^bristol palin reflects becoming teen mom years ago^lilly ghalichi is married former shahs sunset star weds dara mir^taylor swift returns instagram after months but remains mia real life what she been up to^prince william opens up about th anniversary princess diana death ''i still find it difficult now ''^the big skin care change elle macpherson made after^one direction fans gush over new rare photo louis tomlinson briana jungwirth son freddie^all details giuliana rancic sag awards dress^kourtney kardashian is moving on here why her family will never break up with scott disick^clapback queen chrissy teigen shares her social media secrets^ben higgins leaves bachelor winter games admits he still has move on lauren bushnell^which spf sunscreen do you need a celeb skin eert weighs in^riverdale arrow are moving new nights the cw fall schedule^everything we know about return twin peaks^ed sheeran releases galway girl music video starring saoirse ronan^the most original laughable kentucky derby horse names history^jessica chastain disturbed representation women film cannes film festival^pete davidson debuts ariana grande tribute tattoos after confirming relationship^supernatural premiere how son satan is changing show^did president donald trump just forget words national anthem^meghan markle wears queen favorite nail polish her wedding day^kendall jenner bella hadid more serve up serious style paris haute couture fashion week^cory calls murray f king mess after catching him all over another man what happens the abbey^see tear jerking moment nikki bella john cena decide call off their wedding break up total bellas^that thing you do cast has reunion years later rocks out of course^liam hemsworth joins miley cyrus snl surprise appearance^jenna dewan tatum talks about sex with channing tatum plans baby no^mtv movie amp tv awards announce generation award winner^dylan farrow addresses sexual abuse claims against woody allen i am telling truth^girl top round vote sweet now^ariana grande was ''so shaken up '' after manchester bombing camila cabello says^katherine heigl gushes over her marriage josh kelley how her daughters have embraced being big sisters^sally field plays matchmaker son sam olympic skater adam rippon^the bachelorette alum britt nilsson is engaged jeremy byrne who proposed sweetest way^amy smart defends husband carter oosterhouse after sexual misconduct accusations^amy schumer shares this skin care step with her dog tati^things you need throw coachella party like joe jonas^london plastic surgeon stars victim cyber attack could royals be affected^shania twain joins the voice season key advisor^how stephen colbert got angry remade late show finally got be himself^badass moments from kingsman the golden circle trailer gifs^hgtv drew scott dishes his italian wedding honeymoon ecuador^property brothers drew jonathan scott turn clown around throwback pic^jessica simpson learned important lesson from being every size^karen rodriguez releases music video happy april fools^fox fall tv schedule a few shows are move ... new girl is mia^teen mom jenelle evans reacts ex courtland rogers arrest^teen mom tyler baltierra tweets about rough thanksgiving without catelynn lowell^katie yeager normal life after teen mom how former mtv star started over moving utah^c line dion pays tribute titanic emotional billboard music awards performance^reese witherspoon visits her old college dorm room meets student living it^all eensive ways celebrities are going coachella without paying dime^ariana grande pens powerful essay after manchester attack ''we will not quit operate fear ''^lady gaga boyfriend christian carino take their romance hamptons^erika jayne poses completely nude instagram ''i 'm living my life fullest ''^riverdale camila mendes sparks romance rumors with victor houston^gigi hadid is wearing these denim trends right now shop style^paula abdul talks exciting american idol revival new tour^phaedra parks is n't first the real housewives have epic fall from grace^the amazing rock unbreakable kimmy schmidt crossover that never was but could still happen^shahs sunset season trailer is finally here^the kardashians are selling their designer clothes just time mother day^bradley cooper photobombs brad pitt makes onstage appearance glastonbury^john dickerson replaces charlie rose cbs this morning^chrissy teigen is blown away by gifting queen kris jenner birthday presents baby luna^amy schumer attends met gala year after calling fashion event ''punishment ''^lili reinhart gives cole sprouse look love during midnight breakfast^katy perry is still being asked about her ''bad blood '' with taylor swift here her response^dakota johnson hairstylist mousse is new sea salt spray^james corden pays tribute manchester heartfelt monologue^the first new footage twin peaks revival is here it eerie^joseph duggar weds kendra caldwell dubs their first kiss amazing^inside angelina jolie surprisingly visible new life after her split from brad pitt^jennifer lawrence fine after private plane forced make emergency landing due engine failure^the arrangement betrayal revealed megan learns her best friend hope leaked her nude photos^what next for nick viall dancing with stars contestant is ready get polished^stove top is making stretch pants us all wear during thanksgiving^bella hadid dior top is made denim cool right^girlboss britt robertson elains what exactly title her show means^sandra bullock bryan randall step out arm arm during family vacation wyoming^does christopher meloni regret leaving law amp order svu^meghan mccain joins the view as regular co host^kailyn lowry girlfriend makes her teen mom debut^why brad pitt won jolie pitt war throwing himself his sword^inside olivia culpo dior cruise fashion show diary^ariel winter sarah hyland prove growing up front camera is endless obstacle^mel b restraining order against former nanny extended until amid divorce drama^billie lourd makes surprise appearance star wars celebration honor mom carrie fisher^nick jonas priyanka chopra are engaged^katharine mcphee defends her engagement david foster with sassy clapback^the o.c benjamin mckenzie autumn reeser have mini reunion^here why chance rapper baby kensli are one cutest father daughter duos instagram^carrie fisher debbie reynolds home personal items sold^meghan markle suits cast heading texas celebrate th episode^will mama june maintain her pound weight loss wendy williams delivers her honest prediction^oliva wilde latest hair makeover is not missed^nbc changes its mind moves this is us back tuesdays see what else is move^knicks ex coach derek fisher arrested dui after flipping car with basketball wives star gloria govan^rita ora victoria beckham have this tech accessory common^here why internet thinks selena gomez the weeknd are working new music together^aaron carter elains again why he so skinny basically i have eating disorder^kanye west not attending met gala kim kardashian go solo^ashton kutcher gives rare insight into first lonely days after demi moore divorce^zoe saldana just wore new leather pant^chanel west coast opens up about big black death it just super tragic^taylor swift joe alwyn rendezvous after her jingle ball performance^notorious b.i.g son makes rare public appearance rapper billboard music awards tribute^miley cyrus ca n't stop wearing this designer you do n't yet know about^this coldplay superfan got surprise lifetime after crowd surfing his wheelchair chris martin^the most memorable onstage kisses history mtv movie tv awards^paris jackson gives major marilyn monroe vibes vanity fair newest ''it girl ''^justin theroux not threatened jennifer aniston success^maria menounos diagnosed with brain tumor her mom is fighting stage brain cancer^dwayne johnson announces presidential run with tom hanks snl^diamond designers are star best friend how jennifer meyer became ultimate hollywood connector^only chrissy teigen can make being caught rainstorm look this fabulous^aaron carter looks healthy he spends thanksgiving volunteering less fortunate^kourtney kardashian best holistic beauty secrets revealed^lea michele reveals her fitness motivations opens up about her personal music^lauren conrad bares baby bump bikini launches first swimwear line^jenna johnson dancing with stars pros share their behind scenes health fitness secrets^you 'll never look beauty beast same after seeing dan stevens before cgi^blake shelton reminds fans that gwen stefani is greatest^the craziest facts from pippa middleton extravagant wedding^chris harrison why you might want murder whaboom guy the bachelorette^justin timberlake jessica biel are perfect match wimbledon^decor tricks inspired ellen degeneres portia de rossi 45 million estate^sharknado celeb cameos are insane including charo queen england fabio pope^christina el moussa could see herself marrying boyfriend ant anstead^scott baio will not be charged nicole eggert sexual assault case^parks recreation cast reunites support aubrey plaza see more tv stars reunions^chrissy teigen knows who allegedly bit beyonc face but she wo n't tell^jersey shore ronnie ortiz magro girlfriend pregnant with their first child^jane fonda did n't think she 'd live be i feel very blessed^zendaya dazzles spider man homecoming premiere see stars red carpet^olivia newton john says she feeling great months after revealing breast cancer relapse^nicole williams stresses out fianc larry while talking about all pressure wedding planning wags^people choice awards coming e^things celebs do every day get fit according julianne hough trainer^casting jonben t does n't solve murder jonben t ramsey but it may tell you something about yourself^leslie jones best hosting moments from bet awards^kim kardashian goes surprisingly simple met gala^stunning details you need see from a wrinkle time premiere^ben affleck gal gadot ray fisher ezra miller pose adorable justice league selfie^kendall jenner bringing this bikini style back^bachelor paradise stars tanner tolbert jade roper are eecting baby girl^jennifer hudson joins the voice season^see johnny depp daisy ridley murder orient eress trailer^serena williams alexis ohanian waiting learn sex their baby^joan smalls proves denim liner will be major fall trend^beyonc has destiny child reunion showcases daring maternity look^what happens the abbey star daniel says his hair is insured 750,000 watch^vampire diaries claire holt engaged andrew joblon^dorinda medley goes after sonja morgan with vaginal critique grey gardens references intense rhony preview^if kate middleton engagement dress came every color ...^everyone is screaming each other this shahs sunset season premiere sneak peek^jax taylor breaks up with brittany cartwright vanderpump rules but what their status now^lady antebellum imagine dragons more react their grammy nominations^botched recap see patient darlene transformation from downward nipples perfect d dubrow^ed sheeran settles 20 million plagiarism lawsuit ''photograph ''^bella thorne strips down gets real about fame i have had really dark thoughts^andy cohen crashes tv reporter taping jokes he shameless camera whore^teen mom tyler baltierra opens up about his depression emotional therapy session i do n't feel joy^olympic figure skater adam rippon reveals struggle with body image extreme dieting^princess charlotte net worth is more than 3.8 billion more than prince george^will amp grace first official revival poster is here it got jokes^we finally learned what happened barb from stranger things thanks mtv movie amp tv awards^arrow finale ends season bang who might not have survived^jimmy fallon dwayne the rock johnson bring man tears while photobombing tourists^hot mug shot guy jeremy meeks kisses topshop heiress chloe green ... but what about his wife^tom hardy becomes real life superhero hollywood style chase^rod stewart penny lancaster renew vows donate wedding money grenfell fire victims^farrah abraham rocks completely sheer jumpsuit night out las vegas^pay attention tracee ellis ross style here why^worst dressed met gala daisy ridley sofia sanchez barrenechea amp more^how wear sneakers with dresses like selena gomez pippa middleton^jennifer lopez alex rodriguez take their romance dominican republic with 100,000 getaway^prince harry interviews barack obama do i need british accent^shay mitchell high waisted swimsuit is igniting something all us^kim richards joins the real housewives beverly hills reunion savage awkward exchange with lisa rinna^did prince harry really drive miles get meghan markle inside pippa middleton wedding reception^where was meghan markle pippa middleton wedding^meghan markle prince harry photographed arriving pippa middleton wedding reception^miss usa k ra mccullough clarifies her controversial stances feminism health care^the real housewives new york city dinner blowout bethenny frankel ramona singer give their sides story^kevin can wait loses erinn hayes but gains leah remini as series regular^how paris jackson officially became new it girl^russell simmons accuser tells megyn kelly he privately apologized^brad pitt produce movie about new york times harvey weinstein investigation^lindsay lohan camila cabello were taylor swift biggest fans jingle ball^the originals klaus amp hope eat beignets this adorable sneak peek^chris cornell wife vicky pens emotional open letter her ''soulmate '' days after his suicide^eva longoria is pregnant actress eecting first child with husband jose bast n^chrissy teigen struggling zip up her outfit is anyone who ever tried clothes^jennifer lopez alex rodriguez are already talking about marriage^jennifer lopez reveals how her romance with alex rodriguez got started spoiler alert cobb salad was involved^rebel wilson accuses male star sexual harassment^coco chanel defy gravity yet again with their latest yoga pose^miss america ceo sam haskell resigns amid email controversy^c line dion looks like belle she performs beauty beast song very first time^the girls series finale will be missing half girls it not ok^meet bilquis let talk about american gods premiere craziest scene^nicole kidman says big little lies season stories are rich deep^snow white parody film under fire body shaming^you can now feast groot bread thanks disneyland^ariana grande fans evacuated from concert after serious incident inside manchester arena^jessica simpson celebrates son ace knute birthday with moana themed party^here comes bride pippa middleton arrives church her wedding james matthews^jennifer garner wishes ben affleck happy father day with touching tribute^shawn johnson disgusted with usa gymnastics says it failed protect young athletes^here what bella hadid was doing while the weeknd selena gomez cuddled up coachella hint it intense^the uneected dress every celeb is wearing spring^lindsey vonn others take selfies winter olympics closing ceremony^dorinda medley cuts right point with sonja morgan real housewives new york shut your mouth^bradley cooper irina shayk welcome first child^jenni jwoww farley roger mathews prove just how much life has changed since jersey shore^the real housewives atlanta reunion concludes with complete undoing phaedra parks^this streetwear brand is khloe kardashian kanye west approved^star wars the last jedi trailer luke skywalker tells rey it time jedi end^brad pitt epic romantic history every star he dated including ones you forgot about^what eect the bachelor winter games^michael bubl sets public return following son noah cancer battle^scott disick sophia richie get playful they step out smoothies^ranking ellen degeneres best hidden camera earpiece pranks from adam levine adele^sofia richie is giving plaid fall upgrade^dove cameron reveals how she copes with anxiety^you 're doing it wrong lining your lips^katrina american crime story elects dennis quaid play george w. bush^it been years since richard gere last saw pretty woman^dear white people trailer tackles controversy head on^lily collins proves torrential downpour is now hair trend^star wars the last jedi movie secrets revealed vanity fair^groot is actually dead baby groot is his son^kenya moore shares first photos from her super secret wedding^demi lovato parties with jamie foxx paris hilton wiz khalifa sorry not sorry video^eddie cibrian responds brandi glanville accusations about leann rimes^kate middleton is back work after pippa middleton whirlwind wedding weekend^t.i is proceeding with his divorce from tameka ''tiny '' cottle^lawrence ca n't help but laugh his doctor semen sample comment what happens the abbey watch^donal logue child is still missing after almost week we want you home jade^stranger things millie bobby brown breaks down while accepting best actor show award mtv movie amp tv^scarlett johansson hooking up with snl colin jost all details their fun casual romance^hgtv stars under fire why network biggest names all seem be getting sued^rebecca gayheart files divorce from eric dane after years marriage^tom brady skip new england patriots white house visit^eric dane battling depression production paused the last ship^the crazy funny way tracee ellis ross puts moisturizer^kristen wiig cast wonder woman patty jenkins confirms^japanese beauty brands you ca n't find sephora^jordin sparks celebrates low key baby shower with dana isaiah family^nashville charles esten host cmt music awards plus find out who performing^missing scandal do n't fret dear white people is here help^a timeline sarah jessica parker kim cattrall never ending sex city feud^why barry manilow kept his sexuality down low decades^james corden lionel richie parody dancing on the ceiling video^prince george princess charlotte wedding outfits are surprisingly affordable^you 're doing it wrong sleeping acne cream^kim zolciak biermann rings th birthday thong bikini^chrissy teigen is not impressed with john legend birthday post^kelsea ballerini learned this piece marriage advice from nicole kidman keith urban^chad michael murray shares first photo baby daughter with emotional tribute wife sarah roemer^serena williams will be awesome mom fianc alexis ohanian says^days ways sara sampaio is giving us major sneaker envy^khloe kardashian posts adorable new photo ''mommy little love '' true thompson^you got ta see what happened billboard music awards years ago^old school brands that are making major comeback^grey anatomy introduces station leading lady andy herrera^house cards returns what you need remember about season before watching season^mark ronson wife josephine de la baume files divorce after years marriage^christopher ''big black '' boykin dies look back his most memorable moments with rob dyrdek^jennifer garner turns all details her birthday party^jimmy kimmel cries he pays tribute late don rickles^amber heard elon musk walk arm arm during first public outing together^governors ball lineup includes eminem halsey travis scott^this invite only cabo dinner goes so wrong so fast it 'll make your head spin^these mila kunis inspired holiday dresses ring under 100^ozzy osbourne sharon osbourne renew their wedding vows year after brief split^southern charm cameran eubanks announces she pregnant find out the sex her baby^amal clooney throws george surprise birthday party with cindy crawford rande gerber help^lea michele reveals her secrets getting shape bikini season^inside war jolie pitts how brad angelina went bitter enemies friends^the love actually sequel is finally here thanks red nose day^emily vancamp reveals her plan double endangered tiger population^reasons why slammed car seat headrest who contributed song soundtrack^prince ex wife mayte garcia looks back their love his year death anniversary he was one kind^kesha rainbow debuts no.1 inside her journey release album her own terms^things billy bush revealed in his first interview since lewd tape scandal today exit^riverdale star lili reinhart says show ''saved '' her during her ''worst depression ''^meet your next hgtv obsession home town erin ben napier love home renovating^sexy new year eve outfit ideas no sequins required^megyn kelly receives warm welcomes from hoda kotb today show crew let have some fun^chris pratt gushes over perfect anna faris jokes about his boob sweat^gigi hadid amp lily collins just wore exact same pair jeans^pippa middleton brings part royal wedding her own wedding^prince george was adorable page boy just like dad prince william was child^hit hype celeb pros debunk skin care trends^camila cabello makes her debut solo artist during billboard music awards performance^bachelor paradise derek peth taylor nolan are engaged all details her engagement ring^david ross never thought he 'd make dancing with stars finale^simon cowell new boy band prettymuch could be next one direction^nia jax challenges ronda rousey match i will happily oblige^scott disick sofia richie get flirty yacht^andy cohen sounds off phaedra parks real housewives atlanta dismissal no one wanted anything do with her^the taken season finale finally delivers moment you 've been waiting a threatening bryan mills speech^john oliver publicly confronts dustin hoffman over sexual harassment allegations^hoda kotb brie bella other stars celebrate their first mother day moms^the proposal pulls second episode after contestant accused facilitating sexual assault^beyonc baby gift woman carries curious package hospital birth speculation grows^how get away with murder sneak peek spoiler might be next dead body^sophia bush leaving chicago pd after seasons^see how disney has transformed their animated classics into live action blockbusters^meghan trainor daryl sabara make hearts melt with their sweet year anniversary messages^the greatest moments from royal wedding from smiling page boy candid celebrity reactions^christina aguilera is finally doing carpool karaoke james corden primetime special^saturday night live leslie jones continues her weight loss journey inside her fitness routines^billboard music awards things know before big event^inside kaley cuoco karl cook glam ranch wedding^drake bruno mars ed sheeran celine dion amp more perform billboard music awards^how victoria secret model lais ribeiro makes 2m fantasy bra look sexier^gwyneth paltrow spends thanksgiving weekend with rumored fianc brad falchuk ex chris martin^inside ashley greene paul khoury fairytale wedding forest^there hot grandma who looks exactly like scarlett johansson they 're about get drunk together^red carpet lipstick hues inspire your valentine day beauty^emily vancamp flashes her engagement ring shares proposal details^nikki bella finally got her fairytale ending with john cena dream proposal says total divas nattie neidhart^lady gaga ex taylor kinney attends her chicago concert fans are loving it^ellen degeneres still scares anne hathaway after prank goes awry^ellen degeneres portia de rossi evacuate pets from home under threat from california fire^how corinne olympios is coping with bachelor paradise investigation^teen mom kailyn lowry graduates college^pippa middleton wears something blue parasnowball weeks before her wedding^game thrones spinoff alert hbo working new projects about westeros^kim kardashian attends her year high school reunion^amy poehler will ferrell play the newlywed game with hilarious results^is amy schumer ready have kids people really get mad if you do n't have baby^melissa etheridge smokes weed with her kids it brings you closer^green power ranger jason david frank speaks out after being targeted gunman^harry styles has message ex girlfriend taylor swift^you 're doing it wrong emma roberts dotted eyeliner trick only takes seconds^disney fans brace yourselves frozen broadway cast is costume first time^even the challenge champs vs. pros star athletes are annoyed by johnny bananas we 're gon na shut him up^the daily show jon stewart reunites the late show stephen colbert^a christmas story live musical coming fox just time holidays^here how jessica alba mindy kaling will probably decorate their nurseries^the view sara haines gives birth baby no^best hats pippa middleton wedding ranked^selena gomez pilates trainer reveals booty perfecting workouts^pete davidson gushes about ariana grande onstage comedy club^heidi montag showcases her baby bump she celebrates her first mother day mom be^behati prinsloo describes motherhood raising baby dusty ''heaven '' met gala^emily ratajkowski cannes bikini was bold choice^are you one kathryn palmer reacts those romance rumors with the bachelorette robby hayes^olympic gymnast aly raisman names former u.s. national team doctor alleged abuser^former property wars star scott menaged arrested after fraud investigation^see the voice new block button action ahead season premiere^billboard latin music awards complete list winners^lea michele gushes over c line dion billboard music awards performance fashion police i cried^sam hunt opens up about married life with hannah lee fowler billboard music awards^tori spelling celebrates th anniversary with dean mcdermott hottest soccer dad^jenelle evans reaches custody battle agreement over son jace ''i 'm happy but devastated ''^american crime story switcheroo the assassination gianni versace will now air before katrina^anna wintour is made dame queen elizabeth ii wears her signature look^justin bieber tattoo artist bang bang reveals meaning behind new torso ink^ryan reynolds love note blake lively is met gala sweetest surprise^dove cameron sofia carson share descendants rehearsal photos^kendall jenner gets candid about her debilitating anxiety^the complete fall tv schedule is officially here^saturday savings gigi hadid cropped jeans are sale^jackson odell from the goldbergs dead age^which character from the arrangement are you take our personality quiz find out^scott disick sofia richie pack pda new york^guy ritchie puts king arthur star charlie hunnam fitness blast^jamie lynn spears is pregnant with her second child^ariel winter is living with boyfriend levi meaden gets kiss cook^tom holland zendaya bump into spider man statue^rent is fox other next live musical^rihanna drake reunite kid birthday party los angeles^dorinda medley has new real housewives new york city tirade catchphrase you 're going love it^kyle gets gun after stalker breaks into his house the arrangement the ultimate target was you^wonder woman london premiere canceled after manchester bombing^it finally happened southern charm craig conover just passed bar exam^katie holmes throws suri cruise th birthday party with three cakes^amber portwood fianc matt baier tells all shocking revelations from his new memoir^scarlett johansson her raunchy friends have killer time new rough night trailer^here how recreate kim kardashian kourtney kardashian mexico getaway whopping 122,000^soleil moon frye hears from her late father gets important message about her mother health hollywood me^kerry washington talks showing off ''those curves '' met gala^watch becky g elain diego boneta what caused wild moment fifth harmony concert^kylie jenner the chainsmokers selena gomez other celebs who 've crashed proms^katy perry carpool karaoke addresses feud with taylor swift she started it it time for her finish it^eliza dushku engaged peter palandjian^kelly rohrbach is dating walmart heir steuart walton^new england patriots rob gronkowski crashes sean spicer white house press briefing^jennifer lawrence does n't know kim kardashian considers her friend^paris jackson shares rare photo younger brother blanket^channing tatum pens powerful letter daughter everly about love men sex^critics choice awards complete list movie tv nominations^here proof that taylor swift joe alwyn romance may date all way back october^prince william visits with young cancer patient who jokes he ''too old '' her marry^katie couric breaks her silence matt lauer sexual harassment allegations^how miley cyrus continues give fans best both worlds long after her hannah montana days^phaedra parks is not returning the real housewives atlanta^jimmy fallon breaks silence donald trump interview hair ruffle i did n't do humanize him^twin peaks cast remembers first time they heard about revival i thought it was joke^kanye west mysteriously deletes instagram twitter^from princess diana prince harry why royal family is getting candid about mental illness like never before^styled spencer pratt how break out men wardrobe rut^armie hammer calls out double standard between nate parker amp casey affleck treatment hollywood^attention pippa middleton luann d'agostino schools us how plan perfectly classy wedding^mariska hargitay promises law order svu finale is compelling amp absolutely frightening^teresa giudice shows off ripped bikini body her first bodybuilding competition^christina grimmie family gets emotional she honored humane society gala^arie luyendyk jr. lauren burnham are king queen awkward kisses^fantastic beasts where find them sequel casts jude law albus dumbledore^reasons we 'd totally move into nicole richie chicken coop^how look like victoria secret angel steps^luann de lesseps sit down with andy cohen ... it about tom^onerepublic ryan tedder verge nervous breakdown i hit psychological wall^charlize theron elains how having kids actually helps her ocd^director luc besson ''flatly denies '' french actress rape accusation^a tale quail eggs what it like be guest masterchef jr^ethan embry reveals secret battle with opiate addiction^kevin mckidd divorce finalized grey anatomy star pay 22k child support^carmen sandiego is officially happening with gina rodriguez netflix^lainie kazan attorney speaks out about her arrest^sesame street creators sue over melissa mccarthy ''ejaculating puppets '' movie^prince william jokes midwife trainee might see you sooner than you think^lea michele reveals glee worst song ever^riskiest looks kids choice sports awards lindsey vonn ronda rousey more^beyonc shares rare photos her twins rumi sir carter^netflix announces july movie tv titles say hello titanic goodbye how lose guy days^real housewives orange county shannon beador addresses weight gain ahead season premiere^inside bristol palin first week as mother three how her newborn ''changed whole dynamic our family ''^supergirl welcomes back calista flockhart final season episodes^rob kardashian dream kardashian celebrate his birthday st patrick day^cute watermelon accessories that are almost as good as real thing^southern charm craig conover is starting clothing line ... his girlfriend probably wo n't be wearing it^jean shorts are you wearing them right^chiquis rivera reveals her beauty routine how she prepares red carpets^beyonc blue ivy matching dresses will melt your heart break your bank^netflix may movie tv titles announced say hello brad pitt riverdale goodbye jurassic park^sabrina teenage witch cast reunites l.a. some stars meet first time^tina fey gives mean girls broadway musical update^janet jackson creative director speaks out about her split from wissam al mana^michael strahan holiday gift guide feels like home^paul mccartney pirates caribbean dead men tell no tales poster revealed^the arrangement deann confronts man blackmailing megan i will put you ground^jennifer hudson finally gets her grammy the color purple thanks ellen degeneres^zac efron will star one most notorious terrifying serial killers all time^tom brady hangs up radio hosts his daughter defense^years after jon amp kate plus how gosselins blazed reality tv trail imploded along way^oscars everything you did n't see award show^olivia munn acne trials cortisone shots acid peels amp more^red carpet trends make your mark with style^how melania trump is celebrating her first birthday flotus^girls movie here are lena dunham co stars life plans after hbo series finale^lola monroe confronts crystal smith the platinum life ''stop making me out be person with f king pr^total divas stars eva marie amp maryse plan baywatch photo shoot i 'm freaking out^everything you need know about next phase true crime tv^tom hardy rap mixtape from surfaces online^heather morris is n't alone reality tv most shocking eliminations^michelle branch gets engaged to black keys patrick carney while celebrating her th birthday^why bonner bolton dancing with stars partner sharna burgess is thanking him after their elimination^kim kardashian sets record straight kanye west not monica rose was responsible my style transformation^how make perfect top knot bun^julianne hough is all smiles bikini her brooks laich honeymoon^the bachelor chris soules arrested allegedly leaving scene after fatal car crash^wwe hall famer nikolai volkoff dead age^rob kardashian pays tribute blac chyna mother day^james cromwell speaks out after jail sentence anyone with sense outrage is compelled resist^ariana grande breaks her silence after mac miller split^josh duhamel eiza gonzalez break up after five months^law amp order true crime the menendez murders trailer promises finally tell true story^teen mom catelynn lowell tyler baltierra daughter nova reunite with carly first time years^scott disick stirs up drama with kourtney kardashian taking bella thorne cannes film festival^oh baby serena williams journey from drake drama under radar happiness^faith hill was lied about her birth mother history^anthony bourdain most outrageous candid quotes^rupaul drag race all stars crowns winner^billboard music awards nominations the full list^flip flop stars christina el moussa tarek el moussa sued realtor over 37k alleged unpaid wages^second wives club recap shiva safai becomes cover model nasty feud erupts katie cazorla mermaid party^scooby doo pa pa is new dance craze that you need know about^how stars like jessica biel josh duhamel gisele b ndchen went green honor earth day^jersey shore cast gets party started first day filming reunion^richard simmons gives shout out hospital staff after health scare^shakira me enamor music video with gerard piqu brings us back day they fell each other^you 're doing it wrong customizing your denim^kylie jenner travis scott show pda jordyn woods mom birthday dinner^taylor swift makes very sizable donation houston food bank after hurricane harvey^zayn malik showers gigi hadid with kisses cake her birthday^prince william prince harry are literally walking princess diana footsteps^wags la star nicole williams marries larry english we 're both so full love this moment^smarts get stars famous ladies their techy men^the handmaid tale your guide citizens gilead^khloe kardashian thinks about getting nose job every day^jennifer hudson will make her the voice debut earlier than thought with special performance^vanessa hudgens just made straw hat cool again^chrissy metz is one people most beautiful what she telling her teenage self^emma stone surpasses jennifer lawrence become highest paid actress^lady gaga bradley cooper rock out first set photo from a star is born^was megan morrison poisoned by institute the arrangement watch find out^enrique iglesias amp anna kournikova signs that twins were way^carolina herrera speaks out after nephew is killed venezuela^david spade recalls kate spade beautiful spirit one month after her death^beauty essentials you need this festival season^best street style from cannes film festival^does raven have savior the this sneak peek has us wondering if there hope^eminem fans scared gunshot sound effects his bonnaroo show^khloe kardashian says she motivated kim kardashian ''best body ever ''^kim kardashian reveals her new year resolution that easier said than done^bethenny frankel ex husband jason hoppy arraigned additional charges^how much it costs live it up paris like jennifer aniston justin theroux^american horror story season adds scream queens vet billie lourd^armed robbers reportedly steal 1 million from a ap rocky home^billboard music awards winners the complete list^pharrell williams helen lasichanh kick off met gala red carpet and we spy ripped denim jeans^kate hudson arm workout involves bottles ros^romances baby news more all events that influenced drake scorpion album^was harry potter jock nerd fans are divided over this theory^o.j simpson the lost confession is first time he ever publicly talked about that terrifying night^selena gomez reflects reaching ''life death '' point after lupus diagnosis^telemudo adamari l pez speaks out after being body shamed swimsuit photo^bella hadid practically naked this crochet top amp pant^shockers from caitlyn jenner memoir what kardashians have say^it official kate hudson danny fujikawa make their red carpet debut couple^luke pell confirms he not headed bachelor paradise it just did n't feel right^katy perry reveals meaning behind swish swish amid rumors song is about taylor swift^alicia silverstone breckin meyer are anything but clueless film special screening^new edition honored with lifetime achievement award bet awards^niall horan releases his second single slow hands^justin bieber selena gomez celebrate their reunion with kiss because young love never dies^brad pitt is all smiles during surprise appearance lost city z premiere^catfish resume filming after nev schulman sexual misconduct claims found not credible mtv says^katy perry orlando bloom visit castle during romantic prague getaway^disneyland has its own version unicorn frappuccino the pink pegasus^vanderpump rules brittany cartwright chokes up over jax taylor cheating admission^thomas rhett daughter willa was real star show today^this unprompted beauty beast moment gives entire cast goose bumps^ellen degeneres th birthday party was lit craziest stories^animaniacs may be coming back tv near you^drake becomes coolest chaperone history after taking his cousin prom^you do n't have be gigi hadid wear maxi dress^chrissy metz joins latex dress club mtv movie amp tv awards^gifts kate middleton would love mother day because she uses them lot^gypsy sneak peek is naomi watts worst therapist ever netflix new show^jill duggar new nose piercing has fans freaking out^katie cazorla hilariously disses tania mehra yacht second wives club is that recycling barge^did scott disick send kourtney kardashian bella thorne flowers same day^hoda kotb gets emotional her last days maternity leave^kelsea ballerini bachelorette weekend featured selfies with jennifer lopez bridesmaids impressions^chrissy teigen arthur throw shade john legend easter bunny outfit^what corinne olympios remembers from night bachelor paradise incident^solo a star wars story premieres hollywood see all red carpet photos^how rihanna enhances her best assets how you can too^timoth e chalamet ansel elgort and other stars who were high school classmates^lindsay lohan wishes happy new year video from dubai^the love lives girls next door kendra wilkinson holly madison bridget marquardt^protective nick cannon says he trying raise monroe sophisticated intellectual^i am heath ledger is here remind you what fantasticly dedicated actor its subject truly was^chris soules motion dismiss fatal crash case denied judge^is selena gomez your festival style soulmate^the season finale will leave you breathless death wave finally comes^zayn malik plea donate family friend with cancer brings out twitter trolls^james corden grills jennifer lopez about alex rodriguez please do n't do this me^your first look ryan murphy is here^colton haynes proposes back fianc jeff leatham^eva longoria amp more bare plunging necklines billboard latin music awards^todd chrisley gets nanny faye arrested watch exclusive chrisley knows best clip^nicki minaj kicks off billboard music awards with minutes star studded hits^liam payne cheryl cole did not secretly marry here why he calls her his ''wife ''^liam payne just kind dissed harry styles solo music^martha stewart gets between donald trump snoop dogg art fair dishes out shade^britney spears shares photos from her family trip hawaii^this is how william levy kids surprised him for his birthday^basic hair trends every celeb is wearing with twist^missy returns doctor who welcomes back michelle gomez for last time^billboard latin music awards red carpet arrivals see jennifer lopez eva longoria more stars rock miami^mama june speaks candidly about sugar bear i 've never hated anybody much i hate him^radio disney music awards winners the complete list^the girls girls star golden girls parody^miss usa things know know about miss district columbia k ra mccullough^how matthew mcconaughey helped dirty dancing remake star lose lbs^the bachelorette premiere sneak peek watch what happens when corinne olympios returns^justin theroux is ''enjoying his new single life '' post jennifer aniston split^kate beckinsale dating year old matt rife more may december romances^paris jackson poses topless instagram after sharing her honest thoughts nudity^mary kay letourneau former student vili fualaau separate after years marriage^prince harry meghan markle make first official joint appearance invictus games^all the times harrison ford turned into real life hero^arrow things know about what come rest season^jada pinkett smith playfully claps back will smith with bikini pic^matt lauer fired amid sexual misconduct allegations everything we know^mariah carey nick cannon twins celebrate turning with magical birthday party^sugar bear fianc e flips out over mama june surprise wedding day visit go out my house^chris pratt takes off his shirt guardians galaxy vol teaser^the most talked about maternity looks met gala through years kim kardashian kate hudson emily blunt^how chris soules is trying get crash case dismissed^iconic halloween costume items you can wear again irl^elton john throws shade mtv generation we were real artists^chris pine excited about his nearly nude scene wonder woman^selena gomez is loving these white sneakers they 're not stan smiths^this beauty beast deleted scene reveals castle enchanted toilet^nicole kidman gets asked about bathing colin farrell front keith urban^the bachelorette contestant michael nance dead age^bachelor tenley molzahn marries longtime boyfriend taylor leopold^botched recap dr. terry dubrow uses leeches suck blood from actress tawny kitaen nipples^fierce women who run music world^geri halliwell releases angels chains memory george michael^friends courteney cox lisa kudrow jennifer aniston are group text^penn badgley domino kirke get married again^abby lee miller gives fans health update after second surgery ''i had staples ''^why abigail breslin sobbed after recreating dirty dancing iconic lift^eden sassoon not returning the real housewives beverly hills i feel free alive be real me^candace cameron bure elains why she ca n't stop watching reasons why^several r. kelly remaining tour dates canceled due low ticket sales^chris pratt apologizes sign language offending those with hearing disabilities^paris hilton ashanti lc which early style star are you^danica patrick aaron rodgers get kissy daytona^tarek el moussa claps back after speculation his ''single dad '' comment was aimed christina el moussa^the originals charles michael davis talks directing tonight turning point episode^'n sync reunion super bowl joey fatone says kiss that wish ''bye bye bye ''^billie lourd pays tribute carrie fisher her first mother day without her^meet navi michael jackson searching neverland impersonator who used work king pop^shawn mendes nick jonas lady gaga perform american music awards^scandal final season premiere is here remind you never question olivia pope authority^giada de laurentiis plans national pasta chain has our mouths watering^kate middleton looks lovely stripes she hosts london marathon runners kensington palace^why so many reality tv stars struggle with actual reality after cameras go away^james corden shoots fruit harry styles face but does singer flinch^pippa middleton wedding dress whole outfit details revealed^try not smile while looking through all these adorable photos prince harry with kids dogs his family^kim zolciak biermann family meet john legend chrissy teigen after oral sex offer joke^reasons why renewed season^rupaul looks back his legacy reveals what next^the best moments from miley cyrus tonight show takeover with jimmy fallon^sting lists luxurious 56 million manhattan penthouse^never before heard chris cornell songs be released one day after his death^cmt music awards red carpet arrivals see kellie pickler hunter hayes more singers^kylie jenner breaks met gala no selfie rule epic bathroom photo^see music cutest couples hit red carpet grammys^supergirl boss sets stage season final episodes kara got several very difficult decisions mak^inside mama june past months since debuting her dramatic weight loss^nicole kidman reveals th birthday celebration plans with her ''divine '' husband keith urban kids^arrow stephen amell says he hated coachella but has learned to love it for wife cassandra jean^austin jones arrested child pornography charges more biggest youtube star scandals^kim kardashian dyes pink hair brown before khloe kardashian baby shower^tyler baltierra slams catelynn lowell cheating rumors^robert de niro makes his snapchat debut it amazing you 'd think^steve harvey most controversial moments from his alleged staff rules infamous miss universe mishap and^how drake amp justin bieber want you dress according their lyrics^christina el moussa year old son doing great after falling into pool thankfully all is fine^is jax taylor leaving vanderpump rules^kirsten dunst it time have babies chill^luann d'agostino wants see the real housewives new york city receipts where are tom texts^amber heard elon musk vacationing chile together one week after kissing photos^wango tango see katy perry noah cyrus more stars get wild music festival^comparing meghan markle kate middleton royal engagement announcement outfits^liam payne drops debut solo single strip that down feat quavo^kendra wilkinson baskett admits doing reality tv with her mom again was toughest decision my life^get hailey baldwin step smoky eye amp 8 mascara from met gala^the most controversial commercials history from ashton kutcher mary j. blige^ellen degeneres reflects th anniversary her public coming out it was really scary time^this p.m skin care routine is celeb approved^ariana grande performs where is the love with black eyed peas manchester benefit concert^that our girl rachel lindsay first bachelorette promo is here^throwback alert relive pippa middleton scene stealing appearance kate middleton wedding^amy schumer gets snatched worst possible outfit^selena gomez is stunned success reasons why i believed project long^loretta lynn admitted hospital after suffering stroke^patrick dempsey kate walsh surprise grey anatomy reunion is just what doctor ordered^will smith addresses jada pinkett smith divorce rumors new song^cindy crawford rande gerber think pal george clooney will do just fine new dad^alison brie says she was asked take her shirt off entourage audition^nikki bella reveals what she wants her wedding dress i definitely have have some cleavage^is the big bang theory ending after season johnny galecki says ...^once upon time things know after musical episode^gal gadot schooled jimmy fallon box lies just like wonder woman would^the arrangement christine evangelista reveals major movie role she did n't get it went bigger actress^robin thicke shares sweet photo son meeting newborn daughter^this is ellie kemper ideal unbreakable kimmy schmidt ending^noah cyrus billy ray cyrus are father daughter goals mtv movie amp tv awards^the resurgence leah remini how she became more famous than ever years after the king queens^why you should start buying purple shampoo immediately^why victoria beckham other stars do n't wash their jeans^sophie turner reveals downside dating joe jonas marie claire you feel like you 're living fishbowl^she back pretty little liars sneak peek brings old foe back into mix^a two one boob job tummy tuck gone wrong left krystle with gangrene botched^ivanka trump tiffany trump are all smiles thanksgiving turkey pardoning ceremony^nicole kidman proves she can clap normally the ellen degeneres show^it official scandal ending after season^yes arrested development season is really finally officially confirmed^netflix is reportedly reviving carmen sandiego with gina rodriguez^what next moana auli'i cravalho prom cats dancing with stars^chris pratt returns instagram with son jack months after anna faris breakup^scott disick admits he does n't have any father day plans while partying las vegas^amanda bynes years later inside her struggle reboot her life after her public meltdown^heathers reboot pulled following sante fe high school shooting^luann de lesseps arrested drunk disorderly conduct palm beach^kesha mother drops counterclaims against dr. luke she tries find peace forgiveness her heart^queen south executive producer goal is bring more latinos into process^dancing with stars carrie ann inaba robb derringer call off their engagement^jessie james decker reasons this country darling is just like us^goodbye hannah baker no reasons why season for katherine langford^watch trailer the beguiled it sure be summer guiltiest pleasure^the lion king by numbers how simba timon pumbaa helped create disney classic^rachel weisz daniel craig kids are ''really excited '' about having sibling^happy birthday north west see her style evolution over years^chris pratt prank calls etic pet shop leaves us all shock best way possible^pippa middleton james matthews wedding numbers how nuptials easily cost more than million dollar^kevin spacey investigated three more sexual assault allegations london^john stamos caitlin mchugh honeymoon walt disney world^yikes kyle is furious after he loses his movie jeremy renner the arrangement i 'm gon na lose my s t^jessica alba gets real about finding enough time balance work family^rihanna breakup advice fan proves why she gift we do n't deserve^moana auli'i cravalho just blessed dwts with her beautiful voice^jason aldean wife brittany kerr are eecting their first child together^katie cazorla tania mehra engage never ending war words second wives club^j balvin pitbull camila cabello electrify mtv movie tv awards^bella hadid lindsay lohan paris hilton more stars break out all glitz glamour cannes amfar gal^gwen stefani her kids enjoy spring break with blake shelton oklahoma^instagram poses celebs like shay mitchell have perfected^watch out channing tatum zac efron shows off stripper moves with pole dance^brooke shields models sexy calvin klein lingerie years after iconic jeans ads^met gala cliffsnotes how do you actually pronounce comme des garcons^amy schumer celebrates national bikini day like only she can^adele makeup artist reveals secret dramatic eyeliner^mindy kaling reacts being turned into meme^total bellas recap the family takes trip sonoma bella twins celebrate launch their new wine^richard simmons hospitalized severe indigestion^liam payne talks ''internal battle '' against cheryl cole over naming their son bear what made him come around^the keepers will there be season and what latest case^k ra mccullough was n't first raise more questions with her answer miss usa history controversial q amp as^how kanye west found balance his life after his breakdown^luxembourg first gentleman poses with melania trump other leaders wives^caitlyn jenner faith kardashians running office highlights from her book talk^could zac efron alexandria daddario really be dating a frame frame baywatch investigation^beyonc looks almost exactly like blue ivy childhood photo^khloe kardashian is ready marry tristan thompson^heidi montag spencer pratt are eecting baby boy^janet jackson wissam al mana split a timeline their relationship^naomi watts talks good days bad days after liev schreiber split^gigi hadid denim jacket game is strong yours could be too^harry styles facetimes james corden before his week long residency late late show^kendall jenner takes her famous see through style airport^zayn malik spotted wheelchair after injury^the true story under radar celebrity perks from airport escorts free vacations^the real housewives new york city latest berkshires episode was filled with breakdowns fires revelations^carmelo anthony trying not lose his family la la anthony debates what next their relationship^selena gomez mom not happy about justin bieber reunion^olivia munn aaron rodgers break up after years dating^meet pippa middleton bridal party^orlando bloom finally addresses his katy perry split those nude paddle boarding photos^chris cornell wife vicky believes his suicide was accidental^celebrities comme des garcons an ode rei kawakubo fashion brand^jon gosselin reveals how he celebrated sextuplets th birthday^joss whedon replaces director zack snyder justice league after daughter suicide^will smith trolls son jaden smith with parody his music video^inside pippa middleton wedding reception get all deets^scott baio clarifies his controversial comments erin moran death please stop assuming worse me^britney spears christina aguilera selena gomez more stars write love letters lgbtq community^goldie hawn amy schumer play never have i ever with ellen degeneres^fact checking feud bette joan episode did joan crawford have secret porn past^kate middleton shushing kids pippa middleton wedding is total mom move^times ed sheeran was boyfriend our dreams perfect video^chris soules absent from funeral man killed fatal car accident^jessie james decker makes eric decker strip her nashville concert eric amp jessie sneak peek^tamar braxton sets record straight vincent herbert relationship^while rihanna came slay met gala these supermodels were snore^kit harington teases game thrones ending i know everything now^olivia munn doing well after aaron rodgers split how they 're both coping with breakup^jenna fischer runs kim kardashian sisters japan^taylor swift attends snl after party takes selfie with leslie jones^survivor most shocking moments zeke smith outing jonny fairplay grandma more^katie holmes gets pixie cut again ... surprise^nancy kerrigan deserved go further dancing with stars artem chigvintsev says^hollywood hits france see all star sightings cannes film festival^ben affleck daughter seraphina are cutest duo ever father daughter dance^once upon time finale how did it all end ... and what coming next^this peter rabbit red band trailer will give you nightmares^riverdale shocker major character be recast season^adam lambert sounds off american idol reboot ''i would judge heartbeat ''^chris cornell laid rest star studded funeral^mariah carey daughter monroe totally nailed always be my baby while onstage with mom^amal clooney dress was most searched guest look from royal wedding^tom holland mom tricks him into staying close home^supergirl watch alex kara go back midvale mourn sanvers^tiffany haddish paves her own way her first mtv movie amp tv awards promo^grey anatomy spin off coming abc^the handmaid tale is gripping story about survival that will make you uncomfortable in best way possible^rosario dawson finds year old cousin dead her l.a. home^the murder jonben t ramsey why we 're still obsessed with this case more than years after her death^when doves cry beyonc bruno mars more most moving prince tributes year since his death^famously single recap the cast hosts wild mixer that full drama of course^adam levine delivers emotional tribute christina grimmie the voice^andy cohen jamie foxx are turning thursdays into party fox this summer^harry styles covers kanye west first ever solo concert^the unicorn food trend is taking over internet starbucks is latest hop board^designer rebecca minkoff closet tour tips small spaces^selena gomez new los angeles home is totally affordable hollywood standards^days ways zoe kravitz could totally be olsen twin with this outfit^wissam al mana pens emotional message janet jackson after split news^gal gadot shows us what wonder woman really is^nbcuniversal upfront red carpet arrivals^young prince harry originally could n't believe princess diana had died^jimmy kimmel returns work shares positive update newborn son health^mark hamill pranks star wars fans their reactions are priceless^kanye west pays tribute emma gonz lez who praises waffle house hero instead^met gala see how halle berry kate hudson more stars prep new york glamorous night^gigi hadid jumpsuit is most comfortable fall trend yet^welcome back twin peaks see characters then now^from rita ora beyhive all the people lemonade affected intentionally not^christmas is coming harry potter wizarding world other new attractions universal studios hollywood^see kylie jenner cause major frenzy after crashing fan prom life kylie i do n't believe this^revenge co stars emily vancamp josh bowman are engaged^sonja morgan reveals she dated jack nicholson nobody nails down nicholson^pregnant beyonc was one sassy mama easter party with kelly rowland their kids^wear kylie jenner hoop earrings all summer long^adele fans unite tribute performances her songs after she cancels concerts^jennifer garner ''pretend cooking show '' will make you actually hungry^heidi klum boyfriend vito schnabel reacts pics him allegedly kissing another woman^check out serena williams grand slam pregnancy style^dave annable calls out his wife odette annable postponing sex ... instagram^supermodel nicole trunfio poses nude while pregnant^vanderpump rules lala kent is not engaged randall emmett despite ring photo^kylie jenner kourtney kardashian kick off coachella after khloe kardashian gives birth^lamar odom selling gorgeous florida home 5.2 million^cmt music awards nominations announced see complete list^gloria estefan emilio estefan honored premio lo nuestro^alec baldwin set reprise his role the boss baby animated sequel^from prison break gilmore girls ranking this season recycled tv^leonardo dicaprio has titanic reunion with kate winslet billy zane his foundation gala^dance moms stars react abby lee miller prison sentence^major moments from first star wars the last jedi trailer^this is best gift miley cyrus has given her mom^drumroll please here are stars presenting performing mtv movie amp tv awards^hollywood medium tyler henry reveals surprising celebrity icon who had him totally starstruck^rachel lindsay sounds off the bachelorette tear filled full season trailer^kate middleton prince william firsts royal couple^nick viall his dancing with stars elimination chris soules terrible situation^mean girls jonathan bennett is dating jaymes vaughan things know about his boyfriend^the bachelorette week part a total bloodbath^nicole kidman reflects her miscarriage during tom cruise marriage^jessica biel opens up about justin timberlake son silas the sinner^the flash tom cavanagh spills directing his costars amp creating look barry dark future^miley cyrus reveals katy perry is her oldest friend hollywood^jamie lynn sigler opens up about having more kids and living with ms^colton haynes returning arrow series regular season^heather locklear claims boyfriend tried kill her before domestic violence arrest^terri irwin reflects plans have third child with steve irwin emotional interview ahead mother day^emilie de ravin pregnant with baby no it boy^louis tomlinson talks one direction hiatus critiques band mates^the bachelor bekah martinez had perfect response people calling out her age^happy birthday jughead new riverdale photos show one seriously miserable birthday boy^tara lipinski maldives honeymoon photos will have you begging vacation^donald trump calls stephen colbert no talent guy after host crude rant^grey anatomy might have just killed off spoiler^shedding wedding how super fit pippa middleton is getting ready her big day^david hasselhoff still is n't over pamela anderson charisma baywatch premiere^remembering her roots meghan markle spots her drama teacher post wedding carriage ride^chris soules lawyers confident evidence will show he did everything his power aid crash victim^ben affleck moves out family home with jennifer garner^bachelorette rachel lindsay shows off her ''new summer 'do ''^arrow oliver reunites with slade wilson new finale sneak peek^sisterhood traveling pants cast reunite amber tamblyn directorial debut^blac chyna steps out without her engagement ring one year after rob kardashian proposed^kourtney kardashian gets blood facial just like kim did^lorde addresses her two year disappearance from spotlight after being dubbed music next ''it '' girl^miley cyrus gives emotional ''malibu '' performance billboard music awards^alpha male madness vote final round^alpha male madness vote round^alpha male madness vote round now^alpha male madness vote final round^dream kardashian celebrates her first halloween adorable raggedy ann^celeb approved books you have read before summer is over^the challenge champs vs. pros premiere the first eliminated contestants sound off^this intro the magicians finale elains so many things^j balvin promises fire performance with camila cabello pitbull mtv movie amp tv awards^kylie jenner is ringing her th birthday giving back^brad pitt assures fans i 've got nothing hide following angelina jolie divorce^mariah carey further postpones christmas tour over health issues^kate middleton dresses her baby bump blue visit new addiction treatment center^who did n't make it out agents s.h.i.e.l.d season alive^how pregnant heidi montag spencer pratt beat odds from reality tv pariahs eectant parents^calvin harris announces star studded new album featuring katy perry nicki minaj john legend^how stars full house step step th heaven are shedding their '90s tv stereotypes^kim zolciak biermann goes makeup free wig free instagram^kyle west threatens terence anderson forcing him have sex with detective the arrangement sneak peek^melania trump switches up her style military inspired ensemble^charlie sheen selling beverly hills home 10 million^you 'll have time travel for chance rock kim kardashian spring break bikinis^sea lion drags girl water canada terrifying video^edie falco is already having moment with her law amp order true crime wig^nicki minaj fangirled harder than anyone met gala^lolo jones just called out blake griffin being terrible kisser^bow wow lied about flying private jet twitter wo n't let go^why is always crazy town when the real housewives new york city goes berkshires^laverne cox jessie j join selena gomez demi lovato more we day california^bill cosby sexual assault case judge declares mistrial^how stars like nick jonas niall horan more went little bit country stagecoach festival^see prince philip last public appearance before announcing his retirement^heidi montag reveals secret her post baby weight loss^house cards season shocking twists by numbers^nicki minaj offers pay off more 25,000 her fans college tuition other costs^black ish star yara shahidi is so ready college she just has choose one^ray j princess love welcome baby girl^blac chyna ex boyfriend mechie talks leaked sex tape rob kardashian^celebs most revealing minutia social media get intimate look lives anna faris other stars^deaths that rocked bachelor nation^kendra wilkinson baskett is living extreme fear her mom marriage boot camp reality stars family edition^lin manuel miranda joins disney ducktales reboot^khloe kardashian shows major cleavage nyc month after pregnancy news^val kilmer is ready reprise iceman top gun sequel^cristiano ronaldo girlfriend georgina rodriguez handles their three babies like boss^blake lively shuts down reporter who asked her about her fashion variety power women event^webby awards complete list winners^robert pattinson toys with twilight fans emotions^vanessa bayer leaving saturday night live after seven seasons^look it alex mccord former real housewives new york city star resurfaces comment drama^jason biggs welcomes son lazlo with wife jenny mollen^kate middleton rihanna both shop this online store^glenn close speaks out against pig harvey weinstein sexual harassment^the real housewives gets sesame street parody treatment you 've been waiting for^the arrangement season promo is that megan kyle wedding we see^gwyneth paltrow goop fast food guide will have you rethinking everything drive thru line^revenge nerds curtis armstrong tells all shocking confessions from his new memoir^gwyneth paltrow brad falchuk celebrate engagement star studded party^inside world most shocking royal scandals^jennifer lawrence just wore flats major fashion event^carson daly stepfather richard caruso passes away one month after mom death^janet jackson confirms separation from wissam al mana while announcing new tour dates^bruno mars goes gold with his magic bet awards performance^kris jenner granted year restraining order against joshua jacobs^kendall jenner goes sci fi first adidas video ad^is scandal cast ready more episodes^william levy takes his year old daughter her first dance it nothing short adorable^paige opens up about getting suspended from wwe total divas i do n't do drugs^chrissy teigen demi lovato justin timberlake other celebs who 've embraced their memes^chris soules is risk lose endorsement deals how fatal crash could affect his business^your fast food eerience will never be same thanks mcdonald french fry fork^the good fight dances with devil^kaley cuoco dishes her terrifying bachelor style date with karl cook involving canyon jump^hakuna matata seth rogen billy eichner in talks star pumbaa timon live action lion king^good morning america ginger zee reveals she pregnant while delivering weather forecast^demi lovato ca n't stop wo n't stop posting sexy bathing suit photos^all details pippa middleton james matthew bespoke wedding cake^khloe kardashian claps back haters who give advice^watch erika jayne spend day working vogue^justin bieber forgets words despacito during nightclub performance^melania trump no priority is being barron mom why that wo n't change when first lady moves washington^still star crossed get first look post romeo juliet world abc newest drama^the walking dead christian serratos introduces baby mother day^everyday products celebs use combat stress^bachelor nation becca tilley robert graham break up^which real housewives beverly hills have reached out departing eden sassoon^inside chloe lukasiak sweet birthday party how dance moms star celebrated her big day^chance rapper calls out heineken over terribly racist ad baiting consumers^harry styles funniest moments the late late show with james corden^inside kourtney kardashian younes bendjima adventurous egyptian vacation^kaley cuoco karl cook celebrate engagement disneyland^khloe kardashian how i hid my baby bump told tristan thompson i 'm pregnant^pirates caribbean star kaya scodelario shoes she just wo n't throw away^hailey baldwin ditched denim camo pants^ben affleck jennifer garner officially file divorce^how nicole kidman keith urban keep spark alive^bates motel series finale how did it all end^what deal with ashley graham insta worthy facial^meet new lady joining the real housewives beverly hills season^chris soules isolated world after the bachelor when reality tv stardom does n't do much crank up spotlight^taylor swift is n't alone selena gomez ed sheeran more stars who took break from spotlight^yep that nativity scene sarah jessica parker head met gala^eva longoria uneectedly nuzzles lizard her reaction will have you laughing out loud^mark zuckerberg his 60 billion fortune how frugal facebook ceo is really spending his money^kanye west deletes instagram after his valentine day tribute kim kardashian^kate middleton shows baby bump another chic st patrick day look^melissa joan hart takes e q reveals just how interesting her taste guys was s^biggest benefit concerts all time how much they really made^how a speck dust helped sarah silverman deal with personal loss^get jennifer lopez billboard latin music awards look less^amy schumer goldie hawn play hilarious game ''most likely to '' nothing is off limits^joel osteen rushes tv defend church amid criticism over harvey victims treatment^megan fox thanks brian austin green passing his ''teen heartthrob '' dna their sons^inside selena gomez relationship with justin bieber mom^selena gomez talks her devotion we day possibility nd season reasons why^mtv movie amp tv awards red carpet arrivals see all stars bold looks^all details leighton meester platinum blond hair transformation^don lemon sister dead after accidental drowning^once upon time season everything you need know^mila kunis surprises her parents with home makeover^kevin spacey announced tony awards host^brandi tish cyrus reveal real reason why miley cyrus is so happy these days^kris jenner recalls time kylie jenner sang hollaback girl with gwen stefani^dwayne johnson surprises disney world tourists commandeers jungle cruise ride^chris pine sofia boutella spark romance rumors after attending coachella party with famous friends^big little lies cast is just excited about meryl streep joining season you are^tom cruise just confirmed top gun sequel is in works^kendall jenner mermaid eyeliner will upgrade any boring look^kaley cuoco celebrates bachelorette party drops hint about wedding look^nikki bella verge ''big meltdown '' amid stressful wedding planning total bellas ''why i even doi^savage lines from drake pusha t current diss track war^bristol palin cutest family photos^things you need to know about taylor swift new boyfriend joe alwyn^the obamas take italy golf food friends pda shoulder baring fashion no fear potentially awkward timing^shakira new song details how she met amp fell gerard piqu^how win billboard music awards we investigate^chewbacca smacks porg star wars the last jedi trailer go behind scenes movie^carlos ponce remembers selena quintanilla day they met^kendall jenner blake griffin were never serious^kevin hart kisses baby boy kenzo cutest photo son yet^perfect your curls with toothbrush according alicia keys hairstylist^selena quintanilla relatives among victims hurricane harvey^the rule which celebrity couple is getting engaged next^how grandma nancy drews gemma abbie became stars netflix the keepers^the lindsey morgan elains raven big decision^james bond star sir roger moore dead^it time alpha male madness nominate your favorite tv actors now^tom cruise gears up the mummy check out his best roles^chris pratt files divorce from anna faris^morning joe co hosts joe scarborough mika brzezinski are engaged^how katherine langford handled reasons why heavy material^scott disick celebrates his birthday by partying clubs las vegas^kim kardashian newest beauty products may activate your chakras^espys see all superstar athletes step out red carpet^april giraffe calf meets his dad see adorable introduction^rachel bilson hayden christensen romance rewind reminds us how private love they once were^cute boho dresses all under 100^things you need know about aladdin new princess jasmine naomi scott^the bachelorette odds will rachel lindsay make altar",23,2851,2828,2874,0.008002783576896311,0.9839944328462074,0
1070586199,EOnlineUK,353,102733,316,60989,0,0,23,564,the official e account uk ireland get eredcarpet kuwtk botched busytonight fix sky virgin bt talktalk,"hours josh duhamel fergie announced split josh went solo hike without wedding ring^gorgeous curls gorgeous girl ... natural beauty meets gal pals lunch^amal george clooney prepared welcome twins world^amal george clooney ready welcome twins world 're preparing much possible^it ok people lena dunham jack antonoff not split^jessica simpson almost fell leaving restaurant last night could say shoes may made walking^reasons rihanna amp drake could next beyonc jay z^sharon ozzy osbourne split years marriage^not fast justin bieber hailee steinfeld dating^not fast justin bieber hailee steinfeld dating^selena gomez opening taking justin bieber back true friendship the weeknd their^selena gomez happy still true friendship the weeknd split we ended best fri^love alive well jamaica justin bieber took selena gomez plus one dad wedding pa^gayle king says thinks oprah winfrey intrigued idea running president^gayle king says thinks oprah winfrey intrigued idea running president^how khloe kardashian tell tristan thompson eecting over facetime i nervous was^do n't believe everything read there ben affleck lindsay shookus jennifer garner love triangle^no one color coordinates like jennifer aniston justin theroux the leftovers premiere^from pda pictures next dumpster shocking split a timeline selena gomez the weeknd rel^teen choice awards winners complete list^charlie hunnam n't exactly hit right away robert pattinson filming the lost city z.^charlie hunnam n't exactly hit right away robert pattinson filming the lost city z.^divorce rumours n't phase sofia vergara joe manganiello afraid call fake news.^bella hadid excited return victoria secret fashion show^george clooney reacts harvey weinstein allegations it indefensible^shawn ashmore welcomes first child wife dana ashmore^gisele b ndchen reveals reason tom brady maintains strict diet^meghan markle is getting wax figure madame tussauds^meghan markle is getting wax figure madame tussauds^dolly parton tells new book five shocking revelations suicide sex much^very cavallari shannon coaches taylor her big uncommon james interview but will it be enough land her the^gabrielle union throws shade ''hilarious '' online haters calling bad spelling^katy perry releases swish swish with nicki minaj is it about taylor swift^dylan sprouse may have just responded cheating allegations made from girlfriend dayna frazer^reese witherspoon nicole kidman just had best night bowling with big little lies cast^there charges filed corey bohan alleged audrina patridge domestic violence case^kim kardashian says north west would make better president donald trump^a comprehensive guide throwing shade ex told drake salty af dating life^a comprehensive guide throwing shade ex told drake salty af dating life^jurassic world fallen kingdom teaser has chris pratt running his life^corey feldman announces plan ee hollywood pedophile ring with 10 million film^valentine day date ideas inspired kardashians kuwtk^valentine day date ideas inspired kardashians^valentine day date ideas inspired kardashians kuwtk^jay z gets crowd serenade beyonc her th birthday during made in america festival^kate beckinsale simon pegg nearly make clip absolutely anything gag reel^kerry washington ashley judd mark ruffalo stars share whywewearblack golden globes^investigating katy perry niall horan unlikely friendship^robin wright fear demanding equal pay role house cards^jamie foxx th birthday party sounds lot like survivor^cuteness overload coco takes baby chanel disneyland first time^cuteness overload coco takes baby chanel disneyland first time^angelina jolie sparkles nude feathered gown asc awards^patton oswalt engaged meredith salenger one year wife death^here first look paul bettany elizabeth olsen characters kiss infinity war.^beauty beast coming netflix september say bonjour bonjour bonjour bonjour staying inside^despite reports johnny depp drunk premiere murder on the orient eress^barack obama cried dropping malia obama harvard it little bit like open heart surgery.^gal gadot kate mckinnon kiss wonder woman parody skit snl^kate middleton dons fascinator prince william head pippa middleton wedding^is tyga song playboy kylie jenner we 'll let judge^is tyga song playboy kylie jenner we 'll let judge^justin bieber hits paparazzo with his truck outside church^bill cosby breaks silence confirm blind^scarlett johansson calls james franco women march i want pin back^these celebs would definitely scored wimbledon for stunning white outfits^orlando bloom son cutest reaction seeing pirates caribbean first time^happy birthday jenna dewan tatum let look back best dance moments^these met gala video portraits take breath away^in new heartwarming footage i am heath ledger documentary actor smiles^robert pattinson recalls magical twilight eerience it fond memories^miley cyrus jimmy fallon go undercover subway singers^miley cyrus jimmy fallon go undercover subway singers do n't miss fallontonightuk midnight e^kate walsh talks playing ''wicked bitch '' addison montgomery grey anatomy^how amal clooney turned lifelong bachelor george clooney into family man^kevin hart spares no eense eniko parrish lion king themed baby shower even if he ballin budget^you see stunning oscars party portraits^jay z teases his :44 album with adnis^dance moms abby lee miller sentenced one year prison^we tried shoulder denim jacket trend celebs love happened^is logan huntzberger father matt czuchry holds answer gilmore girls mystery^jimmy kimmel returning host oscars next year^david schwimmer wife zoe buckman taking time apart six years marriage.^will smith chops jaden smith hair tries^kate upton details sexual misconduct allegations against guess paul marciano^nick cannon reveals diva thing seen mariah carey^rose byrne is pregnant with her second child^tiger woods arrested dui charge florida^did demi lovato write ruin friendship about nick jonas^celebrate demi lovato new album with look back her evolution from child star pop diva^richard pryor daughter says he did not have relationship with marlon brando^taylor swift wears plaid performs ed sheeran poptopia show^contrary reports ed sheeran girlfriend cherry seaborn engaged^ed sheeran engaged girlfriend cherry seaborn congrats happy couple^happy birthday britney spears see talk family music e news interview^ian somerhalder paul wesley vampire diaries reunion photo sparks social media frenzy^ian somerhalder paul wesley vampire diaries reunion photo sparks social media frenzy^zac efron goes shirtless christmas hike^just start crying harry styles epic carpool karaoke got romantic emotional like cool way.^happy birthday malia obama see much barack obama daughters grown years^dr. phil accidentally hit skateboarding bodybuilder car^jessica biel shares secret happy marriage justin timberlake^yolanda hadid reveals she contemplated suicide during lyme disease battle^bella thorne says scott disick charming drinks lot^kate hudson pokes fun anthony scaramucci resignation how lose guy days meme^here why internet is freaking out over this selena gomez look alike^jennifer lopez rush walk aisle alex rodriguez i believe marriage i would lov^they dated these real housewives shock past romantic relationships^craziest fashion moments from mtv video music awards red carpet^demi lovato calls time editors hypocrites honoring donald trump alongside metoo women^here proof that sarah michelle gellar freddie prinze jr. year marriage is sweeter than ever^things know pippa middleton fianc james matthews^teen choice awards winners complete list^a gold medal couple simone biles makes romance fellow gymnast stacey ervin instagram official^sandra bullock romantic history the rumors reality including relationships you totally forgot about^watch demi lovato luis fonsi chame la culpa music video^o.j simpson released prison years what next^kelly clarkson opening new interview when i really skinny i wanted kill myself.^remembering prince a tribute legend groundbreaking career^a former porn star claims drake got pregnant here surprising response^a former porn star claims drake got pregnant here surprising response^practice spells charms two new harry potter books published october .^paris jackson sends birthday wishes michael you are always with me i am always with you^pippa middleton undergoing bridal body boot camp ahead wedding^billboard music awards see music biggest stars hit red carpet style^this cheeky little norwegian prince dabs king queen birthday celebrations^fergie recalls crystal meth addiction i was hallucinating daily basis^kylie jenner surprises high school students prom^brie larson reveals emma stone jennifer lawrence aved life ''^creating harry potter j.k. rowling journey struggling single mother world first billionaire author^will smith dj jazzy jeff reuniting first official shows years^okay elsa get girlfriend frozen it still bit unclear^all baby names kim kardashian has nixed over years^kate middleton prince william prince harry cutest cheerleaders london marathon.^kelly rowland wants second boob job nipples size frisbees^youtube star austin jones arrested child pornography charges^should zac efron return musicals forever if ladies choice say bet on it^people convinced kate middleton gave away pregnancy news recent trip poland^people convinced kate middleton gave away pregnancy news recent trip poland^alicia silverstone wears 'clueless outfit hangs chrissy teigen luna^robert pattinson nearly fired filming first twilight film^alexa chung poses topless love magazine^sarah jessica parker says upset kim cattrall really hurtful comments^meet ines rau playboy first transgender playmate^which american idol judges return revival we 're ranking favourites^style fit royalty see princess diana kate middleton meghan markle style compare^inside scott disick wild nights partying with bella thorne ella ross^adam west dies tv original batman^here american crime story the assassination gianni versace cast compares real life counterparts^jack gilinsky apologizes terrible unforgivable words directed towards madison beer^demi lovato wilmer valderrama reunite cutest photo year split^demi lovato wilmer valderrama reunited cutest photo year split^the avengers infinity war trailer teases global destruction new alliances thanos rise powe^the man taylor swift stalking case found unfit stand trial^kim kardashian reveals weirdest thing kanye west does^choose tv king vote final round alpha male madness^coco responds backlash braids this n't race war^mary j. blige ordered pay ex husband 30,000 month temporary spousal support^listen taylor swift new song gorgeous^listen taylor swift new song gorgeous^prince harry condemns paparazzi photographed princess diana dying^kim kardashian goes shirtless suit lacma art film gala^secrets lies cheaters frauds a history real housewives relationship implosions^meghan markle gets official royal aide ahead may wedding prince harry^harry styles dance moves stole show jimmy fallon saturday night live flash mob fallonstylessnl^deena cortese bursts tears jersey shore stars surprise roomie reunion^lollapalooza music festival evacuated due weather^tyga handcuffed detained leaving avenue nightclub hollywood^princess margaret royal rebel how her early heartbreak headstrong ways moved monarchy forward^johnny depp heads disneyland captain jack sparrow surprise pirates caribbean riders^kate middleton style fit royalty see evolved years^angelina jolie reveals bell palsy diagnosis says kids still '' healing '' brad pitt divorce^jamie foxx reese witherspoon more stars set participate hurricane harvey relief telethon^ariana grande named first honorary citizen manchester^it official ariana grande named first honorary citizen manchester^nikki reed showcases chic maternity style ian somerhalder^these couples ignited met gala red carpet years^lily collins reveals complimented weight loss playing anorexic character^janet jackson breaks down tears she sings what about onstage after resuming tour^how the mindy project delivered realistic romantic comedy never knew needed^how music motherhood getting janet jackson public divorce^jennifer lawrence defends getting naked red sparrow after photo hack one is my choice^miranda kerr road altar how supermodel found happily ever evan spiegel^kate upton justin verlander return spotlight wedding^the case claims jim carrey wrongful death lawsuit dismissed.^pregnant khloe kardashian dazzles new family christmas photo but kylie jenner still missing^gal gadot reunited og wonder woman lynda carter honestly iconic^cardi b says pregnant 'getting fat response comment made instagram^jessica simpson i 'm not pregnant^is friday yet here sneak peek demi lovato luis fonsi song echame la culpa^the weeknd robert pattinson more turn out leonardo dicaprio epic rd star birthday bash^goldie hawn returning silver screen says hollywood n't want back years away^gal gadot loves playing wonder woman n't want play forever it i want for^kate middleton begins children hospice week inspirational psa^the mindy project ike barinholtz recovering broken neck movie stunt accident^kate middleton faux bob easier recreate think^grey anatomy set wheels motion another doctor departure^grey anatomy set wheels motion another doctor departure^watch kim kardashian first ever e news interview before keeping up with kardashians premiered^dance moms abby lee miller breaks silence coping prison sentencing.^why once upon time follow jennifer morrison lead end season six^angelina jolie takes her kids toronto international film festival maddox jolie pitt is noticeably m.i.a^la la anthony pays sweet tribute year old son kiyan amid carmelo anthony split^laguna beach talan torriero eecting first child danielle torriero^blac chyna fearful rob kardashian next move what else could^what game thrones night king amazing aim let talk insane theories^get depth look kate middleton flair photographing children^are things getting serious scott disick sofia richie well depends ask.^orange is new black jamie denbo told old play year old man wife^james corden performs backstreet boys showcases killer dance moves^here president donald trump twitter disappeared minutes^lady gaga beautiful tribute cancer stricken friend coachella make cry^eric dane smiles family first public event since depression battle reveal^chop chop taraji p. henson dramatic blond hair change major celeb hair trend moment^picture proof chris hemsworth hollywood hottest dad^exclusive rachel mcadams pregnant first child^sam smith returns with too good goodbyes his first single two years^and the weeknd deletes selena gomez social media^the weeknd deletes selena gomez social media^forget taco tuesday for jennifer lopez kim kardashian west perfect place reunite taco wednesda^lindsay lohan defends harvey weinstein thinks georgina chapman needs be there her husband^meghan markle raves new neighbour future sister law kate middleton royalengagement^glee alum matthew morrison eecting first child wife renee puente^jennifer lawrence mother trailer make want sleep lights^kermit frog getting new voice years^kermit frog getting new voice years^meet man deactivated president donald trump twitter^meet man deactivated president donald trump twitter^say bye bye bleaching hair here bella hadid used glitter dye locks^taylor swift look what you made me do breaks spotify youtube records^farrah abraham paid visit grave daughter father derek underwood birthday^chrissy teigen pretends ballerina gets grief^zac efron recalls scary bear encounter it was charging us^look back the bachelor televised weddings find couples stood test time^black ish yara shahidi headed harvard^ryan reynolds best response wonder woman beating deadpool^ryan reynolds best response wonder woman beating deadpool^ryan reynolds best response wonder woman beating deadpool^fergie shows ups downs celebrity relationships save it til morning music video^a look inside jersey shore reunion deena cortese wedding^a look inside jersey shore reunion deena cortese wedding^john legend singing costco might sexiest thing 've ever heard^khloe kardashian rubs baby bump sparkling outfit family christmas party^kim kardashian answers big question met gala where kanye west^johnny depp missing millions who blame^here clues destiny child might reuniting coachella^shay mitchell runs naked sunset boulevard celebrate youtube milestone^oprah winfrey throws wonder woman party end wonder woman parties^arie luyendyk jr. lauren burnham pack pda during 25,000 spanish getaway^katy perry serves up another hit song with bon app tit feat migos^question if original hocus pocus stars want sequel getting remake^question if original hocus pocus stars want sequel getting remake paging .^congratulations order mindy kaling pregnant first child^rashida jones denies leaving toy story john lasseter misconduct claims^here selena gomez likes taylor swift boyfriend joe alwyn^justin bobby is facing music here what hills star is up now^nikki bella is putting her wedding backburner again total bellas i need work me bellas^black panther how marvel movie became one most revolutionary film^taylor swift makes ''generous '' donation mariska hargitay charity aiding sexual assault survivors^taylor swift makes ''generous '' donation mariska hargitay charity aiding sexual assault survivors^kate middleton is early labor with royal baby no^prince harry barack obama reunite discuss manchester attack^inside romance pitch perfect private couple anna camp skylar astin^bradley cooper irina shayk living best lives vacation tahiti celebrity friends^kate middleton looks elegant curtsies queen royal easter sunday service^selena gomez releases new single music video ''bad liar ''^karlie kloss summer well traveled celebrity thanks travel bug^from drake miley cyrus much here billboard music awards numbers^newly unsealed search warrants reveal prince mislabeled pills paisley park home^ghosted could bromantic grown stranger things n't know waiting^fans already freaking jon snow daenerys targaryen meeting^here eiza gonz lez say asked liam hemsworth i n't know big thing.^jimmy fallon announces the tonight show donate 1 million hurricane harvey relief^is new photo liam payne amp cheryl cole baby new photo liam payne amp cheryl cole baby^adele pays emotional visit london grenfell tower after deadly apartment fire^how meghan markle preparing make big splash pippa middleton wedding^how meghan markle preparing make big splash pippa middleton wedding^kevin hart jokes new baby pays tribute wife eniko snl^tom felton goes incognito among muggles harry potter concert screening^netflix raising subscription prices yes one two pounds per month^the royal staff reportedly called buckingham palace emergency meeting^justin timberlake drops filthy video channels steve jobs^khloe kardashian epic fourth july party included gold dipped everything^inside biggest royal scandal ever how king edward viii elosive affair with wallis simpson changed cour^gisele b ndchen tom brady twinning black suits met gala^gold medalist sanya richards ross abortion day flying olympics^gold medalist sanya richards ross opened abortion one day flying olympics^pippa middleton james matthews wedding numbers celebrity guests venue costs more^meghan markle makes her royal debut true british style alongside prince harry^why taylor swift latest approach romance right move^why taylor swift latest approach romance right move^chris brown punches photographer florida nightclub^so many congratulations order may present tv scoop awards full list winners^neil patrick harris david burtka twins win easter hilariously scary prank^from gwen stefani kristen stewart cringe worthy ways cheating scandals unearthed^from gwen stefani kristen stewart cringe worthy ways cheating scandals unearthed^how motherhood brought chrissy teigen best self^adriana lima wo n't take clothes anymore ''empty cause ''^blac chyna granted temporary restraining order rob kardashian get deets dailypop starting^blac chyna granted temporary restraining order rob kardashian^president kevin hart the comedian plans run dwayne johnson son vice president^inside kim kardashian star studded shower baby no^american horror story season title revealed^north west penelope disick get joint moana themed birthday party^selena gomez cast reasons why get matching tattoos what semicolons mean.^selena gomez cast reasons why get matching tattoos what semicolons mean.^brie bella nikki bella get back into wrestling ring total divas is year bellas^dying see pippa middleton wedding dress might look like here jaw dropping hints^caitlyn jenner responds president donald trump transgender military ban^uma thurman wants justice harvey weinstein alleged assault^tony awards the full winners list^pippa middleton marry family major money^watch jimmy kimmel prank justin theroux with jennifer aniston help^linkin park eeriencing shockwaves grief denial chester bennington suicide^a ap rocky grabs kendall jenner butt met gala family snaps photos^game thrones see much cast changed years^amber rose victim hour home invasion slept^justin theroux breaks social media silence jennifer aniston split^pippa middleton james matthews honeymoon paradise^chadwick boseman shirtless rolling stone cover is jaw dropping^oprah winfrey celebrates her birthday with bread ros more favorite things^rob kardashian dotes daughter dream kardashian biggest fan^beyonc shares photos sexy look serena williams wedding^katy perry wants late night snack^lena dunham n't mind landing worst dressed list^blake lively dramatic movie makeover will blow you away^another video basket katy perry swish swish music video way packed stars^meghan markle takes mom doria london inside their secret mother daughter trip across pond^nina dobrev paul wesley have snowy vampire diaries reunion^rose mcgowan says she was offered 1 million keep harvey weinstein allegations quiet^jennifer aniston justin theroux met valentine day split announcement^harry styles says never felt need define sexuality^britney spears announces piece me world tour dates^game thrones cut finale scene elains littlefinger twist^no achy break hearts billy ray cyrus tish cyrus dismissed divorce case^no achy break hearts billy ray cyrus tish cyrus dismissed divorce case^ben affleck dating saturday night live producer lindsay shookus months after jennifer garner divorce^sofia carson adds disney magic holidays shares her highlights from^celine dion rocks faux leather overalls sparkling shades paris^aaron carter pens emotional letter sexuality ''this bring shame ''^the famous royal bridesmaid become bride everything know pippa middleton wedding far^the famous royal bridesmaid become bride everything know pippa middleton wedding far^here miley cyrus skipped teen choice awards^you ai n't ever friend like will smith talks play genie disney live action aladdin reboot.^you ai n't ever friend like will smith talks play genie disney live action aladdin reboot.^how shawn mendes hailey baldwin friendship grew into serious romance^there nothing holding back how shawn mendes hailey baldwin friendship grew serious romance.^jennifer lawrence delivers moving speech about feeling ''trapped '' objectified early career^here story anna faris chris pratt fell love^donald trump hopes oprah will run president so she can be ''eed defeated ''^hugh grant welcomes baby no with anna eberstein^there royal secret prince harry meghan markle keep romance tight wraps^there royal secret prince harry meghan markle keep romance tight wraps^there royal secret prince harry meghan markle keep romance tight wraps^there royal secret prince harry meghan markle keep romance tight wraps^watch taylor swift end game music video with ed sheeran future^ed sheeran clarifies n't quit twitter stopped reading^we could really use cosmopolitan right everything know scrapped sex city movie^fans spy khloe kardashian baby bump game thrones halloween costume^fans spy khloe kardashian baby bump game thrones halloween costume^lupita nyong'o angela bassett more dazzle black panther premiere^pitbull thinks women powerful thing earth^pitbull thinks women powerful thing earth woman made man.^netflix updates reasons why warnings discussion subject matter increases^jennifer lopez addresses sexual harassment accusations against guess paul marciano^taylor swift sends flowers ''look what you made me do dancers ''keeping secret^queen elizabeth ii paid visit manchester arena attack victims hospital^kim khloe kourtney kardashian front calvin klein new underwear ad kylie kendall jenner and need^pregnant jaime pressly eecting twin boys hamzi hijazi^blac chyna looking legal options rob kardashian published naked photos^blac chyna looking legal options rob kardashian published naked photos^chris brown recalls night assaulted rihanna i felt like f king monster^chris brown recalls night assaulted rihanna i felt like f king monster^harry styles others confirmed victoria secret fashion show performers^scarlett johansson colin jost make first public appearance together snl party attended beyonc^does hollywood hate easter bunny^check emma watson impromptu harry potter reunion^did selena gomez really walk justin bieber seattle date night we break enews p^sound little mix amp cnco premiere music video reggaet n lento remi^emmy rossum told audition bikini ... movie bikini scene^how cast lifetime michael jackson searching neverland compares real life counterparts^quincy jones awarded 9.4 million michael jackson estate royalties lawsuit^prince william kate middleton prince george princess charlotte wear shades blue royal family christmas^prince harry wanted royal family^jennifer garner is holiday style goals amp more best dressed stars^even though life got turned upside millie bobby brown still insists like year old^you 've got friend emma watson says tom hanks things want be.^khlo kardashian opens up about being fan selena quintanilla perez^lady gaga debuts new single the cure gets much love coachella^coolest dragons pop culture ranked^reunion kardashian exes blac chyna parties tyga lamar odom^is dream dinner guest drunk jennifer lawrence well name gail j law fact named he^salma hayek pinault reveals why she hesitated share her harvey weinstein story^tyler posey just shared most heartfelt message about his girlfriend sophia taylor ali^are nina dobrev glen powell dating proof hollywood pair could friends^madison beer swears she not dating brooklyn beckham we 're seriously best friends^madison beer swears she not dating brooklyn beckham we 're seriously best friends^kendall jenner bella hadid more serve up serious style paris haute couture fashion week^the director taylor swift look what you made me do music video thinks beyonc copied bad blood.^the director taylor swift look what you made me do music video thinks beyonc copied bad blood.^the director taylor swift look what you made me do music video thinks beyonc copied bad blood.^american music awards things need know big show we live fr^everything know amy schumer star studded wedding chef chris fischer get latest deets pm^blac chyna great spirits maxim party car accident^jessica simpson learned important lesson every size^angelina jolie eva longoria more go glam hollywood film awards^sofia richie scott disick playboy reunite date night^coldplay played new song houston concert miami dedicated hurricane harvey victims^we ca n't stop wo n't stop looking forward miley cyrus liam hemsworth wedding chris hemsworth sa^mel b restraining order former nanny extended amid divorce drama^aaron carter elains skinny basically i eating disorder^gwyneth paltrow reveals broke foot^reality tv love triangles over years^this coldplay superfan got surprise lifetime crowd surfing wheelchair chris martin^only chrissy teigen make caught rainstorm look fabulous^james franco says acting helped him overcome certain addictions^meet mischa barton new boyfriend james abercrombie aussie heir 574 million fortune^will smith jada pinkett smith celebrate th anniversary best e news moments years^sharknado celeb cameos insane including charo queen england fabio pope^jessica biel justin timberlake relive one hollywood greatest love stories^what difference year makes keeping khloe kardashian tristan thompson year long relationship.^serena williams alexis ohanian waiting learn sex baby^the happiest place earth got even happier disney world opening hotel doors dogs^shay mitchell high waisted swimsuit igniting something us^shay mitchell high waisted swimsuit igniting something us^kim kardashian drinks sardine smoothie avoid discussing khloe kylie jenner rumored pregnancies^james franco further addresses sexual misconduct claims late night^michael phelps defends cgi shark week race amid backlash^titanic slammed into theaters that pesky iceberg years ago today^how paris jackson officially became new girl^chris cornell wife vicky pens emotional open letter oulmate '' days suicide^chris cornell wife vicky pens emotional open letter oulmate '' days suicide^how angelina jolie ended villain divorce brad pitt^chrissy teigen struggling zip outfit anyone ever tried clothes^after recent allegations this is us edit kevin spacey reference tonight episode^chris hemsworth reign thor could coming end he contractually done role avengers^chris hemsworth reign thor could coming end he contractually done role avengers^taylor swift releases end game music video trailer^brad pitt epic romantic history every star dated including ones forgot^sisters grind together shine together see gigi hadid bella hadid stylish sister moments^it years since richard gere last saw pretty woman^demi lovato parties jamie foxx paris hilton wiz khalifa sorry not sorry video^scarlett johansson snl colin jost hooking going longer might 've thought^jordin sparks celebrates low key baby shower dana isaiah family^jordin sparks celebrates low key baby shower with dana isaiah family^why cameron diaz disappeared hollywood^why cameron diaz disappeared hollywood^michael phelps raced cgi sharks fans found fishy^inside joe jonas sophie turner star studded engagement party nyc^selena gomez revisits childhood texas home it could better life today^kate hudson shaves head mystery project sia^proof david brooklyn beckham fashion twins^reasons kristen bell is going ace hosting sag awards^macklemore reveals wife tricia pregnant baby no^billboard music awards things know big event^lamar odom one word renewing romance khloe kardashian no^woody allen concert germany disrupted two topless female protesters^kylie jenner newest photo baby stormi sweetest yet^best dressed week jada pinkett smith c line dion^best dressed week jada pinkett smith c line dion^this side ariana grande was always there it was just shadowed silly distractions^there hot grandma looks exactly like scarlett johansson 're get drunk together^on mark get set binge mindhunter next netflix crime obsession^is emma stone replacing amy schumer jennifer lawrence famous bff^is emma stone replacing amy schumer jennifer lawrence famous bff^harry styles message ex girlfriend taylor swift^dumbo comes life disney new teaser trailer^after show showdown chris brown migos come face face bet awards party^eliza dushku engaged peter palandjian^jennifer lawrence n't know kim kardashian considers friend^macaulay culkin his bond with paris jackson ''she is beloved me ''^game thrones kit harington emilia clarke elained why jon dany meeting did not go so well^blake shelton jimmy fallon get their palms read it gets slightly risqu^laverne cox making history cosmopolitan first transgender cover star^amber rose says savage perfect^everything know kim kardashian surrogate baby no^gigi hadid denim outfit inspiring home d cor^jennifer hudson finally gets grammy the color purple thanks ellen degeneres^reasons why uriah shelton slapped with restraining order after allegedly kicking friend stomach^reasons why uriah shelton slapped with restraining order after allegedly kicking friend stomach^police investigating meghan markle prince harry anthrax scare^scooby doo pa pa dj kass new dance craze need know^scooby doo pa pa dj kass new dance craze need know^a look camila cabello journey escaping cuba finding stardom^jersey shore cast gets party started first day filming reunion^priyanka chopra meghan markle bridesmaid rumors if you see me there you 'll know^zayn malik showers gigi hadid cake kisses sweetest message birthday^james corden initially named his daughter beyonc^c line dion donates concert proceeds las vegas shooting victims^welcome tape we could give reasons why 're thankful netflix guilty pleasure year^selena gomez tearfully accepts billboard woman year award with francia raisa^how much it costs live paris like jennifer aniston justin theroux^two years bobbi kristina brown death questions remain whether drugs violence led coma^inside biggest royal moments^niall horan releases second single slow hands^drake becomes coolest chaperone history taking cousin prom^what to bone got right portrayal eating disorders onscreen and went wrong^fifth harmony releases first single without camila cabello listen down^is selena gomez festival style soulmate^scott disick makes two women las vegas^scott disick makes two women las vegas whirlwind trip cannes^taylor swift latest surprise has amber rose wiz khalifa son freaking out^liam payne cheryl cole secretly marry here calls wife^niall horan hailee steinfeld ignite dating rumors backstreet boys concert^kristen bell reveals keeps marriage dax shepard hot the funny keeps spicy more amp^nick jonas next record is ready but first he has sing christmas carols with his niece^chris pine excited nearly nude scene wonder woman so^salma hayek brunette eebaftas day debuting blond hairstyle^jenelle evans says wants quit teen mom it healthy us anymore^candice swanepoel reveals sex baby no adorable video my boys^henry cavill says goodbye his mustache hilariously dramatic video^heidi montag spencer pratt celebrate year anniversary a retrospective their epic coupledom^saint west reign disick joint monster mash themed birthday party^jason momoa lisa bonet may be instagram cutest under radar couple^james corden shoots fruit harry styles face but does singer flinch^samuel l. jackson james corden epic rap battle ended mic and money drop^countdown royal wedding the very real danger meghan markle prince harry are facing their big day^justin theroux photographed first time without wedding ring two weeks since announcing split fr^miranda lambert recalls needing fuel living oklahoma blake shelton^somebody baby fever somebody kirsten dunst it time babies chill.^selma blair sarah michelle gellar cruel intentions reunion proves duo still good^liam payne drops debut solo single strip that down feat quavo^wax shave pluck laser thread finally hair removal guide every part body^wax shave pluck laser thread finally hair removal guide every part body^prince harry meghan markle wedding cake all details^alison brie says asked take shirt entourage audition^pop culture events guaranteed get excited^the resurgence leah remini how she became more famous than ever years after the king queens^it official gladiators scandal ending season^how dress like kylie jenner matter occasion^scott disick admits n't father day plans partying las vegas^amanda bynes years later inside struggle reboot life public meltdown.^kyle newman offers direct star wars hans solo movie free^zedd reveals worst part dating selena gomez spoiler it bad^cover eyes johnny depp lily rose depp poses topless turning^dj khaled threw his son st birthday party that bigger better than any you 'll ever have^taylor swift fakes friendship russell westbrook silly nba awards video^things know voices behind favorite disney characters^jon gosselin is relentlessly fighting his kids '' after multiple confrontations with kate gosselin lawyer says^could zac efron alexandria daddario really be dating a frame frame baywatch investigation^khloe kardashian ready marry tristan thompson^khloe kardashian ready marry tristan thompson^heidi montag spencer pratt eecting baby boy^mr. grey see studio the fifty shades freed soundtrack includes song jamie dornan.^meghan markle prince harry sneak kiss first public event together^chrissy teigen john legend ca n't come up with baby name their son^avril lavigne really good place moving toward romance music producer j.r. rotem^flashback see goldenglobe nominees first ever ceremonies^harry styles covers kanye west first ever solo concert^harry styles covers kanye west first ever solo concert^gigi hadid bella hadid best sister moments^grey anatomy camilla luddington revealed longtime partner matthew alan got engaged new year^selena gomez new los angeles home totally affordable by hollywood standards least^selena gomez new los angeles home totally affordable by hollywood standards least^jimmy kimmel returns work shares positive update newborn son health^taylor swift releases new song call it what you want^inside ryan murphy secretive totally unstoppable true crime empire^adele fans unite tribute performances songs cancels concerts^check serena williams grand slam pregnancy style^drake wears rihanna branded socks because love never dies^kate middleton prince william firsts royal couple^shedding wedding how super fit pippa middleton getting ready big day^shedding wedding how super fit pippa middleton getting ready big day^chris soules lawyers confident evidence show everything power aid crash victim^what bell palsy a doctor elains condition could mean angelina jolie^ed westwick rape allegations being investigated lapd^watch will smith james corden get jiggy carpool karaoke the series premiere^laverne cox jessie j join selena gomez demi lovato we day california^game thrones gives us another long awaited reunion then overshadows death fire^nicki minaj offers pay 25,000 fans college tuition costs^lilo amp stitch turns today can find easter eggs hidden mickeys^inside world shocking royal scandals^hillary clinton done trying likeable election^hillary clinton done trying likeable election^chrissy teigen demi lovato justin timberlake celebs 've embraced memes^kaley cuoco dishes terrifying bachelor style date boyfriend involved canyon jump^jessie james decker eecting baby no looking back her cutest mommy moments so far^prince william kate middleton ready another wedding we excited harry meghan^bruno mars cardi b collaborate finesse remix^katy perry responds recent criticism new image ''i 'm con artist ''^maybe kylo ren actor adam driver really dark side the star undecided seeing star wars the la^pregnant kate middleton challenges prince william hockey shootout^prince william kate middleton twist pretzels make sweets germany^ed sheeran dishes his all time favorite tv performance we bet you 'll remember it too^ncis losing another team member pauley perrette announced leaving season .^rachel bilson hayden christensen romance rewind reminds us private love^rachel bilson hayden christensen romance rewind reminds us private love",23,564,541,587,0.03918228279386712,0.9216354344122658,0
25589776,people,1751,7565880,33588,267090,7,4,271,264,no site celebrity news and subscribe snapchat discover channel,barbara bush says grandfather george h.w asked if 'it will feel worse than this after wife died^ohio baby girl allegedly found dead closet shelf time bomb father is charged with murder^call details chilling moments after friend found ohio state student dead murder suicide^missing woman is found dead ohio farm man is charged murder^police find year old ohio boy body hidden home where three adults were found dead night before^ohio mom her two daughters found dead bed triple homicide police think they were targeted^call details chilling moments after friend found ohio state student dead murder suicide^john mccain rails against 'half baked spurious nationalism liberty medal acceptance speech^lady gaga bradley cooper vow perform 'shallow oscars if nominated 'one hundred percent^hillary clinton donald trump bernie sanders react orlando mass shooting^a devoted doctor heroic officer determined resident the chicago hospital shooting victims^kim kardashian slams 'liar caitlyn jenner comments about late father robert 'she is not good person^kim kardashian slams 'liar caitlyn jenner comments about late father robert 'she is not good person^pregnant khlo kardashian shuts down baby name rumors that 'so cute but 'not my list^caitlyn jenner says she 'very proud kim kardashian meeting president trump^jennifer aniston says we need 'stop thinking beauty is shape size^robert pattinson fka twigs split but might get back together 'that girl he wants marry^miranda lambert anderson east split after more than years together report^harvey weinstein 'more concerned about his family than himself ahead arrest source^kim kardashian annoyed kanye west refuses rest she seems miserable says source^kim kardashian annoyed kanye west refuses rest she seems miserable says source^butterfly baby kim kardashian west shares new video her adorable daughter chicago^david victoria beckham shoot down divorce rumors 'fake news fueled social media^jennifer lawrence darren aronofsky spotted together one month after split^jennifer lawrence reveals hilarious way amy schumer comforted her after darren aronofsky split^n.y.c night out jamie foxx katie holmes grab dinner big apple after split rumors^now 're official mashups need happen^exclusive it official wrote country song together^who guy keep crashing red carpets attacked brad pitt^who guy keep crashing red carpets attacked brad pitt^no mo day glo kristen stewart ditched orange hair signature brunette shade^kim kardashian defends sister kylie jenner forbes cover after backlash 'she is self made peoplenow^kim kardashian defends sister kylie jenner forbes cover after backlash 'she is self made^pregnant jessica simpson cradles her baby bump while bidding big apple adieu cute snap^baby girl will be here soon all jessica simpson stylish bump pics^pregnant jessica simpson shares first bump photo baby was 'very happy surprise says source^how jessica simpson hid baby bump stage willie nelson weeks before announcing pregnancy^chris pratt files divorce anna faris^did princess diana leave hospital quickly kate middleton did after giving birth^christina aguilera 'it really cute that blake shelton gwen stefani found love the voice^kourtney kardashian sophia richie caitlyn jenner attend star studded malibu chili cook off^kris caitlyn jenner only 'interact when they have kendall kylie sake source^maks chmerkovskiy returns dancing stars after skipping last week due 'personal issue^what stake angelina jolie brad pitt divorce combined fortunes estimated 500 million^what stake angelina jolie brad pitt divorce combined fortunes estimated 500m^what next angelina jolie brad pitt how 'll divide nearly 500 million fortune^liam hemsworth frightens miley cyrus again warns sister law elsa pataky 'you 're next^back on mariah carey spotted kissing bryan tanaka after posting sweet flashback photo^a comprehensive timeline prince harry meghan markle relationship^hawaii croatia oprah reveals how she stedman graham are making memories this summer^oprah winfrey elains why she keeps her relationship stedman graham so private^savannah guthrie says she tries 'keep touch matt lauer via text since his today exit^matt lauer speaks out first time since today exit address controversy over 13m ranch^matt lauer goes paddleboarding hamptons months after today show scandal^channing tatum jenna dewan split after nearly years marriage 'we have lovingly chosen separate^maddie poppe wins season american idol^americanidol crowns its season winner the champion is ...^blake shelton says he gwen stefani thought their relationship was 'rebound deal first^details gwen stefani opening blake shelton miranda lambert split watch gt^blake shelton says gwen stefani 'all i care candid miranda lambert split^gwen stefani 'in shock blake shelton first revealed miranda lambert split^liam hemsworth frightens miley cyrus again warns sister law elsa pataky 'you 're next^liam hemsworth has tennis player lookalike he just hot^sarah jessica parker says sex city fallout was 'enormously painful me^sarah jessica parker suggests that ellen degeneres play samantha sex city^can guess much woman spends makeup lifetime we way via^comedian hannibal buress arrested disorderly intoxication miami^fergie thanks fans being there me during rio meet greet day after announcing split josh duhamel^fergie josh duhamel were 'leading separate lives long time before announcing split says insider^fergie josh duhamel differences were 'a factor split 'this has been long time coming says source^maks chmerkovskiy skipped dwts performance due 'big chemistry issue with partner vanessa lachey says source^maks chmerkovskiy skipped dwts performance due 'big chemistry issue with partner vanessa lachey says source^everything kim kardashian west said baby^everything kim kardashian west said baby^pregnant meghan markle looked radiantly happy royal wedding says jeweler^meghan markle mom doria ragland is looking forward becoming grandmother i 'm 'very happy^liam payne jokes he fragile after cheryl split despite moving on new flame cairo dwek^what new ruling means brad pitt angelina jolie custody case^miley cyrus gets hilariously pranked again liam hemsworth during couple car ride^it b a n a n a s gwen stefani kicks off vegas residency show blake shelton hand^where caitlyn jenner stands every woman kardashian family^a timeline complicated relationship taylor swift kim kardashian west^a timeline complicated relationship between taylor swift kim kardashian west^a timeline complicated relationship taylor swift kim kardashian west^golden globes check out complete list winners^ryan phillippe completely devasted domestic violence allegations the claims are false^meghan markle kate middleton first official royal speeches had just one thing common^katie couric opens up about matt lauer firing today show^gwen stefani joins blake shelton onstage he jokes about messin around when they first met^watch dwayne johnson do his best emily blunt impression front emily blunt^gwen stefani joins blake shelton onstage he jokes about messin around when they first met^kaley cuoco gives update shoulder surgery recovery 'ice is my best friend^the crown just cast their new prince charles princess anne queen mother season^robert pattinson opens up about keeping his life private going therapy^pregnant troian bellisario posts heartbreaking message after friend loses baby months along^amanda seyfried shares 'good advice she used when introducing her dog finn her baby girl^julia roberts says rumors about her her husband 'hurt 'i 'm so proud my marriage^it official colin jost calls scarlett johansson his 'girlfriend saturday night live^francia raisa fears before donating kidney selena gomez 'i did n't want her see i was scared^britney spears appears terrified man crashes stage during vegas residency he got gun^britney spears appears terrified man crashes stage vegas residency he got gun^celebrities react hurricane irma as it pushes toward puerto rico florida^drake responds rumors asked fan remove hijab i utilized fake media story^lorde sets record straight taylor swift friendship fiery letter^ryan phillippe sues ex elsie hewitt after she claimed he brutally beat her drunken rage^mom who suffered same morning sickness princess kate shares her survival tips it miserable^kim kardashian slams 'liar caitlyn jenner comments about late father robert 'she is not good person^kim kardashian slams 'liar caitlyn jenner comments about late father robert 'she is not good person^justin bieber 'is not over selena gomez despite marriage hailey baldwin says source^justin bieber marriage 'threw selena gomez 'off guard hit her hard says source^derek hough julianne wedding i witnessed my baby sister marry man her dreams^christina aguilera 'it really cute that blake shelton gwen stefani found love the voice^oscar isaac talks carrie fisher posthumous return star wars it 'made lot sense^kourtney kardashian warns scott disick not 'disrespect ex younes bendjima^blake shelton friends were shocked he snagged gwen stefani 'they were like what hell^politicians celebrities react trump supreme court justice nominee^brad pitt patrick dempsey set accelerate star power le mans race^brad pitt wave start flag le mans hours auto race next month^margot robbie marries tom ackerley secret wedding ceremony reports^caitlyn jenner reveals decided undergo sex reassignment surgery^emmy awards the complete winners list^angelina jolie brad pitt reach agreement handle divorce privately we committed act united front^angelina jolie brad pitt reach agreement handle divorce privately we committed act united front^kim shares throwback photo kris caitlyn after family drama sending fans overdrive^justin bieber 'is not over selena gomez despite marriage hailey baldwin says source^in honor rd birthday see transformed years^justin bieber wife hailey baldwin all smiles after source says he not over selena gomez^where caitlyn jenner stands every woman kardashian family^celebrities react death jonathan demme he could anything^andy cohen calls kathy griffin accusations drug use 100 false^why kylie jenner is 'very protective stormi how her baby is bonding cousin chicago^michael strahan the view sara haines host good morning america new third hour report^nicole kidman bravely captures tarantula her horrified children look on 'get back mom^kim kardashian says having three kids left her 'fully neglecting kanye west^is brad pitt dating mit professor they just friends report says peoplenow^is brad pitt dating mit professor they just friends report says^jennifer lopez is missing boyfriend alex rodriguez after having spent just 'one day apart^sharon ozzy osbourne split years marriage sources say might reconcile^jennifer lawrence darren aronofsky split after year together^pregnant eva longoria inside her love story husband jos pepe bast n^nick jonas mortified selena gomez reveals he ruined double date with taylor swift amp his brother^teresa giudice amp husband joe spend their birthdays apart source says he lost lbs prison^jennifer garner confronted lindsay shookus about ben affleck relationship sources say^justin theroux steps out year old model erika cardenas n.y.c^george clooney is all smiles he wraps filming italy after scary scooter crash^cheryl burke returns dancing stars^courteney cox amp lisa kudrow have mini friends reunion before show th anniversary^christina el moussa boyfriend ant anstead i can see myself getting married him^hoda kotb al roker amp craig melvin open megyn kelly today hour first show since cancellation^courteney cox amp lisa kudrow have mini friends reunion before show th anniversary^channing tatum jenna dewan split after nearly years marriage 'we have lovingly chosen separate^pregnant jessica simpson cradles her baby bump while bidding big apple adieu cute snap^baby girl will be here soon all jessica simpson stylish bump pics^pregnant jessica simpson shares first bump photo baby was 'very happy surprise says source^how jessica simpson hid baby bump stage willie nelson weeks before announcing pregnancy^kim kardashian says she did n't realize kanye west was suffering anxiety after paris attack^oops savannah guthrie apologizes after accidentally swearing today show^brad pitt spends father day london his kids amid custody dispute^how brody jenner dad caitlyn jenner repaired their relationship after her transition^new year eve baby jessica alba cash warren welcome son hayes alba see his adorable first photo^the weeknd bares broken heart new album post selena gomez split but does he want bella back^gwen stefani forced skip vegas performance rupturing eardrum^brody jenner opens up about his wedding kaitlynn carter 'i am luckiest man earth^caitlyn jenner hits charity event austria instead son brody wedding weekend indonesia^inside brody jenner 'dreamy wedding kaitlynn carter fireworks amp a.m dancing^the hills star brody jenner marries kaitlynn carter inside their destination wedding^inside brody jenner kaitlynn carter ultra exclusive island wedding venue^caitlyn jenner ex throws shade after former olympian did n't attend their son brody wedding^brody jenner says he disappointed dad caitlyn jenner missed his wedding^angelina jolie opens up new interview i don enjoy being single^why katie holmes jamie foxx never leave dinner date together^rob kardashian blac chyna reach custody agreement over baby dream^mel b estranged husband stephen belafonte settle domestic violence claims divorce report^kourtney kardashian wears sheer shirt girls night out post breakup younes bendjima^from 'rebound breakup kourtney kardashian younes bendjima relationship timeline^kourtney kardashian sophia richie caitlyn jenner attend star studded malibu chili cook off^kanye west leaves video shoot after shots were fired he 'was never in danger says source^jon hamm talks frat hazing allegations his softcore porn gig split jennifer westfeldt^anne hathaway takes romantic stroll adam plus katie holmes lady gaga amp more^jennifer aniston amp adam sandler walk hand hand plus britney spears katie holmes amp more^jamie foxx spotted visiting katie holmes n.y.c amid romantic summer^kanye west has had 'elosive fights kris jenner amp kim kardashian ca n't 'control him sources^robert pattinson near firing twilight i was playing edward 'a little bit too miserable^robert pattinson near firing twilight i was playing edward 'a little bit too miserable^parading patriots jennifer garner her kids ride atop truck during fourth july parade^new details brad pitt angelina jolie shocking split inside divorce negotiations kids upbringin^caitlyn heads capitol jenner rep addresses reports inaugural dance trump^rhonj teresa giudice flips out accusations that she cheating husband joe arise^kim kardashian says kanye west was warned not date her because her sex tape^all top contenders co host spot live before ryan seacrest got job^pregnant khlo kardashian says she misses sister kylie jenner she nests cleveland^kylie jenner shares thing misses away home via^kylie jenner 'misses parts her old life is ready for things return 'normal source^kylie jenner already misses dark hair via style^scott disick jokes kourtney kardashian snapchat 're getting back together^see official royal baby announcement outside buckingham palace^travis scott pleads guilty disorderly conduct after allegedly inciting riot during concert^today peoplenow bindi irwin says engaged boyfriend chandler powell yet 'i really love gu^bindi irwin says she not engaged boyfriend chandler powell yet 'i really love this guy peoplenow^bindi irwin says she not engaged boyfriend chandler powell yet 'i really love this guy^chris soules ex fianc e whitney bischoff reacts sad arrest^chris soules ex fianc e whitney bischoff reacts sad arrest^julia roberts shares sweet hug husband danny moder they bid farewell summer^bachelor paradise chris krystal are moving together see their new home^kim kardashian amp kanye west 'put hoodies secretly elored tokyo no media during surprise birthday trip^new mom khlo kardashian heartbreak everything we know about tristan thompson cheating scandal^celebrities slam donald trump criticizing san juan mayor she pleads help her people^why kylie jenner stopped showing stormi face she 'shocked 'nasty comments source says^kim kardashian khlo reconciling tristan thompson 'she has do what makes her happy^kim kardashian slams 'liar caitlyn jenner comments about late father robert 'she is not good person^kim kardashian slams 'liar caitlyn jenner comments about late father robert 'she is not good person^khlo kardashian shows off her 'revenge body amid rough patch tristan thompson^kim kardashian amp kanye west return lakeside getaway 'happy date night malibu source^anne hathaway takes romantic stroll adam plus katie holmes lady gaga amp more^jennifer aniston amp adam sandler walk hand hand plus britney spears katie holmes amp more^jamie foxx spotted visiting katie holmes n.y.c amid romantic summer^christina aguilera 'it really cute that blake shelton gwen stefani found love the voice^kourtney kardashian still thinks sofia richie is 'too young scott disick source^kourtney kardashian thinks sofia richie 'is way too young scott disick source^kourtney kardashian thinks sofia richie 'is way too young scott disick source^how brad pitt angelina jolie divorce eloded^emma stone gushes over her dear wonderful friend ryan gosling he so special^angelina jolie 'focused healing her family splits lawyer brad pitt divorce^just married prince harry meghan markle tie knot fairy tale wedding royalwedding^today on peoplenow teri hatcher denies that she 'broke homeless living out her van 'it totally abs^teri hatcher denies that she 'broke homeless living out her van 'it totally absurd^a 'dream come true amp 'dirrty halloween birthday girl kylie jenner shares highlights her last year^koalas flowers baby board prince harry meghan markle kick first royal tour sydney^kanye west calls jay z amp beyonc 'famleeeeee after revealing he was 'hurt couple skipping wedding kim karda^new details brad pitt angelina jolie shocking split inside divorce negotiations kids upbringin^jamie foxx 'doesn seem worried katie holmes relationship rumors 'guys weekend source^kourtney kardashian says ex scott disick 'will always be family^jennifer lopez alex rodriguez go jewelry shopping together valentine day^why latest twist angelina jolie brad pitt divorce battle is so unusual^angelina jolie her kids go hiking labor day custody battle continues brad pitt^brad pitt angelina jolie agree continue interim child custody agreement amid divorce battle^kourtney kardashian still thinks sofia richie is 'too young scott disick source^today on peoplenow teri hatcher denies that she 'broke homeless living out her van 'it totally abs^teri hatcher denies that she 'broke homeless living out her van 'it totally absurd^prince harry says he 'very excited introduce meghan markle australia first royal visit^priyanka chopra speaks out meghan markle pregnancy 'i 'm really excited her^christina aguilera 'it really cute that blake shelton gwen stefani found love the voice^meghan markle just dropped her own major royal baby hint^maks chmerkovskiy skipped dwts performance due 'big chemistry issue with partner vanessa lachey says source^maks chmerkovskiy skipped dwts performance due 'big chemistry issue with partner vanessa lachey says source^blake shelton says he gwen stefani thought their relationship was 'rebound deal first^christina aguilera 'it really cute that blake shelton gwen stefani found love the voice^jennifer lopez alex rodriguez celebrate christmas miami their families^joe alwyn goes public instagram see his sly nod girlfriend taylor swift^nicki minaj was 'joking about love fest eminem despite social media comments report^kevin hart relives his cheating scandal by playing himself j. cole music video^kanye west has had 'elosive fights kris jenner amp kim kardashian ca n't 'control him sources^kourtney kardashian 'will never get back scott disick source says^flip flop atlanta couple hid tribute their son childhood cancer survivor each home^everything we know kendall jenner rumored new beau ben simmons^christina aguilera 'it really cute that blake shelton gwen stefani found love the voice^all top contenders co host spot live before ryan seacrest got job^brad pitt visited his 'genius gorgeous new friend professor neri oxman mit last fall^pregnant kylie jenner 'looked great family christmas eve party source says^how weeknd helped selena gomez recover her kidney transplant one her biggest supports says source^how weeknd helped selena gomez recover her kidney transplant one her biggest supports says source^everything will jada pinkett smith have said about their unconventional year marriage^hoda kotb says she still 'keeps touch matt lauer after his today show firing^miranda kerr snapchat ceo evan spiegel engaged check dazzling diamond ring^reasons kaia gerber next kendall jenner via style^reasons kaia gerber next kendall jenner via style^ashlee simpson returns reality tv husband evan ross years after the ashlee simpson show^kanye west has had 'elosive fights kris jenner amp kim kardashian ca n't 'control him sources^kim kardashian west is terrified parenting social media age kids should not be falling asleep phones^kim kardashian insisted sick kanye west go hospital after saint pneumonia scare source^princess diana brad pitt julia roberts find celeb people magazine covers^kylie jenner wants 'be out spotlight until baby birth 'focus health amp happiness source^a timeline complicated relationship taylor swift kim kardashian west^a timeline complicated relationship between taylor swift kim kardashian west^a timeline complicated relationship taylor swift kim kardashian west^rihanna responds photos her feuding boyfriend hassan jameel lion meme^selena gomez is feeling empowered after continuing treatment anxiety amp depression source^kim kourtney kardashian celebrate labor day together kendall jenner bella hadid^sandra bullock is not married boyfriend bryan randall her rep says^kourtney kardashian shares current meal plan that helps her 'stay track^kourtney kardashian sex addict scott disick we are never getting back together it done^modern family julie bowen reveals hardest part being mother boys how she handles 'mom guilt^jersey shore star ronnie ortiz magro ex jen harley arrested domestic battery^giuliana rancic returning co host e news alongside 'best friend jason kennedy 'ca n't wait^giuliana rancic returning co host e news alongside 'best friend jason kennedy 'ca n't wait^ryan reynolds reveals he once saved his nephew life^solange knowles reveals autonomic disorder diagnosis cancels new year eve performance^farewell white hats scandal end after season report^stanley tucci felicity blunt welcome daughter emilia giovanna^unreal star josh kelly reveals dramatic lb weight loss^jason mraz opens up about his 'two spirit sexuality 'i 've had eeriences with men^prince harry is engaged meghan markle queen says she is 'delighted couple peoplenow^the bachelor vanessa grimaldi has new boyfriend months after nick viall split^khlo kardashian tristan thompson is 'lucky i was pregnant when i found out he cheated^your ultimate spring break packing list via^your ultimate spring break packing list^amy schumer hospitalized days 'horrible kidney infection^troy gentry helicopter crash caused engine failure new report details final moments fatal flight^jada pinkett smith recalls heated phone call with will smith ex 'it my house now^will jada pinkett smith call themselves 'life partners rather than married here why^will jada pinkett smith call themselves 'life partners rather than married here why peoplenow^grammy winner pink graces cover people beautiful issue her two kids^grammy winner graces cover people beautiful issue her two kids^teen mom jenelle evans admits she used drugs while pregnant daughter ensley^kourtney kardashian slams scott disick being 'photographed different hooker every day^laura prepon ben foster are married 'thank you all love^friendly exes ryan seacrest congratulates stunning julianne hough her wedding brooks laich^surprise bachelor paradise carly waddell evan bass are eecting their first child together^new parents kylie jenner travis scott step out smoothies dinner date^the mindy project fortune feimster is engaged mindy kaling 'will officiate her wedding^luann de lesseps accuses russell simmons groping her elevator 'he was just pig^chester bennington cause death revealed rocker died suicide hanging coroner confirms^teen mom star mackenzie mckee reveals her mother was diagnosed brain cancer^glee star charice pempengco changes name jake zyrus after admitting 'my soul is male^all details the bachelor winter games clare crawley custom neil lane engagement ring^kim kardashian shows off new grill first time since she was targeted in paris robbery^jennifer lopez says she still believes marriage 'is n't forcing anything right now alex rodriguez^kyle richards husband speaks out after home burglary nothing replaces family^aaron paul says his baby girl is due 'any minute now 'i 'm over moon excited^tisha campbell martin files divorce husband duane after more than years marriage^caitriona balfe is engaged outlander actress shows off her ring goldenglobes^shahs sunset star mike shouhed divorce estranged wife jessica parido is finalized^kfc runs out gravy one week after suffering chicken shortage^hall fame quarterback troy aikman is engaged capa mooty^pippa middleton fianc james matthews things know^kylie minogue says 'awkward trademark battle against kylie jenner was 'nothing personal all^darren criss is engaged actor proposes girlfriend mia swier after years dating^alicia silverstone husband christopher jarecki split after years together report^alicia silverstone husband christopher jarecki split after years together^kylie jenner shows off foot christmas tree is it inspired her baby sex^kylie jenner shows off her foot gold christmas tree sneaks selfie stormi^kylie jenner shows off foot christmas tree is it inspired her baby sex peoplenow^teen mom maci bookout files order protection against recently arrested ex ryan edwards^blake lively injured her hand set the rhythm section^rachel brosnahan shares video kate spade happier times as she pays tribute her aunt^sam smith opens up gender fluid identity i feel just much woman i am man^chrissy teigen jokes about joining victoria secret fashion show i gon na kill it^jon gosselin celebrates fourth july daughter hannah^teen mom og tyler baltierra loses pounds weeks 'eating healthier just feels better^the bachelor bekah m. was missing persons list until fan recognized her show^luann de lesseps pleads not guilty christmas eve arrest charges palm beach reports^see complete naacp image awards winners list^is taylor swift ready it about joe alwyn harry styles see why her swifties are split^serena williams will return competitive tennis months after giving birth daughter^how to get away with murder karla souza gives birth first child 'welcome baby girl gianna^idina menzel marries rent costar aaron lohr^congratulations happy couple marries rent costar aaron lohr^taylor swift helped formerly homeless pregnant fan buy house baby gear 'she lifted me off ground^jeopardy host alex trebek recovering surgery remove blood clots brain^josh brolin addresses diane lane domestic abuse arrest 'there no elaining it^new mom kylie jenner makes second post pregnancy outing celebrate her friend baby shower^miss north dakota cara mund crowned miss america^woody allen elains why he thinks he should be 'poster boy metoo movement^kristen bell will still wear black host sag awards it was 'the universe message me^dancing stars emma slater sasha farber are married^big little lies laura dern wins first ever emmy supporting actress limited series movie^the challenge natalie negrotti comes out pansexual i wanted 'share my truth^kendall jenner was hospitalized before attending vanity fair oscars party report^jeff goldblum emilie livingston welcome son river joe^mark salling autopsy reveals he had alcohol but no drugs his system time suicide^ariana grande cancels vietnam concert due health problems there is nothing i hate do more^nelly furtado secretly split husband demacio castellon years marriage^princess victoria allegedly groped french photographer swedish academy event^anne hathaway reveals she gaining weight role preemptively shuts down body shamers^jonah hill brother jordan feldstein cause death released^shot love tila tequila star ashley mcneely found dead report^teen mom jenelle evans david eason are married^unitedairlines announces policy changes response passenger removal incident^kevin spacey house cards character frank underwood 'laid rest south carolina town^portia de rossi says steven seagal 'unzipped his leather pants during audition^'hanging up orange lydia mclaughlin is leaving real housewives orange county again^ryan reynolds responds blake lively marriage rumors 'i could use little me time^fabulous carole radziwill beau adam kenworthy posts racy birthday tribute rhony star^vanderpump rules stars jax taylor brittany cartwright are engaged see ring^singer elle king says skipped wedding favor rock show^whatever it takes drake stages epic degrassi the next generation reunion 'i 'm upset video^jason priestley says he punched harvey weinstein face golden globes party^happy savannahversary savannah guthrie celebrates years today^meghan markle officially leaving suits after season following engagement news says usa network^inside bachelorette contestant michael nance life tragic death he felt things very deeply^cardi b wants 'lit baby shower daughter way 'i might even drink some red wine^john stamos fianc e caitlin mchugh debuts baby bump instagram while wearing sports bra^meghan markle dad will attend royal wedding despite half brother claim he was n't invited^meghan markle dad wo n't attend royal wedding after it was revealed he staged photos report^keaton jones reveals he has n't returned school since his anti bullying video went viral 'it makes me feel awful^scarlett johansson 'ca n't unsee throwback photo boyfriend colin jost beard 'wow^ed westwick accused sexual assault third woman^alanis morissette ex manager sentenced years prison embezzling millions singer^pink reveals christina aguilera tried punch her 'she swung me club^bet awards the complete list winners^did chris evans jenny slate break up again^every adorable photo prince george princess charlotte royal wedding^every adorable photo prince george princess charlotte royal wedding^jesse camp former mtv wan na be vj star found alive after being reported missing police^jesse camp star mtv wan na be vj reported missing police^jesse camp star mtv wan na be vj reported missing police^alyssa milano responds fat shaming backlash over netflix insatiable^rob kardashian blac chyna reach custody agreement over baby dream^kim zolciak biermann surprises son kash with pit bull puppy four months after dog attack^victoria secret adriana lima i will not take off my clothes anymore for empty cause^bringing sexy back justin timberlake announces man woods tour get dates peoplenow^simon cowell rushed hospital after 'scary accident his london home^steve martin martin short have colonoscopy parties tom hanks 'it great fun^jt is back justin timberlake announces new album man woods sneak peek video^rihanna wants travel back time day she lost her virginity^long island medium theresa caputo husband larry living opposite coasts wake split^demi lovato splits mma fighter guilherme bomba vasconcelos^demi lovato splits mma fighter guilherme bomba vasconcelos^icymi demi lovato splits mma fighter guilherme bomba vasconcelos^the starbucks narwhal frappuccino is now thing and it tastes like pink starburst^justin theroux breaks social media silence first time after split from jennifer aniston calls out selena^star jones ex husband al reynolds comes out bisexual^anna wintour daughter bee shaffer marries francesco carrozzini intimate long island wedding^anna wintour daughter bee shaffer engaged late vogue italia editor son francesco carrozzini^anna wintour daughter bee shaffer marries francesco carrozzini again see her wedding dress^zooey deschanel jacob pechenik welcome son charlie wolf^jason aldean brittany kerr are eecting baby boy^paula faris is leaving the view good morning america new role abc^first look go behind scenes mamma mia here we go again lily james^vanessa paradis johnny depp ex marries film director samuel benchetrit france^blac chyna assistant dies after being taken off of life support report^kim zolciak biermann is getting smaller breast implants 'ca n't wait downsize little^mischa barton ex boyfriend agrees restraining order will not release alleged sex tape^enrique iglesias says 'i love my babies he talks about his twins first time^how princess eugenie wedding dress compares kate middleton meghan markle gowns^neve campbell reveals she jj feild adopted baby boy 'we are madly love him^hallelujah tori kelly is engaged basketball player boyfriend andr murillo^kim kardashian reveals her psoriasis is almost completely gone here what she uses^tessa thompson clarifies comment about lena dunham not being part time up movement^former foxnews chairman ceo roger ailes dead^kendra wilkinson files divorce hank baskett after almost years marriage^kendra wilkinson files divorce hank baskett after almost years marriage^abby lee miller undergoes 'emergency surgery amid battle cancer^queer eye tom jackson abby parr get married again^vanderpump rules stassi schroeder apologizes controversial metoo comments 'i crossed line^bachelor paradise carly waddell evan bass reveal baby girl name^karlie kloss is engaged joshua kushner 'their hearts are full^chris stapleton wife morgane eecting twins 2 more way^kaley cuoco marries karl cook romantic ceremony see their wedding photos^does this photo prove amelia earhart survived her final flight new theory suggests she was captured japanese^does photo prove amelia earhart survived final flight^icymi does this photo prove amelia earhart survived her final flight theory suggests she was captured japanese^controversial group nxivm suspends operations after allison mack sex trafficking arrest^eric dane responds rebecca gayheart divorce filing^how blake lively helped ryan reynolds reconcile his tough dad^jennifer lawrence darren aronofsky spotted together one month after split^jennifer lawrence darren aronofsky split after year together^exclusive glee dean geyer engaged code black actress jillian murray see ring^naya rivera ex ryan dorsey celebrates christmas his 'main man son josey^kaley cuoco is engaged boyfriend karl cook watch her emotional reaction proposal amp see her diamond ring^taylor swift music video director claims beyonc lemonade copied swift 'bad blood video^olivia wilde dog 'best friend paco dies her birthday^katy perry her 'darling orlando bloom meet pope francis vatican city^scarlett johansson romain dauriac finalize their divorce settle custody fight^billionaire matthew mellon ex husband jimmy choo tamara mellon dies mexican rehab report^surprise ariana grande pete davidson are engaged after dating few weeks^'hot felon jeremy meeks chloe green welcome son jayden^ca n't keep hands selena gomez the weeknd share cute snap coachella^selena gomez shares selfie weeknd coachella keep hands^melania trump is trapped her hotel room because g20 protesters^melania trump is trapped her hotel room because g20 protesters^billy bush wife sydney davis files divorce months after their separation report^kanye west reportedly settles 10 million lawsuit over canceled saint pablo tour^andrew garfield faces backlash saying 'i gay man right without physical act'^andrew garfield faces backlash after saying 'i am gay man right now just without physical act^gwyneth paltrow brad falchuk confirm their engagement 'we feel incredibly lucky^exclusive bradley cooper irina shayk welcome first child^how get away murder star karla souza alleges she was raped by director mexico^rebecca gayheart files divorce from eric dane after years marriage^all details dwts star jenna johnson huge diamond engagement ring val chmerkovskiy^shameless star jeremy allen white addison timlin eecting first child^mallrats actor jeremy london arrested alleged domestic violence^mark ronson wife jos phine de la baume files divorce after years^farrah abraham daughter sips 150 apple juice gold flakes while vacation dubai^billboard music awards check out complete list winners^siggy flicker leaving real housewives new jersey after seasons^greta gerwig says she 'will not work woody allen again after sexual misconduct allegations^john david duggar is engaged abbie burnett^meghan markle prince harry 'found each other change world says nacho figueras^amber rose says she rapper savage are 'perfect each other read her emotional note^lcd soundsystem gavin russom comes out transgender^the bachelor winter games stars dean unglert lesley murphy split^liam payne niall horan have partial one direction reunion indiana concert^khlo kardashian admits she thinks about getting nose job 'every day^billboard music awards check out complete list winners^sarah hyland is 'very proud that wells adams 'thinks it sexy when woman speaks her mind^tom petty rushed hospital after suffering full cardiac arrest report^rosanna arquette reveals she once rejected warren beatty 'he handsome but not 'for me^usher wife grace miguel separate after two years marriage^kevin can wait will kill off erinn hayes character this fall^and bride wore beige penn badgley domino kirke get married again^gwyneth paltrow denies she 'becky with good hair after amber rose names her beyonc inspiration^serena williams withdraws australian open 'i 'm not where i want be after baby birth^jonathan cheban is legally changing his name 'foodg d^jennifer aniston sports wrist brace first public appearance since justin theroux split^justin theroux is 'doing his thing since jennifer aniston split inside his single life^jennifer aniston 'has seemed fine since split justin theroux will 'continue be friends^justin timberlake wants have 'as many kids he can wife jessica biel^is kirsten dunst ready be mom it time have babies chill^loretta lynn admitted into nashville hospital after suffering stroke^will smith addresses jada pinkett divorce rumors new song ahead world cup performance peoplenow^will smith addresses jada pinkett divorce rumors new song ahead world cup performance^jada pinkett smith elains why she will smith will 'never get divorced 'we are family^january jones addresses rumors that she dating the bachelor nick viall^rod stewart mocks elton john retirement tour 'it stinks selling tickets it dishonest^star jones is engaged boyfriend ricardo lugo^meghan markle kate middleton step out their first ever solo outing together wimbledon peoplenow^fiona baby hippo dad henry dies after battling infection^richard simmons hospitalized california severe indigestion says manager^khlo kardashian 'is n't ready give up tristan thompson she 'very torn source says^selena gomez mom admits she 'not happy about daughter reunion with justin bieber^rose mcgowan says anthony bourdain asia argento had 'free relationship 'without borders^royal wedding recap relive prince harry meghan markle big day under minutes^kelly clarkson host billboard music awards^lea michele announces bff jonathan groff will be her maid honor wedding zandy reich^lea michele announces bff jonathan groff will be her maid honor wedding zandy reich peoplenow^luann de lesseps says she relapsed after her ex husband kids sued her 'i felt betrayed^daniel craig confirms he will play james bond again^demi lovato remains hospitalized after suffering complications apparent overdose sources^carrie underwood husband mike fisher celebrate year wedding anniversary^josh charles wife sophie flack are eecting baby no^listen ariana grande somewhere over rainbow cover released benefit manchester victims^it official prince william standing prince harry side best man upcoming royal wedding^prince william steps out days before serving best man prince harry royal wedding^leslie jones accuses ritz carlton racism post bet awards tweet they don like black people^see terrifying moment sea lion drags little girl water canada^mama june daughter lauryn 'pumpkin shannon gets married las vegas^andrea constand speaks out after judge declares mistrial bill cosby sexual assault case^steve irwin son robert recovering emergency surgery appendix removal^oscars check out complete list winners^oscars check out complete list winners^oscars check out complete list winners^oscars check out complete list winners^teen mom og tyler baltierra reveals how he lost lbs months^ving rhames says police held him gunpoint his own home after neighbor reported robbery^jennifer garner ben affleck officially file divorce 'it time says source^jennifer lawrence says she wants take break acting milk goats farm^bode miller thanks fans their 'love support following month old daughter drowning^mila kunis surprises parents home makeover see incredible results ashton sweet toast^mila kunis surprises parents home makeover see incredible results ashton sweet toast^cassadee pope talks 'super easy breezy romance sam palladio their paw fect first date^chris pratt files divorce anna faris^morningjoe co hosts joe scarborough mika brzezinski engaged^morning joe co hosts joe scarborough mika brzezinski are engaged^confirmed morning joe co hosts joe scarborough mika brzezinski engaged^pauley perrette leaving ncis after seasons,278,268,-10,546,0.5091575091575091,-0.01831501831501832,1
1367531,FoxNews,398,18416786,65345,418052,8,356,17,22,follow america cable news network delivering breaking news insightful analysis must-see videos,"port authority bombing suspect wrote facebook 'trump failed protect nation^port authority bombing suspect wrote facebook 'trump failed protect nation via^port authority bombing suspect wrote facebook 'trump failed protect nation^ohio student suspended staying class national walkout day^ohio student suspended staying class national walkout day^ohio student suspended staying class national walkout day^in approximately ,000 pages code federal regulations today^in approximately ,000 pages code federal regulations today^missed i think really good opportunity distinguish united states coun^moments ago former president george w. bush former first lady laura bush released statement death^just in dan coats statement my admittedly awkward response way meant disrespectful criticize^the united states taken advantage decades decades ca n't anymore watch presi^the united states taken advantage decades decades ca n't anymore watch presi^the community services editor capital gazette issued statement newsroom shooting left l^in rnc acceptance speech sen. john mccain outlined philosophy politics life.^tonight joins live exclusive interview discuss midterms a^today do n't miss exclusive interview tune fox news channel p et p et^conservative lawmakers demand greater transparency deputy attorney general rod rosenstein closed door intervie^sunday treasury secretary sits chris wallace exclusive interview on^sunday do n't miss exclusive interview check local listings tune at^supreme court nomination if think quality people president going^tune in sits p et discuss north korea exclusive^today do n't miss exclusive interview tune p p et fox news channe^rescue dog searches finds missing dog stuck mud^the media puts quotes people say extreme items extreme language watch^when i talking president obama essentially ready go war north korea watch steve dooc^the policies president trump advancing ... actually working revive economy sunday^coming up president trump grants exclusive interview brian tune et on^the european union possibly bad china smaller watch full interview preside^sunday treasury secretary sits chris wallace exclusive interview on^tune in joins tonight exclusive interview p et fox news^tonight joins live exclusive interview discuss midterms a^i ... predict 'll end every republican supporting judge kavanaugh confirmation i also think 'll end^tomorrow do n't miss exclusive interview check local listings tune p^former ice acting director thomas homan discussed response migrant caravan headed u.s. borde^tonight roseanne barr sits don miss must see interview hannity p et fox^thursday roseanne barr sits don miss must see interview hannity p et fo^trump may pledge cooperation trade elosive interview via^pence reports fbi surveillance trump campaign i think would troubling millions of^today sits prince al waleed bin talal al saud exclusive intervi^former ice acting director thomas homan discussed response migrant caravan headed u.s. borde^lisa page appear capitol hill closed door interview house judiciary oversight committees^strzok hearing when prejudge donald trump guilt lead investigator inter^tonight exclusive interview president nicaragua daniel ortega^moments away exclusive interview president tune at^today joins chris wallace exclusive interview tune fox news channel^in interview democratic congressman discussed economic philosophy.^watch preview interview 'the first family get dep^the policies president trump advancing ... actually working revive economy sunday^tomorrow do n't miss exclusive interview foxnewssunday tune p p et fox news^tonight roseanne barr sits don miss part ii must see interview hannity^tomorrow kudlow joins chris wallace interview tune p p et fox news^exclusive house intel gop asked trump declassify key parts carter page fisa application^tomorrow watch highlights chris wallace interview russian president vladimir putin .^i 'd like see answers n't take server fbi n't take server dnc.^monday president donald trump gives powerful interview tune hannity fox news channel^sunday do n't miss exclusive interview check local listings tune p^tune in joins tonight exclusive interview p et fox news^trump urges americans vote republican keep agenda track fox news interview^lisa page appear capitol hill closed door interview house judiciary oversight committees^i told players ... let know i 'll look if 're aggrieved i pardon i 'll g^tonight roseanne barr sits don miss part ii must see interview hannity^today do n't miss former homeland security secretary jeh johnson exclusive interview check you^reports surveillance trump campaign i think would troubling millions ame^tomorrow exclusive interview president tune^today do n't miss exclusive interview check local listings tune t^watch full interview pastor andrew brunson wife norine^tonight roseanne barr sits don miss must see interview hannity p et fox^today kudlow joins chris wallace interview tune p p et fox news ch^today do n't miss exclusive interview check local listings tune fox^today treasury secretary sits chris wallace exclusive interview^right now exclusive interview president tune fox^today do n't miss exclusive interview tune p p et fox news channel^sunday do n't miss exclusive interview check local listings tune at^woman 'helped save six lives posting heartfelt messages uk bridge^today chris wallace interviews tune p amp p et f^today do n't miss exclusive interview foxnewssunday tune p p et fox news cha^tonight exclusive interview president nicaragua daniel ortega^today do n't miss exclusive interview tune p p et fox news channel^fox news first trump joins 'fox amp friends exclusive interview 'gang briefed russia probe^negotiations mueller team narrow scope potential interview we'^says 'i 'm pro russia hits ex cia chief brennan calling putin news conference 'treasonous i^today exclusive interview president tune et^today do n't miss exclusive interview sen. foxnewssunday tune p p et fox n^tomorrow do n't miss exclusive interview check local listings tune at^in surprise interview fox friends president accused top people fbi plotti^sunday do n't miss exclusive interview check local listings tune fox ne^coming up mitch mcconnell talks tonight specialreport watch interview p e^tonight president donald trump gives powerful interview tune hannity fox news channe^i beat clinton dynasty i beat bush dynasty i guess hopefully i 'm process beating dishon^today do n't miss exclusive interview check local listings tune fox new^today exclusive interview house majority whip rep. t^tomorrow exclusive interview president tune^that going platform open borders equals crime i think 'll never win another^thursday roseanne barr sits don miss must see interview hannity p et fo^today do n't miss exclusive interview check local listings tune p an^this aberration mistake criminal act responsible punished.^obama told cia somebody fbi russia he never anything how come never ge^right now sundayfutures exclusive interview mike pence tune fox news channe^tune in joins tonight exclusive interview p et fox news^tomorrow do n't miss exclusive interview sen. foxnewssunday tune p p et fo^monday president donald trump gives powerful interview tune hannity fox news channel^tune in joins exclusive interview tonight p et fox news ch^today do n't miss exclusive interview check local listings tune p^accuser kathleen willey nbc interview i could believe words coming of^tomorrow do n't miss exclusive interview check local listings tune p^in surprise interview fox friends president accused top people fbi plotti^today do n't miss exclusive interview check local listings tune^tonight roseanne barr sits don miss must see interview hannity p et fox^tune in nicaraguan president daniel ortega joins exclusive interview tonight at^tune in mitch mcconnell talks tonight specialreport watch interview p et^today sits prince al waleed bin talal al saud exclusive intervi^sunday do n't miss exclusive interview check local listings tune in^tomorrow do n't miss exclusive interview check local listings tune at^today do n't miss exclusive interview tune fox news channel p et an^today joins chris wallace exclusive interview tune fox news channel a^our presidents business leaders missing action watch full interview wi^if look steel aluminum practically built new industry period months watch^i ... predict 'll end every republican supporting judge kavanaugh confirmation i also think 'll end^thursday president trump grants exclusive interview brian tune et on^today treasury secretary sits chris wallace exclusive interview^tonight president donald trump gives powerful interview tune hannity fox news channe^there evidence collusion russians gone watch full interview president^concerns potential interview mueller team do i want angry democrats dec^what heck else server watch full interview on^concerns potential interview mueller team do i want angry democrats dec^coming up tune interview president attorney pm et^potential interview mueller team one things would show ... the^what heck else server watch full interview on^tonight tune interview president attorney pm et on^there collusion conspiracy russians involving watch^negotiations mueller team narrow scope potential interview we'^there evidence collusion russians gone watch full interview president^rudy giuliani slammed mueller investigation hannity hours legal team said respond^watch chris wallace full interview rudy giuliani president attorney part .^rudy giuliani potential mueller interview they could 've concluded interview thing two months^there collusion conspiracy russians involving watch^potential interview mueller team one things would show ... the^president attorney rudy giuliani weighing possibility president sitting down^rudy giuliani status potential interview mueller probably away^watch chris wallace full interview rudy giuliani president attorney part .^coming up speech nv gop convention full live coverage tune fox news channel^i called ms 'animals ... said 'that terrible thing say she defending ms .^i great nickname ... wacky jacky watch full speech nevada gop state convention^we 're piggy bank everybody likes rob watch full speech nevada gop state conve^nobody fought harder cut taxes watch full speech nevada gop state conventi^we 're getting rid sanctuary cities we 're getting rid unsafe places we 're protecting second amendment.^'' interview praises kim amp kanye says he may need 'overrule sessions prison reform^former ice acting director thomas homan discussed response migrant caravan headed u.s. borde^former ice acting director thomas homan discussed response migrant caravan headed u.s. borde^watch full interview pastor andrew brunson wife norine^in interview president spoke border wall called tool of^'fox amp friends interview trump praises kim amp kanye says he may need 'overrule sessions prison reform^i 'm going get one little kits middle debate proclaims tha^rep. this civility you go want win ideas debate public opini^a look west virginia gop senate primary candidates ahead debate tonight :30p et fox news chann^i 'm going get one little kits middle debate proclaims tha^rep. this civility you go want win ideas debate public opini^gop governor candidate john cox mr. made clear wanted run instead anothe^during address national federation independent business tuesday touted economy^during address national federation independent business tuesday touted economy^delivers remarks national federation independent business th anniversary celebration washin^turning point usa founder said sunday left resorting mob tactics^on sunday morning futures rep. republican california weighed google came under^on thestory said columnist dallas morning news called bigot declaring amer^in interview sunday morning futures president slammed democrats imm^sunday do n't miss life liberty amp levin tune p et fox news channel^in statement released sunday wrote closely monitor caravan crisis must rem^during interview sunday said wo n't intimidated comments president^sunday joins chris wallace exclusive interview check local listings an^rafael nadal beat austria dominic thiem sunday th french open title becoming first man win^sunday treasury secretary sits chris wallace exclusive interview on^sunday do n't miss exclusive interview check local listings tune to^on sunday slammed virginia restaurant the red hen making white house press secretary sarah^on new 'objectified sits discuss journey events tha^the biggest mistake conservatives made past half century vacate universities hand ove^mexico presidential elections sunday could major ramifications u.s. far left populist l^we remain confident fall judge brett kavanaugh justice brett kavanaugh. sund^don miss special live helsinki sunday et^sunday do n't miss u.s ambassador nato check local listings tune in^pittsburgh mayor bill peduto touted city resiliency press conference sunday following deadly shoo^tweeted sunday kid size submarine en route thailand hopefully useful effort^sunday go inside home tv legend alex trebek p et fox news channel^military personnel rescue workers volunteers head tham luang nang non cave ambulances transport^fox news presents moving story dr. krauthammer life charles krauthammer his words sunday p et^a rescue effort free youth soccer players amp year old coach trapped cave north^sunday joins chris wallace exclusive interview check local listings an^sunday exclusive interview president tune et^the policies president trump advancing ... actually working revive economy sunday^just in a motorcade carrying kim jong un sped streets singapore sunday north korean le^don miss fox report jon scott saturdays p et sundays p et fox news channel^sunday treasury secretary sits chris wallace exclusive interview on^in statement released sunday wrote closely monitor caravan crisis must rem^running chinos one man decided participate new york city marathon sunday fully dressed forrest^we remain confident fall judge brett kavanaugh justice brett kavanaugh. toda^turning point usa founder said sunday left resorting mob tactics^don miss fox report jon scott saturdays p et sundays p et fox news channel^sunday exclusive interview president tune et^objectified back iconic rock stars reality tv mavericks amp biggest names world share their^the empire state building lit colors rainbow honor pride week sunday june .^sunday do n't miss life liberty amp levin special guest tune p et^sunday takes look president ronald reagan role collapsing soviet union do n't miss three^air force one taxis past large crowd president donald trump arrives rally macon georgia r^former ice acting director thomas homan discussed response migrant caravan headed u.s. borde^police cape may new jersey sunday released mugshot adorable pug recent run de^it gotten point i 'm either going get i 'm gon na die way.^melania trump waves walks stage speaking students sadd students against destru^my wife i deeply moved deeply honored able bring boys home. sunday^on sunday morning futures said administration ability secure seco^the manhattan beach police department released vince vaughn mugshot actor arrested early sunday^on new 'objectified sits discuss journey events tha^sunday p et watch revealing interview frontman 'objectified hosted by^former ice acting director thomas homan discussed response migrant caravan headed u.s. borde^sunday do n't miss life liberty amp levin special guest dr. patrick michaels tune at^sunday p et watch revealing interview frontman 'objectified hosted by^lightning strikes ground outskirts village campillos spain heavy rain floods caused mu^on sunday morning futures said administration ability secure seco^a pittsburgh fan holds sign honoring victims deadly shooting spree synagogue saturday^two people support front flowers makeshift memorial tree life synagogue sunday^objectified back iconic rock stars reality tv mavericks biggest names world share th^his journey stories intangible wisdom he joins all new episode '^the policies president trump advancing ... actually working revive economy sunday^ohio restaurant cancels sunday church discount outrage secular organization^sunday go inside home tv legend alex trebek p et fox news channel^maryland governor larry hogan late sunday night declared state emergency ellicott city massive rain^we n't want policies ... diminish trememdous energy economy today sunday spe^the south portico white house decorated sunday ahead hosting halloween event^thick smoke wildfire near western edge prompted park officials temporarily close^on sunday morning futures rep. republican california weighed google came under^in small town veracruz mexico gas station truck stop two nuns began stopping big rigs sunday to^on sunday morning futures trade policy director peter navarro praised president e^sunday do n't miss former homeland security secretary jeh johnson exclusive interview check yo^sunday joins chris wallace exclusive interview check local listings t^sunday do n't miss exclusive interview check local listings tune p^sunday do n't miss life liberty amp levin special guest tune p et o^moments ago gov tx sent prayers former president hospitalized sunday fo^members u.s army engineering brigade place concertina wire around encampment troops department defe^we remain confident fall judge brett kavanaugh justice brett kavanaugh. sund^my wife i deeply moved deeply honored able bring boys home. today^an new season 'objectified premieres sunday nba legend tune fox news channel^luke marklin we read sunday morning really believe dedication walter showed.^the volcan de fuego spanish volcano fire eloded hail ash molten rock sunday killing at^fox news presents moving story dr. krauthammer life charles krauthammer his words sunday p et^despair hope america fox news investigates do n't miss part four special series fox report^firefighters try stop wildfire wind drives embers across highway near clearlake oaks california sun^his journey stories intangible wisdom he joins all new episode '^sunday do n't miss john bolton exclusive interview check local listings tune fo^fireball flies across midwest skies sunday leaves 'brilliant green light^melania trump joining president g7 summit quebec eected me^on investigates gov jerry brown policies effect california tune sund^new zealand prime minister jacinda ardern stands next partner clarke gayford holding newly bor^on new 'objectified sits discuss journey events tha^longtime fox news contributor charles krauthammer laid rest sunday maryland^we n't want policies ... diminish trememdous energy economy today sunday spe^in exclusive interview says 're phase tax cuts^voters gathered sunday hear speeches early voting campaign event democrats cincinnati oh^a huge trump banner unfurled new york game sunday fans president^despair hope america fox news investigates do n't miss part three special series fox report^sunday live singapore ahead president historic summit north korean lea^thousands central american migrants resumed advance toward u.s. border sunday.^sunday do n't miss rudy giuliani president attorney check local listin^in interview sunday morning futures president talked dnc s^sunday do n't miss exclusive interview check local listings tune fox^the honored todd dog game sunday tweeting pup hero dog jumped in^melania trump tweeted enjoyed speaking future leaders sadd students against dest^his journey stories intangible wisdom he joins all new episode '^ohio restaurant cancels sunday church discount outrage secular organization^sunday p et watch revealing interview frontman 'objectified hosted by^sunday do n't miss life liberty amp levin special guest tune p et o^a pittsburgh fan holds sign honoring victims deadly shooting spree synagogue saturday^members u.s army engineering brigade place concertina wire around encampment troops department defe^on sunday morning futures discussed former cia director john brennan.^my wife i deeply moved deeply honored able bring boys home. sunday^don miss fox report jon scott saturdays p et sundays p et fox news channel^pittsburgh mayor bill peduto touted city resiliency press conference sunday following deadly shoo^on sunday morning futures former reagan bush campaign manager ed rollins offered great pra^restaurant bringing back church discount^a rainbow appears front humboldt mountain range seen great basin highway nevada sunda^opinion turkish elections sunday create problem world elected president erdogan^onlookers watch cheer ambulances deliver boys rescued cave northern thailand hospital chia^while campaigning democrats gary indiana sunday former president spoke midterms2018^people walk past projection old city wall jerusalem sunday oct. commemoration vi^lightning strikes ground outskirts village campillos spain heavy rain floods caused mu^on sunday night president congratulated andres manuel lopez obrador becoming next preside^authorities toronto late sunday responded mass shooting city neighborhood known greektown wher^the honored todd dog game sunday tweeting pup hero dog jumped in^sunday p et watch revealing interview frontman 'objectified hosted by^sunday joins chris wallace exclusive interview check local listings t^in interview sunday morning futures president slammed democrats imm^sunday do n't miss rudy giuliani president attorney check local listin^opinion turkish elections sunday create problem world elected president erdogan^the sun rises behind washington monument geese swim potomac river daybreak sunday july^a live look outside chiang rai hospital four boys trapped cave thailand removed su^sunday do n't miss exclusive interview check local listings tune fox^president late sunday tweeted iranian president rouhani never threaten u.s. or^on sunday morning futures trade policy director peter navarro praised president e^president late sunday tweeted iranian president rouhani never threaten u.s. or^running chinos one man decided participate new york city marathon sunday fully dressed forrest^the biggest mistake conservatives made past half century vacate universities hand ove^despair hope america fox news investigates do n't miss part one special series fox report^sunday exclusive interview president tune et^houses damaged mudslide following heavy rains southwestern japan july heavy rainfall hammered sou^on sunday morning futures said every american suspici^killed injured chicago shootings sunday^objectified back iconic rock stars reality tv mavericks biggest names world share th^on sunday morning futures said administration ability secure seco^a woman saudi arabia drives car first time capital streets minutes sunday j^a line forms early voting hamilton county board elections cincinnati oh sunday^sunday don miss singapore ahead president historic meeting north^on sunday morning futures shared thoughts u.s. north korean relations^sunday exclusive interview president tune et^ohio restaurant cancels sunday church discount outrage secular organization^despair hope america fox news investigates do n't miss part three special series fox report^in interview sunday morning futures president slammed democrats imm^voters gathered sunday hear speeches early voting campaign event democrats cincinnati oh^sunday do n't miss former homeland security secretary jeh johnson exclusive interview check yo^people walk past projection old city wall jerusalem sunday oct. commemoration vi^sunday don miss singapore ahead president historic meeting north^despair hope america fox news investigates do n't miss part one special series fox report^an new season 'objectified premieres sunday nba legend tune fox news channel^president holds granddaughter arabella hand walk across south lawn the^ahead trump putin summit miss powerful helsinki check local listings and^sunday go inside home tv legend alex trebek p et fox news channel^don miss fox report jon scott saturdays p et sundays p et fox news channel^a supporter beto o'rourke holds sign rally pan american neighborhood park austin tx on^sunday do n't miss exclusive interview check local listings tune fox ne^an new season 'objectified premieres sunday nba legend tune fox news channel^sunday do n't miss u.s ambassador nato check local listings tune in^objectified back iconic rock stars reality tv mavericks biggest names world share th^on sunday morning futures mike pence talked plans travel hawaii next week receive rem^on sunday morning futures former reagan bush campaign manager ed rollins offered great pra^a huge trump banner unfurled new york game sunday fans president^former president waves supporters sunday gary indiana rallied democrats behalf o^sunday live singapore ahead president historic summit north korean lea^sunday do n't miss three days moscow hosted looks end cold war pres^on sunday morning futures shared thoughts u.s. north korean relations^in exclusive interview says would probably ask supreme^hosted halloween event white house sunday evening the south lawn filled tric^sunday do n't miss exclusive interview check local listings tune in^president holds granddaughter arabella hand walk across south lawn the^central american migrants pack back trailer truck begin morning trek part thous^in interview sunday morning futures president talked dnc s^in exclusive interview says 're phase tax cuts^huckabee 'morning joe attacks trump are 'mosquito bite should be ignored^huckabee 'morning joe attacks trump are 'mosquito bite should be ignored^huckabee 'morning joe attacks trump are 'mosquito bite should be ignored^joemanchin says regrets support could back president^watch live president speaks rally gop congressional candidate moon townsh^president hold rally outside pittsburgh rally support gop congressional candidate^president pushed tough stance immigration campaign rally nevada for^politics poll bush congressional job ratings hit historic lows^tonight p et fmr president george w. bush amp join exclusive sit interview^soon briefing dailybriefing^during press briefing monday sarah sanders slammed democrats coming tab^sarah sanders holds press briefing^during press briefing monday sarah sanders slammed democrats coming tab^watch sarah sanders holds press briefing^awaiting press briefing^sarah sanders holds press briefing^sarah sanders holds briefing^during briefing tuesday sarah sanders stated president worked increasing^during briefing tuesday sarah sanders stated president worked increasing^world transcript joran van der sloot 'on record interview fallout^politics transcript rush limbaugh 'on record^kate middleton prince william leave hospital welcoming baby boy^kate middleton proudly held new bundle joy prince william left hospital welcoming bab^how brad pitt angelina jolie divide 400 million fortune via^how church scientology seemingly protected danny masterson amid rape allegations^meghanmarkle criticized inappropriate shoulder dress queen birthday parade^prince harry patron charity wellchild meghan duchess sussex meet four year old mothe^prince harry meghan markle reportedly postponing royal honeymoon^fox life john mayer jennifer aniston reportedly back together^las vegas shooting celebrities react massacre jason aldean concert^kanye west returns twitter video mind control^meghan markle media hungry half sister turning storybook wedding grimm fairy tale via^jamie foxx walks espn interview katie holmes relationship questions^tom petty dead musicians celebrities react^caitlyn jenner confirms underwent 'final surgery gender reassignment^meghan markle arrives wedding ceremony marry britain prince harry duke sussex st george chap^prince harry elains meghan markle royal wedding bouquet got 'kind ruined^actor dennis quaid says really really nervous playing former president ronald reagan upcoming b^prince harry asks big brother prince william best man wedding meghan markle^after opening monologue sprinkled anti gop political jabs returning host oscars jimmy kimmel comme^olivia munn recreates meghan markle old buckingham palace 'tourist photos^remove cosmopolitan magazine checkout lines^'superman star margot kidder dead^'house cards producers may kill kevin spacey frank underwood sexual allegations report^'fixer upper stars chip joanna gaines welcome baby no^'fixer upper stars chip joanna gaines welcome baby no^'wicked tuna star nicholas 'duffy fudge dead^'big bang theory star kaley cuoco marries karl cook horse themed ceremony^'nypd blue 'la law 'hill street blues creator steven bochco dead^'nypd blue 'la law 'hill street blues creator steven bochco dead^billy bush wife sydney davis files divorce nearly years marriage report^billy bush wife sydney davis files divorce nearly years marriage report^princess eugenie jack brooksbank royal wedding everything need know^wwe star vader dead^weinstein company file bankruptcy following sale talk collapse^harvey weinstein georgina chapman reach settlement divorce^bill cosby trial judge declares mistrial sexual assault case jury deadlock^judge declares mistrial bill cosby sexual assault case^bill cosby trial judge declares mistrial sexual assault case jury deadlock^jennifer garner ben affleck officially file divorce via",25,378,353,403,0.0620347394540943,0.8759305210918115,0
20012204,usweekly,1177,2181224,11975,188328,0,0,203,181,your trusted source latest celebrity news photos videos,pics every time justin theroux gushed jennifer aniston instagram^hollywood producer joel silver sued assistant death jenniferaniston justin theroux honeymoon^twitter heartbroken jennifer aniston justin theroux split^movie producer joel silver sued assistant death jenniferaniston justin theroux honeymoon^exclusive george clooney joked twins got drunk celebrating st birthday amal gushed^exclusive george clooney showed jon rudnitsky photos twins alexander ella^exclusive find tilda swinton thought funny george clooney twins^kendalljenner responds speculation pregnant funniest relatable way possible^see kendall jenner photo sparked speculation pregnant^kendall jenner responds speculation pregnant^john mayer hospitalized emergency appendectomy^angelina jolie says getting married brad pitt casual^jennifer lawrence said amy schumer told going 'die alone split darren aronofsky^yep britney spears still crushing brad pitt^watch busy philipps lindsay lohan dothelilo viral dance challenge^pregnant jessica simpson shows baby bump airport^shows growing baby bump colorful dress^jessica simpson shows growing baby bump airport^pregnant jessica simpson showed baby bump sweet photo^it almost time see pic jessica simpson patting baby bump looking ready pop^chris pratt files divorce anna faris get details^a timeline katie holmes jamie foxx relationship^will jennifer lopez ben affleck get back together jlo bff leah remini says ...^a timeline miley cyrus liam hemsworth relationship^chris brown soulja boy got feud karrueche tran^chris brown soulja boy feud karrueche tran^miley cyrus impressed fianc liam hemsworth latest prank^is kim kardashian irritated called kim kardashian west^a timeline prince harry meghan markle relationship^angelina jolie it strange i never wanted baby^from courteney cox alexander skarsgard kylie jenner best celebrity music video cameos ever^ed sheeran rumored wife cherry seaborn hung courteney cox sparking wedding rumors earlier w^from courteney cox alexander skarsgard kylie jenner best celebrity music video cameos ever^blake shelton says gwen stefani back split miranda lambert^gwen stefani says blake shelton uneected gift split gavin rossdale^exclusive stephanie shepherd said would freaking rumored feud kim kardashian true^comedian hannibal buress arrested disorderly intoxication miami^fergie grins looks carefree without wedding ring brazil one day announcing split josh duhamel^relive fergie josh duhamel sweetest moments son axl split^exclusive inside fergie josh duhamel split^liam payne said announcing split cheryl cole weeks later felt like breaking twice^hear harry meghan markle revealed recent interview becoming mom bucket list^meghan markle revealed recent interview becoming mom bucket list^kyliejenner travisscott timeline relationship^kylie jenner travis scott a timeline relationship^lamar odom breaks silence everything fault^justin bieber complete dating history kourtney kardashian selena gomez hailey baldwin^justin bieber complete dating history kourtney kardashian selena gomez hailey baldwin^justin bieber complete dating history kourtney kardashian selena gomez hailey baldwin^justin bieber complete dating history kourtney kardashian selena gomez hailey baldwin^justin bieber complete dating history selena gomez hailey baldwin^justin bieber complete dating history^justin bieber complete dating history kourtney kardashian selena gomez hailey baldwin^from selena gomez sofia richie justin bieber complete dating history^jennifer aniston hailey baldwin kim kardashian celebs best beach bodies^exclusive gwen stefani blake shelton put baby wedding plans hold^watch heidi klum get glammed agt mesmerizing time lapse video^katy perry made best joke false ryan phillippe dating rumors^katie couric said matt lauer today show firing really crushing^teresa giudice opens dinner divorce lawyer^kim kardashian concierge blaming h tel de pourtal s lack security reality star paris robbery^ben affleck eemed tense meeting jennifer garner romance went public^has chris martin dumped jennifer lawrence kate hudson^exclusive inside julia roberts danny moder really solid loving marriage^from courteney cox alexander skarsgard kylie jenner best celebrity music video cameos ever^ed sheeran rumored wife cherry seaborn hung courteney cox sparking wedding rumors earlier w^exclusive inside julia roberts danny moder really solid loving marriage^katie holmes jamie foxx a timeline relationship^president donald trump first lady melania keep separate bedrooms they never spend night together^president donald trump first lady melania keep separate bedrooms^'keeping up with kardashians recap kris jenner reveals cheated boyfriend robert kardash^exclusive gwen stefani blake shelton put baby wedding plans hold^exclusive tom cruise reportedly n't seen daughter suri three years details^tom cruise reportedly n't seen daughter suri three years exclusive details^hailee steinfeld denies justin bieber dating rumors we been friends years^see cindy crawford jenna dewan zendaya stars without makeup^see cindy crawford jenna dewan zendaya stars without makeup^exclusive justin bieber focused marriage amid ex selena gomez medical issues^see cindy crawford jenna dewan zendaya stars without makeup^see cindy crawford jenna dewan zendaya stars without makeup^a look back carrie underwood mike fisher romance^lady gaga taylor kinney reportedly split five years together^happy birthday pretty woman julia roberts^is kylie jenner labor fans convinced^exclusive brad pitt committed making time children ex wife angelina jolie^hailey baldwin took twitter deny already married justin bieber^celebrity mugshots see chris brown heather locklear vince vaughn stars 've behind bars^nicole kidman donald trump we country need support whoever president^jennifer lopez hired private investigator tail alex rodriguez^'keeping up with kardashians recap kris jenner reveals cheated boyfriend robert kardash^drake bella hadid 'hooking source confirms us^drake bella hadid hooking^drake bella hadid 'hooking source confirms us weekly^kim kardashian shuts cocaine claim i play rumors like^kim kardashian said kids left kanye west feeling neglected^angelina jolie single dating real estate agent despite reports saying otherwise^exclusive a source tells us brad pitt absolutely smitten new love mit professor neri oxman^madonna faced uncomfortable questions judge adoption twin girls malawi^exclusive justin theroux 'reservations marrying jennifer aniston^ozzy osbourne sharon osbourne reportedly split years marriage^grammys see complete list winners nominees^grammys complete list winners nominees^pregnant khloe kardashian said baby wo n't mend relationship caitlyn jenner^hailee steinfeld denies justin bieber dating rumors we been friends years^exclusive jennifer garner pleased ben affleck dating young playboy model surpr^exclusive today show anchors including savannah guthrie hoda kotb left reeling megyn kelly^pregnant jessica simpson shows baby bump airport^jessica simpson shows growing baby bump airport^pregnant jessica simpson showed baby bump sweet photo^kim kardashian admitted new interview aware kanye west suffering anxiety pa^exclusive gwen stefani blake shelton put baby wedding plans hold^the weeknd said upbeat beautiful album turned melancholy split selena gomez^rhoa alum claudia jordan confirms pal jamie foxx katie holmes dating^exclusive linda thompson said brody jenner disappointed caitlyn jenner n't attend wedding last^brody jenner thanked attended wedding kaitlynn carter^exclusive kristen cavallari dished reason n't get brody jenner wedding gift^i n't enjoy single angelinajolie says new interview^exclusive younes bendjima still bitter breakup kourtney kardashian^charlie hunnam robert pattinson barely spoke 'the lost city z set^exclusive dakota johnson chris martin definitely dating get details^dakota johnson chris martin dating^shots rang set tekashi ix9ine kanye west nicki minaj new music video^see katy perry reacted taylor swift fan americanidol^this matt lauer texted hoda kotb replaced today show^kourtney kardashian younes bendjima sexy romance pictures^kourtney kardashian younes bendjima sexy romance pictures^kourtney kardashian younes bendjima sexy romance pictures^kourtney kardashian younes bendjima sexy romance pictures^kourtney kardashian younes bendjima sexy romance pictures^kourtney kardashian younes bendjima sexy romance pictures^kourtney kardashian younes bendjima sexy romance pictures^kourtney kardashian younes bendjima sexy romance pictures^kyliejenner travisscott timeline relationship^kylie jenner travis scott a timeline relationship^julia roberts shared rare photo embracing husband danny moder^breaking christina aguilera engaged she said yes boyfriend matt rutler^it get ugly ... get exclusive details angelina jolie brad pitt divorce war^angelina jolie asks brad pitt miscellaneous jewelry details divorce filing^al franken accused groping radio host leeann tweeden without consent slept^george clooney shows pics twins jokes 're like models^exclusive kourtney kardashian zero interest getting back together scott disick^oh lord kuwtk star scott disick jokes getting back together kourtney kardashian watch^julia roberts shared rare photo embracing husband danny moder^exclusive find bachelorinparadise ashley iaconetti getting wedding shape^kendall jenner breaks tears camera feels ignored family^everything know far khloe kardashian tristan thompson cheating scandal^anmer hall may need another nursery exclusive details duke amp duchess baby plans^emma stone gushes costar ryan gosling^it get ugly ... get exclusive details angelina jolie brad pitt divorce war^angelina jolie asks brad pitt miscellaneous jewelry details divorce filing^angelina jolie ca n't see past anger toward brad pitt amid custody battle^exclusive brad pitt sees kids every day amid custody battle angelina jolie^exclusive brad pitt angelina jolie truce custody battle^exclusive the custody battle brad pitt angelina jolie far^here everything know far brad pitt angelina jolie ongoing custody battle^everything know far brad pitt angelina jolie custody battle^find jennifer lopez devastated split marc anthony^khloe kardashian says excited future tristan thompson kuwtk teaser^exclusive taylor swift preparing 'come hiding joe alwyn side^khlo kardashian hold back twitter tristan thompson cheating scandal played kuwtk^khloe kardashian said cheating episode kuwtk would bring feels^'kuwtk recap khloe kardashian family find tristan thompson cheating^exclusive tristan thompson gave khlo kardashian firm asked whether wanted watch cheatin^ciara russell wilson welcome daughter sienna princess^david beckham stopped health food store buy single carrot wife victoria beckham^brad pitt i 'm miserable b tard i 'm bit loner know^exclusive david victoria beckham lead different lives works^he taking opening restaurants calling kanye west food^justin bieber complete dating history kourtney kardashian selena gomez hailey baldwin^justin bieber complete dating history kourtney kardashian selena gomez hailey baldwin^justin bieber complete dating history kourtney kardashian selena gomez hailey baldwin^justin bieber complete dating history kourtney kardashian selena gomez hailey baldwin^justin bieber complete dating history selena gomez hailey baldwin^justin bieber complete dating history^justin bieber complete dating history kourtney kardashian selena gomez hailey baldwin^from selena gomez sofia richie justin bieber complete dating history^kylie jenner travis scott a timeline relationship^ben affleck lindsay shookus timeline relationship^john cena nikki bella timeline relationship^justin bieber hailey baldwin relive romance timeline relationship^justin bieber hailey baldwin engaged check timeline relationship^vanessa trump donald trump jr divorce timeline relationship^ben affleck girlfriend lindsay shookus timeline relationship^relive everything will smith jada pinkett smith said marriage^relive everything will smith jada pinkett smith said marriage^relive everything will smith jada pinkett smith said marriage^exclusive ashlee simpson told us plan returning reality tv years finale the^exclusive gwen stefani blake shelton put baby wedding plans hold^see katy perry reacted taylor swift fan americanidol^exclusive find qvc workout tool heidi klum uses every day keep body bikini ready^life fair check heidi klum noshing french fries flaunts amazing bikini body^exclusive gwen stefani blake shelton put baby wedding plans hold^charlie hunnam robert pattinson barely spoke 'the lost city z set^exclusive brad pitt completely devastated angelina jolie surprise divorce filing.^devastated angelina jolie everything power protect family brad pitt divorce^jealous ethan hawke angelina jolie christmas card list^katie holmes jamie foxx a timeline relationship^sandra bullock married boyfriend bryan randall^exclusive celeb moms like julie bowen ellen pompeo reveal want mother day^exclusive watch julie bowen hilariously dissect evolution mom jeans^exclusive jennifer garner n't want kids around ben affleck girlfriend lindsay shookus^angelina jolie single dating real estate agent despite reports saying otherwise^exclusive jennifer garner n't want kids around ben affleck girlfriend lindsay shookus^exclusive ronnie ortiz magro ex jen harley driving erratically three flat tires arr^chicagofire star dushon monique brown cause death revealed^ryan reynolds reveals saved nephew life^'pretty little liars star sasha pieterse marries hudson sheaffer ireland^pretty little liars sasha pieterse marries hudson sheaffer ireland^prince harry meghan markle photographed arriving pippa middleton wedding reception^kelsea ballerini marries fiance morgan evans mexico^singer kelsea ballerini marries fiance morgan evans mexico^congrats wizards waverly place star david henrie got married longtime girlfriend maria cahill^wizards waverly place star david henrie got married longtime girlfriend maria cahill^amy schumer revealed hospitalized horrible kidney infection^a second suspect arrested murder xxxtentacion^mark salling autopsy revealed cause death^mtv movie amp tv awards full list nominees^strangerthings earns mtv movie amp tv award nominations see full list nominees^'this is us star justin hartley marries chrishell stause romantic ceremony^orange is new black laura prepon ben foster married^david schwimmer wife zoe buckman taking ome time apart six years marriage^star jones marries ricardo lugo cruise ship bahamas^kate upton details sexual misconduct allegations guess cofounder paul marciano^nick cannon reveals diva thing ever seen mariah carey^ed sheeran says beyonce changes email address every week^ed sheeran says beyonce changes email address every week^luann de lesseps accuses russell simmons groping years ago^linkin park singer chester bennington cause death revealed^'wags miami stars ashley nicole roberts philip wheeler wed curacao details^'wags miami stars ashley nicole roberts philip wheeler married^outlander star caitriona balfe engaged tony mcgill^former nfl quarterback troy aikman engaged capa mooty^things know pippa middleton fiance james matthews^teen mom og ryan edwards mackenzie standifer get married^kylie jenner surprises high school students junior prom^watch kylie jenner surprise sacramento high school students junior prom^kelly rowland wants second boob job nipples size frisbees^blake lively injured set new action movie the rhythm section production temporarily halted^lea michele engaged zandy reich see massive ring^lea michele engaged zandy reich see huge ring^youtube star austin jones arrested child pornography charges^khloekardashian makes first public appearance since pregnancy news photos^khloekardashian makes first public appearance since pregnancy news photos^ashton kutcher pays emotional tribute mila kunis kids iowa award speech^naya rivera refiles divorce husband ryan dorsey domestic battery arrest^meghan markle arrives london pippa middleton wedding^'the view alum jedediah bila marries jeremy scher romantic ceremony see dress^katy perry becomes first person reach million twitter followers^katy perry becomes first person reach million twitter followers^new couple alert lucy hale dating life sentence costar riley smith^jesus christ superstar announced nbc next live musical details^tim mcgraw collapses onstage concert ireland faith hill addresses crowd^a second suspect arrested murder xxxtentacion^emma stone responds arizona teen viral la la land inspired promposal^justin bieber cancels remaining purpose world tour dates^jim carrey fighting get late girlfriend cathriona white mother wrongful death lawsuit dismissed^ariana grande new tattoo dedicated pete davidson firefighter dad died /11^tiger woods breaks silence arrest suspicion dui^icarly nathan kress wife london welcome first child^joanna krupa romain zago split after less than four years marriage^hugh grant eecting fifth child girlfriend anna eberstein^jayz reveals beyonc named twins rumi sir^avicii funeral private according new statement family^sag awards see complete list nominees winners^these celebrity couples prove love dead^these celebrity couples prove love n't dead^love n't dead promise these celebrity couples prove love flourish hollywood^celebrity couples prove love n't dead brangelina^celebrity couples prove love n't dead^transparent costars bradley whitford amy landecker engaged^nelly criminal investigation england alleged sexual assault^rhoa kenya moore eecting first child husband marc daly^find kim kardashian dyed hair pink^celebs mourn happy days star erin moran found dead age^happy days star erin moran found dead indiana home saturday she^james van der beek wife kimberly welcome baby pics^james van der beek wife kimberly welcome baby see sweet pics^jazz jennings great gender confirmation surgery^fixer upper joanna chip gaines welcome baby^'fixer upper stars joanna chip gaines welcome baby^superstore actress america ferrera pregnant first child see announcement^elle king skipped wedding andrew fergie ferguson find^elle king reveals skipped wedding^a french official confirmed anthony bourdain narcotics body time death^tyrese gibson wife samantha eecting baby girl^chris cornell ended final performance song death watch^chrissy teigen gives birth baby john legend^val kilmer confirms cancer battle 'i healing^val kilmer confirms cancer battle previous denials 'i healing^kim cattrall brother found dead reported missing^kim cattrall brother found dead hours asked help reported missing^surprise mindy kaling reportedly pregnant first child^get details thebachelorette rachel lindsay engagement ring^summer movie preview 'wonder woman 'baywatch 'spider man^'real housewives new jersey star danielle staub marries marty caffrey bahamas get details^keaton jones n't returned school since bullying video went viral^'teen mom og star ryan edwards reportedly checked rehab following substance abuse allegations^naomi watts ex liev schreiber reunite celebrate son birthday^prince harry secretly visits meghan markle toronto ahead easter^bet awards see complete winners list^bet awards see complete winners nominees list^broke girls beth behrs celebrates bridal shower friends including kat dennings^broke girls beth behrs celebrates bridal shower friends including kat dennings pics^broke girls beth behrs celebrates bridal shower friends including kat dennings christina hendricks pics^larry nassar sentenced another years prison sexual abuse^blac chyna granted temporary restraining order rob kardashian^long island medium theresa caputo husband larry split details^long island medium theresa caputo husband larry split^long island medium theresa caputo husband larry split read statement^'bachelor paradise stars jade roper tanner tolbert reveal newborn daughter name^jimmy kimmel pranks pal justin theroux jennifer aniston help watch^anna wintour daughter bee shaffer married francesco carrozzini colin firth officiated^anna wintour daughter bee shaffer engaged francesco carrozzini^'game thrones stars kit harington rose leslie wedding date revealed^baby bliss find jason aldean brittany kerr eecting boy girl^will smith talks play genie disney 'aladdin live action reboot^exclusive queereye tom jackson abby parr got married second time private ceremony^eddie redmayne wife hannah bagshawe welcome baby^eddie redmayne wife hannah welcome baby^'bachelor paradise stars carly waddell evan bass reveal baby girl name^'bachelor paradise stars carly waddell evan bass reveal baby name^'clueless alum stacey dash running congress california^'arrow star katie cassidy engaged matthew rodgers see ring^kathy bates hints sarah paulson might play princess diana feud season^jennifer lawrence darren aronofsky split one year dating^jennifer lawrence darren aronofsky split^mila kunis revealed makes monthly donations planned parenthood mike pence name^u.s. figure skater ashley wagner 'furious making winter olympics team^figure skater ashley wagner 'furious making winter olympics team^katy perry 'darling orlando bloom meet pope francis pics^katy perry 'darling orlando bloom meet pope francis vatican pics^shailene woodley stop kissing nz rugby player ben volavola pics^cue ca n't keep hands lyrics selena gomez the weeknd pack pda coachella^jersey shore ronnie ortiz magro celebrates upcoming arrival first child beautiful baby shower t^serena williams fiance alexis ohanian are 'waiting learn sex baby^prince harry meghan markle photographed arriving pippa middleton wedding reception^is scarlett johansson hooking snl colin jost^seth meyers wife alexi ashe eecting baby^michelle williams engaged andrew youmans^exclusive michelle williams engaged boyfriend andrew youmans^kim kardashian attends year high school reunion pics^kim kardashian attends year high school reunion see pics^melissa etheridge admits smokes weed kids 'it brings much closer^tori spelling celebrates th anniversary with dean mcdermott 'you are hottest soccer dad i know'^jamie lynn spears pregnant eecting second child first husband jamie watson^eliza dushku engaged boyfriend peter palandjian photo^katharine mcphee david foster engaged^catfish nev schulman marries laura perlongo^niall horan liam payne one direction reunion indiana concert^olympian tom daley dustin lance black eecting first child^khloe kardashian says thinks getting nose job 'every day^american idol lauren alaina engaged alex hopkins details^ryan murphy reveals first look cory monteith glee tribute episode^cory monteith glee tribute episode getting close ryan murphy released first look episode^missusa things know miss district columbia kara mccullough^icymi mary kay letourneau former student vili fualaau separate years marriage^penn badgley domino kirke get married second ceremony photos^brad pitt spoken jennifer aniston since news broke split justin theroux yet least e^exclusive jennifer aniston justin theroux barely spoken since split^a night justin theroux appeared good spirits first public event since split jennifer^jennifer aniston spotted first time since announcing split justin theroux^justin theroux stepped new york city first time since news split jennifer aniston broke^brandy hospitalized losing consciousness plane^all details prince harry duchess meghan wedding cake revealed^find details prince harry meghan markle wedding cake^jason aldean wife brittany kerr are eecting first child together see cute announcement^richard simmons hospitalized severe indigestion^michael phelps wife nicole johnson welcome baby see sweet pic^khloe kardashian i ready marry tristan thompson^grey anatomy spin involving firefighters coming abc^'the good wife actor josh charles wife sophie flack eecting baby^the good wife josh charles wife sophie flack eecting baby^mobb deep rapper prodigy cause death revealed^leslie jones accuses l.a. ritz carlton racism they n't like black people^'star wars the last jedi dedicated 'our princess carrie fisher^oscars see complete nominees winners list^oscars see complete winners list^tommy lee engaged former vine star brittany furlan^is strangerthings actor david harbour dating alison sudol^get details prince harry meghan markle wedding rings^congrats james van der beek wife kimberly pregnant couple third child^chris pratt files divorce anna faris get details^pauley perrette leaving ncis seasons read statement^april giraffe pregnant,203,181,-22,384,0.5286458333333334,-0.05729166666666665,1
21246105,HollywoodLife,4407,335776,2163,186740,0,0,353,29,get hottest news hottest stars hollywoodlife instagram,selena gomez saddened mom criticism justin bieber^uh oh selena gomez the weekend first fight^uh oh selena gomez the weekend first fight^selena gomez amp the weeknd first big fight^tyga will dump kylie jenner if kris demands to see his finances^kris jenner wants kylie jenner dump tyga amp date zayn malik^kris jenner wants selena gomez to get kylie to dump tyga^kris jenner told kylie dump tyga allegedly slept w/ same girl charlie sheen^kris jenner wants kylie jenner dump tyga amp date zayn malik^breaking selena gomez pregnant the weeknd baby amp racing marry report^breaking selena gomez pregnant the weeknd baby amp racing marry report^is selena gomez amp the weeknd relationship trouble already^is selena gomez amp the weeknd relationship trouble already^how brad pitt feel jennifer aniston getting married justin theroux^how brad pitt feel jennifer aniston getting married justin theroux^justin bieber so proud selena gomez epic amas performance^katie holmes lunch scott eastwood jamie foxx split rumors swirl^it official blake shelton head heels gwen stefani three little boys^is brad pitt crushing year old cutie^did angelina jolie fire nanny crushing brad pitt^khloe kardashian admits she crushing brad pitt will they date^angelina jolie crushing mystery man since brad pitt split^kristen stewart threw mad shade donald trump hair hilarious^kristen stewart threw mad shade donald trump hair hilarious^kristen stewart happier w/ gf alicia cargile man shade rob pattinson^is katie holmes pregnant jamie foxx baby^aww jessica simpson baby bump cutest^gwen stefani amp blake shelton baby way plan christmas wedding report^breaking gwen stefani amp blake shelton baby way plan christmas wedding report^are brad pitt jennifer lawrence dating^apparently kylie jenner travis scott super sexy world series bet ...^angelina jolie keeping tabs on brad pitt scared she lose hold over him^are ben affleck amp jennifer lopez getting back together bff leah remini spills dirt^are ben affleck amp jennifer lopez getting back together bff leah remini spills dirt^kanye west reveals still texts caitlyn jenner amidst feud kardashians^jennifer aniston pregnant miracle baby report^justin bieber upset selena gomez refused to see him after the met gala^brad pitt nearly shelled small fortune watch episode game thrones emilia clarke^liam hemsworth sure knows make scream^miley cyrus sooooo liam hemsworth pranks^angelina jolie amp brad pitt divorce papers get first look legal documents^breaking angelina jolie amp brad pitt divorce papers get first look legal documents^brad pitt apologizes jennifer aniston regret leaving angelina jolie^blake shelton vowed father figure gwen stefani boys even split^gwen stefani says blake shelton saved devastating split gavin rossdale^gwen stefani says blake shelton saved devastating split gavin rossdale^wow jennifer aniston forgives brad pitt angelina jolie cheating^the real reason justin bieber commit selena gomez kourtney kardashian^the real reason justin bieber amp selena gomez released romantic duet strong^the real reason justin bieber amp selena gomez released romantic duet strong^what real reason justin bieber wo n't marry selena gomez^awww real reason justin bieber always loves selena gomez^here real reason justin bieber selena gomez break^the real reason justin bieber attacked selena gomez instagram^justin bieber amp selena gomez the real reason he won invite her to mayweather fight^the real reason justin bieber attacked selena gomez instagram^miley cyrus liam hemsworth relationship stronger ever may never get married^miley cyrus sooooo liam hemsworth pranks^fergie josh duhamel reportedly trying second baby one year split^meghan markle looked happy partaking first solo charity project royal^aw prince harry so happy father able step meghan markle her dad could n't ma^meghan markle happy sis^sofia richie wants engagement ring scott disick birthday^did sofia richie get breast augmentation^sofia richie wants diamond ring birthday^happy birthday^mila kunis thrilled ex macaulay culkin looks happy amp healthy rough patch^hmmm rihanna unfinished business drake^blake shelton amp gwen stefani planning backyard wedding end^did justin bieber confirm relationship selena gomez good watch^are blake shelton amp gwen stefani secretly married^did miley cyrus liam hemsworth call wedding^editor chief thinks miley cyrus amp liam hemsworth smart call wedding do^has liam hemsworth amp miley cyrus wedding called^is us angelina totally channeling jennifer aniston last night either way love sexy slit showdown^jennifer aniston vs. justin bieber harem pants showdown who wore best^ben affleck jennifer garner definition tense new pics taken groping scandal^ben affleck jennifer garner definition tense new pics taken groping scandal^chris soules breaks silence on fatal accident i overwhelmed with this tragedy^did liam hemsworth miley cyrus secretly get married^did miley cyrus liam hemsworth secretly get married chris hemsworth spilling tea^brad pitt cute would hard not crush does margot robbie feel way^secret baby news nicole kidman and keith urban welcomed a baby girl via a surrogate who knew^nick jonas dating victoria secret model sara sampaio dating he was all over her^kylie jenner pregnant already^kylie jenner pregnant already^kylie jenner pregnant already^brad pitt looking to buy new place in la arts district amid angelina jolie romance rumors^kylie jenner reacts rumors jealous kendall jenner^selena gomez fears coachella run in with bella hadid wants the weeknd to protect her^selena gomez fears she be single forever after justin bieber relationship^paige thomas i was terrified singing britney spears breakup song via^britney spears falls floor terrified kids epic scary prank watch^brad pitt he had a blast playing with kids during secret cambodian family reunion^are brad pitt jennifer lawrence dating^check selena gomez natural beauty beach vogue shoot^check selena gomez natural beauty beach vogue shoot^justin bieber believes selena gomez one^does justin bieber still think selena gomez one^miley cyrus pregnant liam hemsworth baby report^miley cyrus pregnant liam hemsworth baby report^scott disick furious kourtney kardashian 'classless pda younes bendjima^fka twigs turns kristen stewart love advice rob pattinson^blake shelton pissed gwen stefani breakup rumors^blake shelton pissed gwen stefani breakup rumors^iggy azeala warning to khloe kardashian tristan thompson will cheat on you^kylie jenner pregnant travis scott baby or^justin bieber amp hailey baldwin step amid reports marriage took toll selena gomez^justin bieber amp selena gomez rekindled romance ended 'could n't promise marriage^selena gomez like rest world shook justin bieber hailey baldwin marriage news^selena gomez amp the weeknd might already thinking marriage^brad pitt angelina jolie fighting ...^maddox reportedly shocking videos brad pitt angelina jolie fighting^gwen stefani loves blake shelton gushes thevoice social media^kourtney kardashian kinda jealous justin hailey tbh^brad pitt apologizes jennifer aniston regret leaving angelina jolie^are brad pitt jennifer lawrence dating^sofia richie wants engagement ring scott disick birthday^did sofia richie get breast augmentation^sofia richie wants diamond ring birthday^happy birthday^kendall jenner reacts 'baby bump photo^kim kardashian dressed baby bump kendall jenner birthday^kendall jenner flaunts huge baby bump watch^kendall jenner makes cute pregnant woman see baby bump kim b day party^kendall jenner flaunts huge baby bump watch^kendall jenner flaunts huge baby bump watch^kendall jenner makes cute pregnant woman see baby bump kim b day party^yep kylie jenner heard nicki minaj wants sock travis scott face^tyga will dump kylie jenner if kris demands to see his finances^kris jenner wants kylie jenner dump tyga amp date zayn malik^kris jenner wants selena gomez to get kylie to dump tyga^kris jenner told kylie dump tyga allegedly slept w/ same girl charlie sheen^kris jenner wants kylie jenner dump tyga amp date zayn malik^jimmy fallon caught bts everything btsonfallon^caitlyn jenner reportedly begging khloe kardashian end feud amid tristan thompson cheating scandal^kim kardashian getting tips on hiding her baby bump from beyonce^no bad blood ian somerhalder wife nikki reed ex nina dobrev hung goldenglobes par^jennifer aniston amp justin theroux war brad pitt amp^are rihanna amp drake hooking london^are rihanna amp drake hooking london^are rihanna amp drake hooking london^are rihanna amp drake hooking london^are taylor swift amp drake hooking^are rihanna amp drake hooking london^kylie jenner heartbroken travis scott care free attitude pregnancy^baylee curran says shock terrified chris brown shocking interview^find karrueche tran terrified chris brown snap^karrueche tran absolutely terrified chris brown amp ready take court^chris brown spending days anger management rehab reportedly terrified going jail^chris brown terrified 'll sent back jail^chris brown so terrified by naked intruder he had to sleep with tv on all night^chris brown terrified 'll sent back jail^chris brown so terrified by naked intruder he had to sleep with tv on all night^are robert pattinson kristen stewart getting back together robsten^awww angelina jolie still misses brad pitt^is angelina jolie rethinking brad pitt divorce she misses^is angelina jolie rethinking brad pitt divorce she misses^is angelina jolie rethinking brad pitt divorce she misses^angelina jolie misses brad pitt spending months apart^kylie jenner devastated wo n't spend nye travis scott kim kardashian swooping help^tyga devastated kylie jenner amp travis scott flirt storm^kylie jenner devastated wo n't spend nye travis scott kim kardashian swooping help^justin theroux reveals secret making marriage jennifer aniston last amid brangelina nasty split^miranda lambert getting revenge blake shelton hot body^miranda lambert getting serious revenge divorce blake shelton^is miranda lambert new romance revenge blake shelton^is kim kardashian jealous kourtney body^kim kardashian super jealous kourtney bikini body^family drama kim kardashian jealous sister kourtney find^miley cyrus admits loves reading fifty shades of grey is prepping honeymoon liam hemsworth^liam hemsworth amp miley cyrus month long honeymoon dreams^jennifer lopez ca n't stop smiling talking new boyfriend alex rodriguez watch^selena gomez amp justin bieber planning taylor swift double date jelena reputation^we 're green envy kim kardashian bikini body^kim kardashian getting antsy for third baby to arrive^lamar odom revealed much really betrayed ... amp makes us respect million times^lamar odom revealed much really betrayed ... amp makes us respect million times^hailee steinfeld reveals dating justin bieber^hailee steinfeld reacts justin bieber dating rumors^hailee steinfeld totally shut rumors dating justin bieber^is jenniferaniston finally pregnant reports say eecting baby girl pics^is jennifer aniston finally pregnant check huge baby bump^jennifer aniston reportedly trying get pregnant boyfriend justin theroux finally^taylor swift slams kim kardashian bully makes katy perry all one night busy girl.^angelina jolie terrified brad pitt will start dating again she very jealous^angelina jolie terrified brad pitt will start dating again she very jealous^so kim kardashian upset whole i wan na bang sisters thing^nina dobrev amp orlando bloom are more than friends is he already over katy perry^nina dobrev amp orlando bloom are more than friends is he already over katy perry^is robert pattinson getting cold feet marrying fka twigs kristen stewart^robert pattinson amp fka twigs cuddle close at metgala in front of ex kristen stewart^angelina jolie went braless day kids amidst brad pitt drama^angelina jolie goes braless meet archbishop canterbury totes inappropes^kendall jenner looking flirty fun nyfw outfit^who wore flirty lbd parisfashionweek better bella hadid kendall jenner^jennifer aniston amp justin theroux war brad pitt amp^aww jessica simpson baby bump cutest^selena gomez looked super pretty floral dress easter amid split justin bieber and the weeknd drama^the weeknd amp bella hadid reportedly texting amp facetiming time since split selena gomez^are robert pattinson kristen stewart getting back together robsten^this caitlyn jenner going brody wedding^caitlyn jenner ex threw major shade skipping brody jenner wedding^caitlyn jenner got slammed missing brody jenner wedding^kris jenner orders emergency family meeting over rob kardashian crisis^kris jenner orders emergency family meeting over rob kardashian crisis^tom hiddleston 'crushed taylor swift disses reputation^even three years breakup kourtney kardashian special place heart scott disick^kourtney kardashian breakup younes bendjima easy^jennifer aniston encouraging selena gomez to follow her heart in the weeknd romance^oh kylie jenner confesses hair destroyed bleaching^oh kylie jenner confesses hair destroyed bleaching^oh kylie jenner confesses hair destroyed bleaching^oh kylie jenner confesses hair destroyed bleaching^chelsea handler says 'd never date brad pitt respecting girl code^chelsea handler says 'd never date brad pitt respecting girl code^brad pitt laser focused best dad ever^angelina jolie relieved brad pitt n't talk new romance latest interview^nicki minaj embarrassed meek mill^wow jennifer aniston forgives brad pitt angelina jolie cheating^after suge knight shot chris brown pre vmas party fans freaking terrifying situation^caitlyn jenner desperate mom plans adopt baby boy revealed^tyga furious at kylie jenner for rockets date with travis scott he feels like a chump^kendall jenner reacts 'baby bump photo^kim kardashian dressed baby bump kendall jenner birthday^kendall jenner flaunts huge baby bump watch^kendall jenner makes cute pregnant woman see baby bump kim b day party^kendall jenner flaunts huge baby bump watch^kendall jenner flaunts huge baby bump watch^kendall jenner makes cute pregnant woman see baby bump kim b day party^angelina jolie crushing mystery man since brad pitt split^did kylie jenner photoshop butt 'cause jealous kim kardashian see pic^did kylie jenner photoshop butt 'cause jealous kim kardashian see pic^is kim kardashian jealous kylie jenner^did kylie jenner photoshop butt 'cause jealous kim kardashian see pic^this kim kardashian super jealous kylie jenner^kim kardashian jealous of kylie jenner rising fame why she blames kris^this kim kardashian super jealous kylie jenner^courteney cox urging jennifer aniston reunite brad pitt^omg selena gomez going judge next season^omg selena gomez going judge next season^selena gomez joining taylor swift enemy katy perry american idol^part kylie jenner still misses tyga here ...^tyga misses kylie jenner even baby^tyga misses kylie jenner^kylie jenner wild night out every guy was hitting on her but she misses tyga^kylie jenner says misses tyga downstairs adorable snapchat video^king cairo heartbroken he misses his room in kylie jenner house^aw kylie jenner says misses tyga cute snapchat video watch^kourtney kardashian open getting back together scott disick^does taylor swift low key throw shade calvin harris gorgeous some fans thinks ...^taylor swift disses calvin harris new song 'gorgeous gorgeous reputation^here jennifer lopez amp alex rodriguez romance getting serious fast^there trouble paradise meghan markle prince harry already^there reportedly trouble paradise meghan markle prince harry^kylie jenner heartbroken travis scott care free attitude pregnancy^kylie jenner totally heartbroken travis scott handled pregnancy^is kim kardashian secretly taping kanye west strange behavior^kim kardashian secretly kept outfits for north after kanye west closet purge kuwtk^kendall jenner tears vogue cover see instagram^kendall jenner broke tears pepsi ad controversy last night kuwtk^a ap rocky secret gf tahiry jose tears dumped kendall jenner^breaks tears bruce jenner transition watch^perrie edwards dissing selena gomez 13 reasons why^blake shelton amp gwen stefani planning on having a baby he wants a girl^kendall amp kylie jenner hate being caught in the nasty feud between kris amp caitlyn^kylie jenner feels type way rob amp blac nasty feud^here selena gomez secretly hoping hailey baldwin amp justin bieber never marry^kendall amp kylie jenner hate being caught in the nasty feud between kris amp caitlyn^find caitlyn jenner a wreck kris nasty car accident^khloe kardashian amp tristan thompson reportedly planning 2 million wedding gives birth^are robert pattinson kristen stewart getting back together robsten^are meghan markle amp prince harry moving windsor castle^justin bieber wants major alone time selena gomez th birthday^kylie jenner amp kendall jenner fight latest episode keeping up with the kardashians^kim kardashian freaked kanye west wild rants hurt north amp saint^kim kardashian terrified kanye west endorsing donald trump will hurt their brand^kim kardashian terrified kanye west endorsing donald trump will hurt their brand^miley cyrus gets spanked easter bunny naughty video^anxiously waits announce pregnancy kuwtk preview^blake shelton gwen stefani saved life miranda lambert divorce^brad pitt got spend father day kids long custody battle angelina jolie^brad pitt vs. angelina jolie here breakdown legal battle^brad pitt seeing kids every day amidst custody battle angelina jolie^angelina jolie rush end divorce battle brad pitt^wendy williams team brad pitt actor custody battle angelina jolie^meghan markle excited bff priyanka chopra may getting married^khloe kardashian fans excited new baby ... .and so mad tristan thompson^the latest episode kuwtk made khloe kardashian very uncomfortable^khloe kardashian begged family act normal around tristan thompson following cheating scandal kuwtk^justin bieber amp selena gomez consider soulmates^angelina jolie amp jared leto dating after brad pitt divorce report^kim kardashian begging kanye west apologize jay z amp beyonce^kim kardashian begging kanye take coachella go^is kourtney kardashian pregnant baby make sex scott disick^is kourtney kardashian pregnant baby make sex scott disick^is kourtney kardashian pregnant baby make sex scott disick^kylie jenner ready to spoil tyga rotten with luxury watches amp more extravagant gifts^omarosa rushed hospital white house injury report^kanye west replacing simon cowell judge americanidol reboot will watching^selena gomez still thinking justin bieber^robert pattinson still loves kristen stewart amid reunion rumors does want date^trump renaming black history month years celebration report^khloe kardashian amp tristan thompson splitting up inside their passionate fights^sofia richie wants engagement ring scott disick birthday^did sofia richie get breast augmentation^sofia richie wants diamond ring birthday^happy birthday^jessica simpson pregnant again ... according new report anyway via^sofia richie wants engagement ring scott disick birthday^did sofia richie get breast augmentation^sofia richie wants diamond ring birthday^happy birthday^are brad pitt jennifer lawrence dating^aw prince harry so happy father able step meghan markle her dad could n't ma^here complete timeline entire relationship^kylie jenner crying sleep new delivery room drama^breaking reveals kidney transplant summer^we 're seriously jealous selena gomez friendship jennifer aniston friendshipgoals^kim kardashian storms blowup fight kanye west weight^the mystery man selena gomez hanging actually brother one bffs^brad pitt vs. angelina jolie here breakdown legal battle^kim kardashian terrified kanye west endorsing donald trump will hurt their brand^kim kardashian terrified might face attackers ...^find kim kardashian terrified kanye west yeezy show^kim kardashian terrified kanye west endorsing donald trump will hurt their brand^sofia richie is convinced kourtney kardashian still in love with scott disick^lamar odom pissed khloe kardashian dating tristan thompson^will caitlyn jenner kids call mom dad find^will caitlyn jenner kids call mom dad find^will caitlyn jenner kids call mom dad find^will caitlyn jenner kids call mom dad find^iamcait kendall jenner calls caitlyn mad mom amp dad watch^ben affleck amp jennifer garner renew their vows in intimate ceremony with kids^omg is wedding bells hear sandra bullock amp bryan randall^marion cotillard devastated dragged brad pitt amp angelina jolie divorce^brad pitt devastated spending thanksgiving without kids^as eected world devastated angelina jolie amp brad pitt divorce^kate middleton baby bump looks cute pink dress confirm girl^the flawless amp newly engaged nikki bella star week^justin bieber inspired selena gomez^kim kardashian ignited prank war kylie jenner^kim kardashian amp kylie jenner trying lure rob prank war^kourtney kardashian amp scott disick back together^breaking kourtney kardashian scott disick back together^stop teasing us scott disick amp kourtney kardashian are guys really back together^okay kourtney kardashian amp scott disick actually back together^stop teasing us scott disick amp kourtney kardashian are guys really back together^kourtney kardashian scott disick back together^kourtney kardashian amp scott disick back good terms getting back together^are kourtney kardashian scott disick getting back together again^jennifer aniston everything help selena gomez singer 'emotional breakdown'^bella hadid feels selena gomez emotional breakdown^the reason khloe kardashian misses pregnant so relatable^ummm ... sofia richie scott disick face phone case^mark salling official cause death revealed^breaking miles teller reportedly arrested drunk public amp cooperating police^'outlander caitriona balfe engaged^who pippa middleton fiance things know james matthews^a suspect xxxtentacion murder arrested^chris brown reportedly investigation pet monkey amp could potentially face jail time^lady antebellum hillary scott gives birth twins congrats^shot at love with tila tequila star ashley mcneely found dead^mac miller death major factor ariana grande pete davidson breakup^kim kardashian reveals dyed hair pink^mystery solved kim kardashian gives reason dyed hair pink^breaking hugh hefner cause death revealed^kit harington reveals win iron throne gameofthrones^the bachelorinparadise season cast revealed you 're going believe picks ...^christopher big black boykin dead rob amp big star dies at^the end droughtlander upon us starz return november plus show ren^here full schedule freeform '13 nights halloween including hour hocuspocus marathon^freeform nights of halloween finally see full schedule^here full schedule freeform '13 nights halloween including hour hocuspocus marathon^breaking jennifer lawrence darren aronofsky split^meghan markle bff dubbed pippa middleton prince harry meghan markle wedding^get know host golden globes seth meyers^rent set as fox next live musical after a christmas story^baywatch star kelly rohrbach dating billionaire walmart heir steuart walton^kelly rohrbach baywatch star dating walmart heir billionaire steuart walton^selena gomez moon reasonswhy got renewed season^morning joe co hosts joe scarborough amp mika brzezinski engaged,353,29,-324,382,0.9240837696335078,-0.8481675392670157,1
16331010,TMZ,910,5042080,21882,269730,0,95,161,111,tmz consistently credited breaking biggest stories dominating entertainment news landscape changing way public gets news,watch whoopi lash out at judge jeanine video theview whoopigoldberg judgejeanine dramaalert via^on objectified steven tyler singer opens past infidelities paid price cheating th^alex trebek dropped military school chase love life did get happy ending objectified^does alex trebek rehearse answers beforehand pronunciation skills good objectifie^dr. phil opens met oprah gave wake call absolutely needed only objectified^objectified magic johnson sunday july st p et p pt p et p pt hear life^will seeing end jeopardy watch objectified alex trebek sunday fox news p et p^before dr. phil became household name got oprah brink break hear oprah wake u^on objectified steven tyler singer opens past infidelities paid price cheating th^a life story liked never seen objectified kris jenner sunday pm et pm pt at^objectified season premiere air sunday night july st due passing charles krautha^objectified season premiere air sunday night july st due passing charles krautha^this sunday premiere objectified 're kicking magic johnson tune hear his^an incredible life story told treasured objects objectified kris jenner catch x sunday on^a life story liked never seen objectified kris jenner this sunday pm et pm pt again^objectified season premiere air sunday night july st due passing charles krautha^things got real kris jenner robert kardashian filed divorce even afford buy tom^how magic johnson react realized son n't want follow athletic footsteps watch objecti^did keeping up kardashians cause demise kris caitlyn jenner marriage find objectifi^how alex trebek deal dreaded moustache resistance objectified alex trebek sunday fox news at^objectified dr. phil confesses worst marital therapist stand around hi^kris jenner relives time suffered bone tumor almost leg amputated on objectified kris^objectified season premiere air sunday night july st due passing charles krautha^objectified magic johnson sunday july st p et p pt p et p pt one mo^dr phil lived childhood without money alcoholic father how overcome obstacles^objectified magic johnson sunday july st p et p pt p et p pt magic enjoyed^objectified season premiere air sunday night july st due passing charles krautha^alex trebek enduring career might sooner think what host future find out^is alex trebek gregory hines brother after jeopardy host moustache afro dark^how steven tyler deal women throwing time watch objectified steven tyler su^dr phil lived childhood without money alcoholic father how overcome obstacles^objectified season premiere air sunday night july st due passing charles krautha^kris jenner relives time suffered bone tumor almost leg amputated on objectified kris^how magic johnson react realized son n't want follow athletic footsteps watch objecti^objectified magic johnson sunday july st p et p pt p et p pt hear life^this sunday premiere objectified 're kicking magic johnson tune hear his^objectified dr. phil confesses worst marital therapist stand around hi^kris jenner looks back affair soccer player regrets letting marriage fall apart ob^dr phil lived childhood without money alcoholic father how overcome obstacles^dr. phil confesses worst marital therapist stand around patients o^are alex trebek pronunciation skills good rehearse answers beforehand objectifi^dr. phil comes clean commitment issues time got dog ass kicked curb catch x^what magic johnson athletes hit single daughter objectified magic johnson this sun^kris jenner relives time suffered bone tumor almost leg amputated on objectified kris^an incredible life story told treasured objects objectified steven tyler catch x sunday on^objectified season premiere air sunday night july st due passing charles krautha^dr. phil confesses worst marital therapist stand around patients o^kris jenner famous mom planet architect one lucrative empires watch story^how public get past negative stigma magic johnson hiv diagnosis watch objectified magic johnson^what happened to trebek s face the jeopardy host talks scandal made headlines everywhere o^objectified season premiere air sunday night july st due passing charles krautha^alex trebek talks afro moustache dark tan africa^before dr. phil became household name got oprah brink break hear oprah wake u^aerosmith steven tyler talks easy rockstars get laid felt obligation keep^objectified dr. phil confesses worst marital therapist stand around hi^steven tyler turns mic harvey levin week episode objectified did harvey admit secret wild^steven tyler turns mic harvey levin week episode objectified did harvey admit secret wild^objectified steven tyler rockstar personifies every stereotype sex drugs rock n roll his j^an incredible life story told treasured objects objectified steven tyler catch x sunday on^what magic johnson athletes hit single daughter objectified magic johnson this sun^dr phil lived childhood without money alcoholic father how overcome obstacles^what happened to trebek s face the jeopardy host talks scandal made headlines everywhere o^objectified steven tyler rockstar personifies every stereotype sex drugs rock n roll his j^an incredible life story told treasured objects objectified steven tyler catch x sunday on^whoa steven careful around harvey ... need back newsroom safe sound find heck he'^will seeing end jeopardy watch objectified alex trebek sunday fox news p et p^objectified season premiere air sunday night july st due passing charles krautha^aerosmith steven tyler talks easy rockstars get laid felt obligation keep^dr. phil opens met oprah gave wake call absolutely needed only objectified^this sunday premiere objectified 're kicking magic johnson tune hear his^objectified magic johnson sunday july st p et p pt p et p pt one mo^dr phil lived childhood without money alcoholic father how overcome obstacles^kris jenner looks back affair soccer player regrets letting marriage fall apart on^kris jenner looks back affair soccer player regrets letting marriage fall apart ob^an incredible life story told treasured objects objectified magic johnson catch x sunday jul^an incredible life story told treasured objects objectified magic johnson catch x sunday jul^how public get past negative stigma magic johnson hiv diagnosis watch objectified magic johnson.^steven tyler turns mic harvey levin week episode objectified did harvey admit secret wild^did kris jenner know secret caitlyn jenner hiding life watch objectified kris jenner s^on objectified steven tyler aerosmith front man comes clean drug use great lengths took^objectified magic johnson sunday july st p et p pt p et p pt hear life^will seeing end jeopardy watch objectified alex trebek sunday fox news p et p^on objectified steven tyler singer opens past infidelities paid price cheating th^a life story liked never seen objectified dr. phil this sunday pm et pm pt again^objectified magic johnson sunday july st p et p pt p et p pt hear life^how steven tyler deal women throwing time watch objectified steven tyler su^two weeks kris jenner declared done men met bruce jenner watch objectified kris jenner t^an incredible life story told treasured objects objectified steven tyler catch x sunday on^dr. phil opens met oprah gave wake call absolutely needed only objectified^an incredible life story told treasured objects objectified kris jenner catch x sunday on^will seeing end jeopardy watch objectified alex trebek sunday fox news p et p^objectified magic johnson sunday july st p et p pt p et p pt magic discuss^you witnessed murder espys party tmz^congressman bob brady bill cosby should keep heck out philadelphia forever^congressman bob brady bill cosby should keep heck out philadelphia forever^meghan markle showed some leg we 're not mad about it pics meghanmarkle meghanandharry sexy via^anna faris chris pratt hang out second day row annafaris chrispratt via^kim richards opens up about her secret love years wynn katz exclusive kimrichards via^ariana grande gets huge tattoo anime character arianagrande via^anna faris chris pratt hang out second day row annafaris chrispratt via^kylie jenner declares her abs 'making comeback poses sports bra video kyliejenner via^meghan markle showed some leg we 're not mad about it pics meghanmarkle meghanandharry sexy via^ariana grande gets huge tattoo anime character arianagrande via^the real reason jennifer lawrence find boyfriend via^khloe kardashian i want nothing to do with lamar odom but ...^khloe kardashian i want nothing to do with lamar odom but ...^karrueche tran granted five year restraining order against chris brown update^karrueche tran granted five year restraining order against chris brown update^karrueche tran granted five year restraining order against chris brown update^lindsay lohan mocked busy phillips over drunk mykonos video^lindsay lohan mocked busy phillips over drunk mykonos video^jessica simpson debuts baby bump announcing pregnancy via^jessica simpson debuts new baby bump after revealing she eecting her third child jessicasimpson via^chris pratt files divorce from anna faris^chris pratt files divorce from anna faris^leah remini breaks silence jennifer lopez ben affleck getting back together bennifer via^leah remini breaks silence jennifer lopez ben affleck getting back together bennifer via^jennifer lopez jokes there no pressure for alex rodriguez to propose via^kim kardashian mission free another prisoner tmz^kim kardashian addresses speculation drake sexual relationship via^jamie foxx katie holmes finally out public as couple^kris jenner posts fashion brand kim kardashian possibly turned down pics via^kris jenner posts fashion brand kim kardashian possibly turned down pics via^kris jenner posts fashion brand kim kardashian possibly turned down pics via^was megyn kelly target went nbc beloved matt lauer also cops pay visit ronnie ortiz ma^channing tatum wife jenna dewan split after nearly years marriage^kardashian family banned from oscar party over drunk messy behavior report via^tmz live kim kardashian r word controversy^kim kardashian bikini pic looks perfect yet she being body shamed by fans see what they are freaking out ov^kim kardashian bikini pic looks perfect yet she being body shamed by fans see what they are freaking out ov^kim kardashian bikini pic looks perfect yet she being body shamed by fans see what they are freaking out ov^kim kardashian bikini pic looks perfect yet she being body shamed by fans see what they are freaking out ov^fergie josh duhamel split after year marriage^fergie josh duhamel split after year marriage^alexandra daddario slams rumors she still dating zac efron what happened via^alexandra daddario slams rumors she still dating zac efron what happened via^meghan markle makes another major royal faux pas with prince harry oh no watch via^meghan markle makes another major royal faux pas with prince harry oh no watch via^did justin bieber mom just confirm her son is dating selena gomez see her loving tweets via^did justin bieber mom just confirm her son is dating selena gomez see her loving tweets via^jennifer garner no ring truth reconciliation ben affleck photo^jennifer garner no ring truth reconciliation ben affleck photo^meghan markle receives support from queen elizabeth over family drama report says meghanmarkle royals via^meghan markle receives support from queen elizabeth over family drama report says meghanmarkle royals via^kourtney kardashian breaks down over 'evil human being kim 'kuwtk screaming match exclusive kimkardashian^kourtney kardashian breaks down over 'evil human being kim 'kuwtk screaming match exclusive kimkardashian^britney spears falls to the floor terrified after epic scare crazy video via^justin bieber has selena gomez face tattooed on his wrist despite being engaged hailey baldwin via^justin bieber has selena gomez face tattooed on his wrist despite being engaged hailey baldwin via^justin bieber has selena gomez face tattooed on his wrist despite being engaged hailey baldwin via^the weeknd one ended relationship selena gomez ... justin bieber fault^the weeknd one ended relationship selena gomez ... justin bieber fault^the weeknd one ended relationship selena gomez ... justin bieber fault^the weeknd one ended relationship selena gomez ... justin bieber fault^did keeping up kardashians cause demise kris caitlyn jenner marriage find objectifi^younes bendjima fires back 'rebound rumors after kourtney kardashian split younesbendjima kourtneykardashian^younes bendjima fires back 'rebound rumors after kourtney kardashian split younesbendjima kourtneykardashian^katherine jackson resigns blanket guardian^katherine jackson resigns blanket guardian^katherine jackson resigns blanket guardian^ariana grande gets huge tattoo anime character arianagrande via^kanye west concerts on hold ... indefinitely^kanye west concerts on hold ... indefinitely^kanye west nick cannon squashed their beef over kim kardashian^kanye west nick cannon squashed their beef over kim kardashian^kanye west nick cannon squashed their beef over kim kardashian^justin bieber strolls nice chick south france^justin bieber strolls nice chick south france^justin bieber strolls nice chick south france^justin bieber strolls nice chick south france^justin bieber strolls nice chick south france^did keeping up kardashians cause demise kris caitlyn jenner marriage find objectifi^kim kardashian left suggestive comment kanye west instagram account via^kim kardashian left suggestive comment kanye west instagram account via^nick jonas mortified selena gomez reveals he ruined double date with taylor swift amp his brother via^nick jonas mortified selena gomez reveals he ruined double date with taylor swift amp his brother via^nick jonas mortified selena gomez reveals he ruined double date with taylor swift amp his brother via^nick jonas mortified selena gomez reveals he ruined double date with taylor swift amp his brother via^dakota johnson interesting plans shades done via^beyonce birth twins still hospital 'minor issue^beyonce birth twins still hospital 'minor issue^channing tatum wife jenna dewan split after nearly years marriage^jessica simpson debuts baby bump announcing pregnancy via^jessica simpson debuts new baby bump after revealing she eecting her third child jessicasimpson via^karrueche tran granted five year restraining order against chris brown update^karrueche tran granted five year restraining order against chris brown update^karrueche tran granted five year restraining order against chris brown update^justin bieber fan arrested trespassing at singer beverly hills home^brody jenner amp wife shade caitlyn after dodging wedding^brody jenner amp amp wife shade caitlyn after dodging wedding^caitlyn jenner austria life ball while brody preps wedding without her^brody jenner wedding celebration full effect fireworks^caitlyn jenner austria life ball while brody preps wedding without her^kourtney kardashian looks hotter than ever in post breakup bikini shot via^clearing brad pitt angelina jolie divorce details brangelina^clearing brad pitt angelina jolie divorce details brangelina^clearing brad pitt angelina jolie divorce details brangelina^are john mayer jennifer aniston back together^kim kardashian says kanye west was told not to date her because of sex tape via^kim kardashian wears skin tight dress date night kanye west kimkardashian kanyewest via^kim kardashian wears skin tight dress date night kanye west kimkardashian kanyewest via^kim kardashian says kanye west was told not to date her because of sex tape via^oj simpson predicted that 'keeping up with kardashians would fail via^drake gets former porn star pregnant she has text messages ... she claims but he calls bs^drake gets former porn star pregnant she has text messages ... she claims but he calls bs^angelina jolie strapless naked dress amp naked heels could n't be hotter pics angelinajolie via^kendall breaks tears bruce jenner sex change ... khloe response rude via^chris pratt coffee date mystery blonde^chris pratt coffee date mystery blonde^kanye west returned twitter live video rant about 'mind control evils social media among other^ouch spencer pratt slams lauren conrad amp caitlyn jenner with some nasty remarks via^ouch spencer pratt slams lauren conrad amp caitlyn jenner with some nasty remarks via^people are freaking out over kate middleton daring low cut gown too sexy for a royal via^people are freaking out over kate middleton daring low cut gown too sexy for a royal via^people are freaking out over kate middleton daring low cut gown too sexy for a royal via^clearing brad pitt angelina jolie divorce details brangelina^clearing brad pitt angelina jolie divorce details brangelina^clearing brad pitt angelina jolie divorce details brangelina^miley cyrus easter photo shoot gets little naughty^miley cyrus easter photo shoot gets little naughty^miley cyrus easter photo shoot gets little naughty^miley cyrus easter photo shoot gets little naughty^miley cyrus easter photo shoot gets little naughty^miley cyrus easter photo shoot gets little naughty^miley cyrus easter photo shoot gets little naughty^miley cyrus easter photo shoot gets little naughty^meghan markle is 'very excited about nick jonas amp priyanka chopra engagement report says meghanmarkle^meghan markle is 'very excited about nick jonas amp priyanka chopra engagement report says meghanmarkle^donald trump calls stephen colbert 'no talent hack 'filthy mouth^donald trump calls stephen colbert 'no talent hack 'filthy mouth^kanye west nick cannon squashed their beef over kim kardashian^kanye west nick cannon squashed their beef over kim kardashian^kanye west nick cannon squashed their beef over kim kardashian^chris pratt amp mystery blonde jet out of la together a week after anna faris split pic via^chris pratt spotted on potential nd date with mystery blonde via laineygossip^chris pratt coffee date mystery blonde^chris pratt coffee date mystery blonde^chris pratt amp mystery blonde jet out of la together a week after anna faris split pic via^chris pratt spotted on potential nd date with mystery blonde via laineygossip^kris jenner boozy karaoke valentine night^kris jenner boozy karaoke valentine night^kris jenner boozy karaoke valentine night^travis scott knows spoil lady date night kyliejenner travisscott tmz^travis scott knows spoil lady date night kyliejenner travisscott tmz^joe alwyn goes public instagram see his sly nod girlfriend taylor swift taylorswift joealwyn via^joe alwyn goes public instagram see his sly nod girlfriend taylor swift taylorswift joealwyn via^gwyneth paltrow denies she 'becky with good hair after amber rose calls her out gwynethpaltrow jayz^gwyneth paltrow denies she 'becky with good hair after amber rose calls her out gwynethpaltrow jayz^charles manson pen pal submit docs court claiming manson will legit^charles manson pen pal submit docs court claiming manson will legit^miley cyrus liam hemsworth chumming it up lunch^miley cyrus liam hemsworth chumming it up lunch^miley cyrus liam hemsworth chumming it up lunch^miley cyrus liam hemsworth chumming it up lunch^meghan markle rejoins prince harry australian tour after missing event^kendall jenner could be hooking up anwar hadid^'chicago fire star dushon monique brown cause death revealed^'chicago fire star dushon monique brown cause death revealed^'chicago fire star dushon monique brown cause death revealed^kelly ripa picks her new 'live with kelly co host and it ... ryan seacrest tmz^kelly ripa picks her new 'live with kelly co host and it ... ryan seacrest tmz^kelly ripa picks her new 'live with kelly co host and it ... ryan seacrest tmz^kelly ripa picks her new 'live with kelly co host and it ... ryan seacrest tmz^kelly ripa picks her new 'live with kelly co host and it ... ryan seacrest tmz^sources say pregnant khloe kardashian is 'completely devastated over tristan thompson cheating allegations exclus^jada pinkett smith slams 'all eyez me inaccuracies calls movie 'deeply hurtful^jada pinkett smith year old bodybuilder pal calls out will smith^jada pinkett smith year old bodybuilder pal calls out will smith^jada pinkett smith slams 'all eyez me inaccuracies calls movie 'deeply hurtful^jada pinkett smith year old bodybuilder pal calls out will smith^real housewives new york luann de lesseps accuses russell simmons groping her elevato via^'house cards star reg e. cathey dead from cancer^tisha campbell files for divorce from husband duane martin via^'martin star tisha campbell martin files for divorce husband duane^'martin star tisha campbell martin files for divorce husband duane^'martin star tisha campbell martin files for divorce husband duane^'martin star tisha campbell martin files for divorce husband duane^tisha campbell files for divorce from husband duane martin via^kylie jenner shows off her foot christmas tree amp it so extra via^kylie jenner shows off her foot christmas tree amp it so extra via^kylie jenner shows off her foot christmas tree amp it so extra via^madonna files emergency order stop tupac shakur letter auction^madonna files emergency order stop tupac shakur letter auction^madonna files emergency order stop tupac shakur letter auction^jill zarin husband bobby dead cancer battle^jill zarin husband bobby dead cancer battle^jill zarin husband bobby dead cancer battle^th suspect xxxtentacion murder case trayvon newsome arrested^farrah abraham shares pics her vaginal rejuvenation procedure via^farrah abraham shares pics her vaginal rejuvenation procedure via^farrah abraham shares pics her vaginal rejuvenation procedure via^cardi b shows ellen degeneres how she got pregnant video via^mark salling autopsy reveals alcohol his system during suicide^mark salling autopsy reveals alcohol his system during suicide^nelly under criminal investigation sexual assault^nelly under criminal investigation sexual assault^'superman star margot kidder dead^tina turner firstborn son craig turner dead suicide^tina turner firstborn son craig turner dead suicide^tina turner firstborn son craig turner dead suicide^this is why kim kardashian dyed her hair pink amp how kanye feels about it via^this is why kim kardashian dyed her hair pink amp how kanye feels about it via^portia de rossi says steven seagal 'unzipped his leather pants during audition via^portia de rossi says steven seagal 'unzipped his leather pants during audition via^jennifer lopez cheers boyfriend alex rodriguez year old daughter she sings her via^jennifer lopez cheers boyfriend alex rodriguez year old daughter she sings her via^jennifer lopez cheers boyfriend alex rodriguez year old daughter she sings her via^jennifer lopez cheers boyfriend alex rodriguez year old daughter she sings her via^jennifer lopez cheers boyfriend alex rodriguez year old daughter she sings her via^jennifer lopez cheers boyfriend alex rodriguez year old daughter she sings her via^'my big fat greek wedding mom lainie kazan arrested shoplifting^miley cyrus poses nearly nude fairy princess david lachapelle new book 'lost found nsfw via^miley cyrus poses nearly nude fairy princess david lachapelle new book 'lost found nsfw via^pink reveals christina aguilera tried punch her 'she swung me club video via^pink reveals christina aguilera tried punch her 'she swung me club video via^'wicked tuna star nicholas 'duffy fudge dead^it official arie luyendyk jr. amp lauren burnham announce their wedding date location via^mindy kaling wants people think she dating chadwick boseman via^'stranger things star shannon purser comes out bisexual apologizes lgbt fans photo^'stranger things star shannon purser comes out bisexual apologizes lgbt fans photo^we finally know why ren e zellweger disappeared from hollywood for years via^we finally know why ren e zellweger disappeared from hollywood for years via^did cardi b sister accidentally reveal sex her baby offset via^tessa thompson clarifies comment about lena dunham amp time up via^tessa thompson clarifies comment about lena dunham amp time up via^kendra wilkinson files divorce hank baskett^kendra wilkinson files divorce hank baskett^kendra wilkinson files divorce hank baskett^kaley cuoco marries boyfriend karl cook^kaley cuoco marries boyfriend karl cook^tiffany haddish cries after oprah surprises her the ellen degeneres show video via^tiffany haddish cries after oprah surprises her the ellen degeneres show video via^taylor swift music video director says beyonce copied 'bad blood via^taylor swift music video director says beyonce copied 'bad blood via^sarah paulson does n't care what haters think her year age gap with holland taylor via^sarah paulson does n't care what haters think her year age gap with holland taylor via^sarah paulson does n't care what haters think her year age gap with holland taylor via^sarah paulson does n't care what haters think her year age gap with holland taylor via^sarah paulson does n't care what haters think her year age gap with holland taylor via^sarah paulson does n't care what haters think her year age gap with holland taylor via^jeremy london arrested domestic violence^jeremy london arrested domestic violence^katharine mcphee david foster are engaged^katharine mcphee david foster are engaged^katharine mcphee david foster are engaged^lcd soundsystem gavin russom comes out transgender see the star new transformation via^lcd soundsystem gavin russom comes out transgender see the star new transformation via^gwyneth paltrow denies she 'becky with good hair after amber rose calls her out gwynethpaltrow jayz^gwyneth paltrow denies she 'becky with good hair after amber rose calls her out gwynethpaltrow jayz^justin theroux makes first official appearance since jennifer aniston split via^justin theroux first instagram post since jennifer aniston split swoon worthy via^justin theroux makes first official appearance since jennifer aniston split via^khloekardashian is ready to marry tristanthompson tmz^khloekardashian is ready to marry tristanthompson tmz^khloekardashian is ready to be tristanthompson bride tmz^khloekardashian is ready to marry tristanthompson tmz^meghan markle admits she misses 'suits since trading in acting for royal duties via^meghan markle admits she misses 'suits since trading in acting for royal duties via^luann de lesseps sued ex husband kids over trust^luann de lesseps sued ex husband kids over trust^chris pratt files divorce from anna faris^chris pratt files divorce from anna faris^april giraffe pregnant again she sure gets around aprilthegiraffe tmz^april giraffe pregnant again she sure gets around aprilthegiraffe tmz^april giraffe pregnant again she sure gets around aprilthegiraffe tmz^april giraffe pregnant again she sure gets around aprilthegiraffe tmz^april giraffe pregnant again she sure gets around aprilthegiraffe tmz,161,206,45,367,0.43869209809264303,0.1226158038147139,0
111556701,DailyMailCeleb,979,303051,2456,147432,0,0,292,67,latest celeb entertainment news daily mail showbiz team we facebook kim k followed us /21/2015,jennifer aniston 'pining justin theroux^jennifer aniston 'furious selena gomez justin theroux dating rumors^amal george clooney picture exclusive couple leave twins home zoom around scooter italy^is kim kardashian stolen jewelry funding terrorism^jennifer lopez alex rodriguez jet miami together amid cheating claims extortion attempt^jennifer lopez alex rodriguez jet miami together amid cheating claims extortion attempt^brad pitt angelina jolie finally getting married ... new movie^karrueche tran finally granted five year restraining order ex chris brown^karrueche tran finally granted five year restraining order ex chris brown threats violence^jennifer lawrence darren aronofsky plit huge age gap^jennifer lawrence darren aronofsky plit huge age gap^jennifer lawrence says pal amy schumer told would 'die alone split darren aronofsky^jamie foxx parties mystery woman miami amid rumors split katie holmes^jamie foxx takes swing celebrity softball game katie holmes denies split rumors^selena gomez gets matching tattoos three friends^hero brad pitt pulls little girl safety crushing crowd gran canaria^what roseanne barr net worth^caitlyn jenner planning unveil new body gender reassignment surgery nude photo shoot^jessica simpson debuts baby bump ... hours announcing eecting third child girl^jessica simpson stuns hiding burgeoning baby bump latest fashion campaign^jessica simpson covers baby bump leopard print dress makes way nyc^jessica simpson stuns tank top knee boots photo shoot took place baby bump be^kylie jenner gives fans look inside luxury mansion shows huge pool tennis courts bedroom^ben affleck treats cast crew hawaiian luau lindsay shookus joins^kanye west shares friendly texts caitlyn jenner amid feud kim kardashians family^just angelina jolie brad pitt divvy 400m fortune^liam hemsworth plays hilarious prank miley cyrus again^liam hemsworth plays hilarious prank miley cyrus again sneaks scares fiancee parking lot^kim kardashian brands partygoers 'retarded recognizing pamela anderson halloween costume^kim kardashian cries 'turquoise tears sizzling topless photo eye makeup brand^sharon osbourne brands kim kardashian 'obnoxious 'flaunting private flight social media^kim kardashian proudly embracing nudity one hallmarks brand^kim kardashian sister khloe brand pranksters set fake photos kylie boyfriend travis scott cheating^kim kardashian brands partygoers 'retarded recognizing pamela anderson halloween costume^let countdown begin eva longoria heavily pregnant talks new film overboard anna far^oprah winfrey 'favorite date night cooking urprise dinner partner stedman graham^ben affleck jennifer garner divorce may dismissed court 'drag feet three years spl^what mila kunis net worth^what mila kunis net worth^the real reason justin bieber selena gomez split^the real reason justin bieber selena gomez split^liam hemsworth plays hilarious prank miley cyrus again^liam hemsworth plays hilarious prank miley cyrus again sneaks scares fiancee parking lot^sarah jessica parker addresses replacing kim cattrall sex and the city^sarah jessica parker addresses replacing kim cattrall sex and the city^manchester attack victim georgina callander remembered once upon a time cast^cheryl plit ex liam payne felt like raising son bear one due d sta^cheryl reveals never date liam payne split^cheryl set stun fans 'eletive laden track liam payne split^liam payne announces release date first single since split cheryl^cheryl reveals never date liam payne split^cheryl plit ex liam payne felt like raising son bear one due d sta^sofia richie slips bikini celebrate th birthday^scott disick whisked sofia richie away mexico th birthday^sofia richie lounges around sexy red dress celebrating th birthday mexico^sofia richie celebrates th birthday style^sofia richie scott disick enjoy dinner date malibu^sofia richie flaunts cleavage flat midriff knotted top trousers date night scott di^sofia richie given hot pink birkin bag dad lionel^katy perry slips raunchy leather leotard embarking tour show nyc^selena gomez justin theroux 'more friends jennifer aniston 'is happy^selena gomez justin theroux 'more friends jennifer aniston 'is happy^angelina jolie accuses brad pitt paying enough child support divorce custody battle rages on^brad pitt 'not relationship neri oxman focuses six children career^kim kardashian branded 'petty sharing flirty throwback snap caitlyn jenner mom kris^celebrities react donald trump inauguration^julia roberts enjoys malibu outing niece emma roberts evan peters^julia roberts enjoys outing malibu chili cook niece emma roberts evan peters^heidi klum sends support longtime friend mel b pop star reveals going rehab^ryan phillippe hits 'false allegations ex elsie hewitt seeks 1m damages^jennifer aniston 'furious selena gomez justin theroux dating rumors^moment prince charles camilla gaze eyes polo match recreated the crown^moment prince charles camilla gaze eyes polo match recreated the crown^jennifer garner takes tense phone call weeks split ben affleck^ben affleck jennifer garner look tense reunite take kids halloween^ben affleck ex jennifer garner look tense take son samuel basketball game^ben affleck jennifer garner seen tense conversation bahamas retreat^jennifer garner looks tense set claims ben affleck fling nanny^did miley cyrus liam hemsworth secretly get married^did miley cyrus liam hemsworth secretly get married^tom cruise 'diabolical 'good person says leah remini puts famous scientologist blast^tom cruise 'diabolical 'good person says leah remini puts famous scientologist blast^tom cruise 'diabolical 'good person says leah remini puts famous scientologist blast^tom cruise 'diabolical 'good person says leah remini puts famous scientologist blast^jennifer aniston 'furious selena gomez justin theroux dating rumors^justin theroux flaunts biceps rides around nyc bike^taylor kinney praised lady gaga right engagement christian carino revealed^gwen stefani says 'convince blake shelton participate crowned sexiest man alive^gwen stefani says 'convince blake shelton participate crowned sexiest man alive^angelina jolie enjoys labor day hike kids^bella hadid hits back 'jealous troll accused kendall jenner plastic surgery^britney spears terrified crazed man rushes onstage las vegas show^britney spears terrified crazed man rushes onstage las vegas show^britney spears left 'terrified crazed man rushes onstage las vegas show^what margot robbie net worth^selena gomez natural beauty^selena gomez natural beauty^what amal clooney net worth the human rights lawyer worth revealed^katie holmes jamie foxx leave nobu restaurant separately rare date night^kourtney kardashian blasts kris jenner affair tense clip keeping up with the kardashians^kourtney kardashian blasts kris jenner affair tense clip keeping up with the kardashians^brad pitt 'absolutely smitten mit professor neri oxman^cindy crawford cuts elegant figure white top heads dinner husband rande gerber^cindy crawford giddily poses storm sophisticated chiffon dress^cindy crawford gets 'back work^kylie jenner 'leaned kim kardashian found 'pregnant travis scott baby^justin bieber golfs la amid news marriage hailey baldwin 'undoubtedly 'effect selena gomez^cindy crawford cuts elegant figure white top heads dinner husband rande gerber^cindy crawford giddily poses storm sophisticated chiffon dress^cindy crawford gets 'back work^kourtney kardashian none pleased 'jealous younger boyfriend younes bendjima^kim kardashian tells khloe fight kanye west band aids^ray j took high road asked kanye west v. nick cannon feud kim kardashian^ray j takes high road kanye west v nick cannon feud kim kardashian 'that macho macho kind st^kim kardashian supports troubled husband kanye west backlash controversial comments^what rachel weisz net worth pregnant star wealth revealed^joel edgerton 'meets jennifer lawrence family rumours sweep hollywood red sparrow co star^david foster breaks silence engagement katharine mcphee proposing italy^are justin bieber hailey baldwin 'already married^selena gomez justin bieber despite married man^sofia richie slips bikini celebrate th birthday^scott disick whisked sofia richie away mexico th birthday^sofia richie lounges around sexy red dress celebrating th birthday mexico^sofia richie celebrates th birthday style^sofia richie scott disick enjoy dinner date malibu^sofia richie flaunts cleavage flat midriff knotted top trousers date night scott di^sofia richie given hot pink birkin bag dad lionel^kendall jenner slams pregnancy rumors fans claim sporting baby bump^kourtney kardashian blasts kris jenner affair tense clip keeping up with the kardashians^kourtney kardashian blasts kris jenner affair tense clip keeping up with the kardashians^reese witherspoon gives glimpse stays fit goes run friend la^lamar odom congratulates ex wife khloe kardashian 'pregnancy tristan thompson^lea michele enjoying every minute long holiday weekend^lea michele soaks sun relaxes bikini labor day selfie^colin jost calls scarlett johansson 'girlfriend first time snl dating segment^colin jost calls scarlett johansson 'girlfriend first time snl dating segment^justin theroux 'had reservations marrying jennifer aniston^miley cyrus cancels honeymoon bora bora liam hemsworth^'we 've friends years hailee steinfeld denies dating justin bieber radio interview^julia roberts enjoys malibu outing niece emma roberts evan peters^julia roberts enjoys outing malibu chili cook niece emma roberts evan peters^kim kardashian 'upset kanye west said would move chicago plans 'leave family la^kim kardashian 'upset kanye west said would move chicago plans 'leave family la^kendall jenner rules victoria secret runway fun flirty attitude^caitlyn jenner planning unveil new body gender reassignment surgery nude photo shoot^jessica simpson debuts baby bump ... hours announcing eecting third child girl^jessica simpson stuns hiding burgeoning baby bump latest fashion campaign^jessica simpson covers baby bump leopard print dress makes way nyc^jessica simpson stuns tank top knee boots photo shoot took place baby bump be^karrueche tran finally granted five year restraining order ex chris brown^karrueche tran finally granted five year restraining order ex chris brown threats violence^the weeknd scrapped 'upbeat beautiful album my dear melancholy selena gomez split^brody jenner releases official wedding photo days marrying kaitlynn carter indonesia^caitlyn jenner shows leg tight skirt disappointing son brody missing wedding^why caitlyn jenner missing son brody jenner wedding^brody jenner spectacular tropical island wedding venue revealed^brody jenner 'disappointed father caitlyn ditched wedding last minute take 'work offer^brody jenner fianc e ask guests cash toward honeymoon fund luxury wedding^brody kaitlynn jenner release baby turtles 'rescued local markets wedding indonesia^kourtney kardashian ex younes bendjima till bitter breakup^kourtney kardashian ex younes bendjima till bitter breakup^katie holmes looks casually cute plaid spotted enjoying lunch mystery man^ryan gosling eva mendes 'on verge split^kylie jenner says hair 'destroyed bleaching^katie holmes jamie foxx spotted leaving nyc apartment separate times^katie holmes takes suri mother daughter breakfast girls coordinate flowing dresses^katie holmes steps solo grab lunch^katie holmes mini daughter suri coordinate denim pink errands run nyc^katie holmes takes suri mother daughter breakfast girls coordinate flowing dresses^brad pitt 'genius professor love neri oxman totes the feynman lectures on physics around campus^brad pitt genius new love neri oxman steps black outfit^brad pitt love neri oxman models another angelina jolie look gets back work near boston^julia roberts enjoys malibu outing niece emma roberts evan peters^julia roberts enjoys outing malibu chili cook niece emma roberts evan peters^'things got bad angelina jolie breaks silence brad pitt split vanity fair^'things got bad angelina jolie breaks silence brad pitt split vanity fair^caitlyn jenner planning unveil new body gender reassignment surgery nude photo shoot^nicole kidman flaunts slender figure skintight bodysuit new trailer aquaman^why selena gomez justin bieber break^why selena gomez justin bieber break^kendall jenner slams pregnancy rumors fans claim sporting baby bump^when kanye west yandhi album kim kardashian reveals release date twitter^kim kardashian slips slimmed figure skin tight latex enjoys glamorous date night husband^angelina jolie 'involved bizarre special forces plot arrest warlord joseph kony^scott disick not getting back together kourtney kardashian^kylie jenner boyfriend new dad travis scott pleads guilty disorderly conduct^celine dion taking inspiration britney justin double denim disaster^angelina jolie enjoys labor day hike kids^what sarah paulson net worth ocean star wealth revealed^julia roberts enjoys malibu outing niece emma roberts evan peters^julia roberts enjoys outing malibu chili cook niece emma roberts evan peters^angelina jolie enjoys labor day hike kids^blake griffin jilted ex tears nba star lawsuit claiming 'abandoned family 'fawn kend^emma watson accused 'diva behaviour arriving elle style awards minutes late^kate walsh splits boyfriend trevor davis claimed 'he n't ready children^jennifer aniston puts brave face ellen degeneres makes awkward joke marriage^'pregnant kylie jenner hit split claims boyfriend travis scott^katie holmes jamie foxx spotted leaving nyc apartment separate times^katie holmes takes suri mother daughter breakfast girls coordinate flowing dresses^katie holmes steps solo grab lunch^katie holmes mini daughter suri coordinate denim pink errands run nyc^katie holmes takes suri mother daughter breakfast girls coordinate flowing dresses^rob kardashian suing blac chyna 'for trying strangle iphone cord consuming drugs alcohol^teri hatcher shoots claims 'broke homeless living van ... calling report 'totally a^'i scared mom growing kylie admits still fears momager kris jenner life of kylie sneak peek^justin bieber joins dad jeremy little brother jan guys lunch hollywood^miley cyrus gets spanked very naughty bunny racy easter photo shoot^alessandra ambrosio debuts new braided hairdo alongside casual ensemble heads la airport^angelina jolie 'driven wedge ex brad pitt six children amid bitter two year custody b^brad pitt paid 'millions support kids two year custody battle angelina jolie drags^brad pitt heads law office amid bitter custody battle ex angelina jolie^brad pitt spends father day kids london amid custody battle angelina jolie^jennifer aniston worried brad pitt custody battle angelina jolie^angelina jolie spends day knox shiloh amid custody battle brad pitt^brad pitt pictured law office amid bitter custody battle angelina jolie^angelina jolie accuses brad pitt paying enough child support divorce custody battle rages on^jennifer aniston worried brad pitt custody battle angelina jolie^teri hatcher shoots claims 'broke homeless living van ... calling report 'totally a^priyanka chopra says 'really excited meghan markle following pregnancy announcement^priyanka chopra says 'really excited meghan markle following pregnancy announcement^kim kardashian tells khloe fight kanye west band aids^ray j took high road asked kanye west v. nick cannon feud kim kardashian^ray j takes high road kanye west v nick cannon feud kim kardashian 'that macho macho kind st^kim kardashian supports troubled husband kanye west backlash controversial comments^chris pratt leaves la private jet mystery blonde anna faris split^chris pratt leaves la private jet mystery blonde anna faris split^kim kardashian reveals 'begging sister khloe surrogate mother help another child^khloe kardashian shows long legs boozy trip kris jenner malibu winery^kim kardashian steps holding hands kanye west ... attend opening scott disick restaurant wit ...^hailey baldwin worries selena gomez never get justin bieber^hailey baldwin worries selena gomez never get justin bieber^hailey baldwin worries selena gomez never get justin bieber^justin theroux flaunts biceps rides around nyc bike^justin theroux bundles bikes around nyc outing mystery brunette^jennifer lawrence absolutely terrified teaser trailer boyfriend darren aronofsky horror flick mother^betty white reveals plans retire^sofia richie slips bikini celebrate th birthday^scott disick whisked sofia richie away mexico th birthday^sofia richie lounges around sexy red dress celebrating th birthday mexico^sofia richie celebrates th birthday style^sofia richie scott disick enjoy dinner date malibu^sofia richie flaunts cleavage flat midriff knotted top trousers date night scott di^sofia richie flaunts gorgeous figure bright orange bikini day th birthday^sofia richie given hot pink birkin bag dad lionel^sofia richie slips bikini celebrate th birthday^scott disick whisked sofia richie away mexico th birthday^sofia richie lounges around sexy red dress celebrating th birthday mexico^sofia richie celebrates th birthday style^sofia richie scott disick enjoy dinner date malibu^sofia richie flaunts cleavage flat midriff knotted top trousers date night scott di^sofia richie flaunts gorgeous figure bright orange bikini day th birthday^sofia richie given hot pink birkin bag dad lionel^sir billy connolly wife slams michael parkinson health comments^emotional selena gomez reveals kidney transplant ... donated organ came best friend^emotional selena gomez reveals kidney transplant ... donated organ came best friend^selena gomez reveals kidney transplant help battle lupus^kim kardashian tells khloe fight kanye west band aids^selena gomez meets mystery man breakfast beverly hills^selena gomez meets mystery man breakfast beverly hills^david beckham pulls sad face admits 'not happy trimming daughter harper hair^david beckham pulls sad face admits 'not happy trimming daughter harper hair^'i ca n't trust anyone reveals paris robbery left terrified emotionally scarred months^kim kardashian west 'jealous daughter north trouble accepting child^'pregnant kylie jenner 'is planning six month break spotlight focus motherhood^pregnant kylie jenner mum kris take lip kit promo shunning spotlight^pregnant kylie jenner mum kris take lip kit promo shunning spotlight^kylie jenner goes creative lengths hide baby bump makes rare return spotlight^'pregnant kylie jenner 'is planning six month break spotlight focus motherhood^white witch warns angelina jolie using spells 'tattoo binding woo back brad^katy perry slams lionel richie jimmy kimmel live^heidi klum flaunts toned beach body tiny bikini holiday beau vito schnabel kids^heidi klum shows incredible bikini body sultry swim campaign^heidi klum shows bikini body playful video reunites ex husband seal america got talent^heidi klum flaunts toned beach body bikini^heidi klum flaunts bikini body fun sun soaked day sardinia four kids^britney spears vegas costumes falling apart already^jennifer lopez jenna dewan tatum shine red carpet promote world dance season two^are wedding bells sandra bullock future^kim kardashian leaves suggestive comment kanye west instagram post^kim kardashian leaves suggestive comment kanye west instagram post^kim kardashian leaves little imagination topless photo^kim kardashian leaves little imagination topless photo^reese witherspoon 'furious nicole kidman fallout new tv show big little lies^caitlyn jenner confirms daughter kylie is eecting baby^marion cotillard 'absolutely devastated dragged angelina jolie brad pitt split^not missing harry much meghan markle gets christmas spirit^selena gomez feeling 'very empowered treatment^ruby rose claims rebel wilson stole spotlight pitch perfect^ruby rose claims rebel wilson stole spotlight pitch perfect^brad pitt sienna miller 'cosy glastonbury party^kendall jenner flaunts flat stomach tiny red bikini fun labor day party^are brad pitt jennifer aniston getting back together^anna kournikova enrique iglesias welcome twins ... keeping pregnancy secret^heather locklear pleads guilty attacking police officers la mansion^stanley tucci wife felicity blunt welcome daughter emilia giovanna^oscar isaac reveals infant son eugene named late mother plays hamlet nyc^oscar isaac reveals infant son eugene named late mother^the bachelor vanessa grimaldi new boyfriend eight months split ex fiance nick viall^snl bill hader wife maggie carey divorcing years marriage^blac chyna packs pda boyfriend ybn almighty jay lashed ladies la^dance moms star abby lee miller sentenced year day prison fraud charges^ed sheeran reveals secretly got engaged girlfriend cherry seaborn last year^'that support everything brie larson reveals emma stone jennifer lawrence aved life^'that support everything brie larson reveals emma stone jennifer lawrence aved life^blake lively 'needs another hand surgery injured set the rhythm section^the handmaid tale actress yvonne strahovski reveals pregnant first child^summer phoenix files divorce casey affleck^kendall jenner 'hospitalized suffering bad reaction vitamin drip attending vanity fair oscar^'hot felon jeremy meeks files divorce wife melissa eight years marriage^ariana grande cancels vietnam concert hours performance due 'health problems^heidi montag spencer pratt welcome newborn son gunner stone^heidi montag spencer pratt welcome newborn son gunner stone^heidi montag spencer pratt welcome newborn son gunner stone^bachelor nick viall vanessa grimaldi end engagement^tina turner firstborn son craig turner found dead suicide aged^ariana grande mac miller break two years together^the notebook star rachel mcadams 'is pregnant first child boyfriend two years jamie linden^tyrese gibson fast and furious fame reveals eecting baby girl wife samantha^mindy kaling finally confirms pregnant first child^mindy kaling finally confirms pregnant first child^former mtv vj jesse camp found safe 'depressed media personality reported missing five days ago^katie holmes jamie foxx spotted looking cozy clive davis pre grammy gala^grey anatomy star jesse williams awarded joint physical custody children divorce battle ex^anna wintour daughter bee shaffer ties knot francesco carrozzini romantic second wedding ceremony i^anna wintour daughter bee shaffer francesco carrozzini honeymoon italy^la la anthony removes wedding ring steps since split amid claims carmelo 'got another woman pregnant^kendra wilkinson files divorce hank baskett^kaley cuoco marries karl cook reveals news sweet black white instagram photo^kaley cuoco marries karl cook charming ceremony following seven month engagement^gossip girl actor patrick boll arrested undercover prostitution sting 'trying buy hooker 150^gossip girl actor patrick boll arrested undercover prostitution sting 'trying buy hooker 150^jennifer lawrence darren aronofsky plit huge age gap^jennifer lawrence darren aronofsky plit huge age gap^mila kunis makes monthly donation planned parenthood mike pence name^priyanka chopra nick jonas 'engaged^priyanka chopra nick jonas 'engaged^gwyneth paltrow reveals broke foot jimmy kimmel^meghan markle spotted first time since pippa middleton wedding touches texas^meghan markle spotted first time since pippa middleton wedding touches texas^jennifer lopez alex rodriguez 'already talking marriage two months dating^jennifer lopez alex rodriguez 'already talking marriage^breaking bad aaron paul wife lauren parsekian eecting first child together^taylor swift accused stalker sentenced years probation violating protective order^camille grammer awarded half ex husband kelsey retirement fund^wwe star vader dead age losing two year long battle congestive heart failure^arnold schwarzenegger returns home emergency open heart surgery^katharine mcphee david foster engaged^josh duhamel bikini clad eiza gonzalez pack pda enjoy loved vacation mexico^richard simmons hospitalized california 'battling severe indigestion^avicii ex girlfriend emily goldberg breaks silence death dj age oman^avicii ex girlfriend emily goldberg breaks silence death dj age oman^nick viall breaks silence split fiancee vanessa grimaldi five month engagement^counting on josiah duggar proposed lauren swanson six weeks courtship^taylor swift releases new song call it what you want^dancing with the stars kym johnson gives birth twins robert herjavec^'do n't worry 're gentle mariah carey shows cleavage ... takes twins swimming sharks^avengers infinity war everything need know seeing blockbuster^kylie jenner mother kris eresses urprise waking reports youngest child pregnant^kylie jenner mother kris eresses urprise waking reports youngest child pregnant,292,67,-225,359,0.8133704735376045,-0.6267409470752089,1
14934818,InStyle,2438,4421036,20536,223111,0,0,309,50,everybody,celebrities share tributes victims barcelona terror attack^happy birthday robertpattinson see cutest baby pic^john mayer hospitalized emergency appendectomy^wait second kyliejenner travisscott secretly get married^wait second kyliejenner travisscott secretly get married^lindsaylohan meme worthy dance mykonos long weekend mood^kimkardashian defends kyliejenner forbes cover says entire family self made^kimkardashian defends kyliejenner forbes cover says entire family self made^kyliejenner cuddles stormi sweet mother daughter swimsuit snap^angelinajolie abandoned favorite color opted second favorite neutral beige^so drama princesseugenie wedding date prince harry meghan markle^so drama princesseugenie wedding date prince harry meghan markle^so drama princesseugenie wedding date prince harry meghan markle^so drama princesseugenie wedding date prince harry meghan markle^so drama princesseugenie wedding date prince harry meghan markle^so drama princesseugenie wedding date prince harry meghan markle^so drama princesseugenie wedding date prince harry meghan markle^so drama princesseugenie wedding date prince harry meghan markle^priyankachopra not spill details meghanmarkle bridezilla but facial eression says^priyankachopra not spill details meghanmarkle bridezilla facial eression says all^priyankachopra not spill details meghanmarkle bridezilla but facial eression says^priyankachopra not spill details meghanmarkle bridezilla but facial eression says^kimkardashian redefined business casual white house^as angelina jolie brad pitt intense two year long divorce battle rages onward ca n't help wonder what^as angelina jolie brad pitt intense two year long divorce battle rages onward ca n't help wonder what^the definitive timeline prince harry meghan markle relationship^the definitive timeline princeharry meghanmarkle relationship^courteneycox got big break years friends even started^courteneycox got big break years friends even started^come way sex city without kim cattrall^tears gives update post split life josh duhamel^in september issue jenniferaniston shares 29 lipliner wearing nearly years and re^so uh jenniferaniston adamsandler holding hands exactly^here closer look meghan duchess sussex outfit today sleeveless trench dress canadian based label^juliaroberts meghanmarkle obsessed figure flattering jeans^johnkrasinski says found secret ingredient success emily blunt^johnkrasinski says found secret ingredient success emily blunt^georgeclooney year highest paid actor thanks tequila^courteneycox got big break years friends even started^courteneycox got big break years friends even started^confirmed part superbowl halftime show set list^confirmed part superbowl halftime show set list^angelinajolie abandoned favorite color opted second favorite neutral beige^leads support victims london terror attack^all members british royal family ranked net worth^all members british royal family ranked net worth^all members british royal family ranked net worth^all members british royal family ranked net worth^all members british royal family ranked net worth^all members british royal family ranked net worth^all members british royal family ranked net worth^all members british royal family ranked net worth^all members british royal family ranked net worth^all members british royal family ranked net worth^all members british royal family ranked net worth^all members british royal family ranked net worth^all members british royal family ranked net worth^all members british royal family ranked net worth^all members british royal family ranked net worth^all members british royal family ranked net worth^all members british royal family ranked net worth^all members british royal family ranked net worth^all members british royal family ranked net worth^all members british royal family ranked net worth^all members british royal family ranked net worth^all members british royal family ranked net worth^all members british royal family ranked net worth^all members british royal family ranked net worth^all members british royal family ranked net worth^all members british royal family ranked net worth^all members british royal family ranked net worth^all members british royal family ranked net worth^all members british royal family ranked net worth^the 98 dress absolutely need reesewitherspoon closet^here closer look meghan duchess sussex outfit today sleeveless trench dress canadian based label^georgeclooney year highest paid actor thanks tequila^juliaroberts meghanmarkle obsessed figure flattering jeans^taylorswift called kimkardashian bully stage opening night reputation world tour yesterday^taylorswift called kimkardashian bully stage opening night reputation world tour yesterday^taylorswift called kimkardashian bully stage opening night reputation world tour yesterday^taylorswift called kimkardashian bully stage opening night reputation world tour yesterday^taylorswift called kimkardashian bully stage opening night reputation world tour.^kimkardashian responds critics upset straightening northwest hair^fans pretty upset kimkardashian comments body here^kimkardashian responds critics upset straightening northwest hair^kimkardashian responds critics upset straightening northwest hair^kimkardashian responds critics upset straightening northwest hair^fans pretty upset kimkardashian comments body here^kimkardashian responds critics upset straightening northwest hair^meghanmarkle princeharry announced royal baby news princess eugenie wedding better^meghanmarkle princeharry announced royal baby news princess eugenie wedding better^meghanmarkle princeharry announced royal baby news princess eugenie wedding better^angelinajolie abandoned favorite color opted second favorite neutral beige^of course scott disick thoughts kourtneykardashian breakup^of course scott disick thoughts kourtneykardashian breakup^of course scott disick thoughts kourtneykardashian breakup^of course scott disick thoughts kourtneykardashian breakup^of course scott disick thoughts kourtneykardashian breakup^of course scott disick thoughts kourtneykardashian breakup^of course scott disick thoughts kourtneykardashian breakup^of course scott disick thoughts kourtneykardashian breakup^of course scott disick thoughts kourtneykardashian breakup^from princess diana jennifer aniston revenge dress real photographic proof^from princess diana jennifer aniston revenge dress real photographic proof^from princess diana jennifer aniston revenge dress real photographic proof^from princess diana jennifer aniston revenge dress real photographic proof^from princess diana jennifer aniston revenge dress real photographic proof^from princess diana jennifer aniston revenge dress real photographic proof^from princess diana jennifer aniston revenge dress real photographic proof^from princess diana jennifer aniston revenge dress real photographic proof^from princess diana jennifer aniston revenge dress real photographic proof^from princess diana jennifer aniston revenge dress real photographic proof^from princess diana jennifer aniston revenge dress real photographic proof^from princess diana jennifer aniston revenge dress real photographic proof^from princess diana jennifer aniston revenge dress real photographic proof^from princess diana jennifer aniston revenge dress real photographic proof^from princess diana jennifer aniston revenge dress real photographic proof^from princess diana jennifer aniston revenge dress real photographic proof^from princess diana jennifer aniston revenge dress real photographic proof^from princess diana jennifer aniston revenge dress real photographic proof^from princess diana jennifer aniston revenge dress real photographic proof^from princess diana jennifer aniston revenge dress real photographic proof^from princess diana jennifer aniston revenge dress real photographic proof^from princess diana jennifer aniston revenge dress real photographic proof^from princess diana jennifer aniston revenge dress real photographic proof^from princess diana jennifer aniston revenge dress real photographic proof^from princess diana jennifer aniston revenge dress real photographic proof^from princess diana jennifer aniston revenge dress real photographic proof^from princess diana jennifer aniston revenge dress real photographic proof^from princess diana jennifer aniston revenge dress real photographic proof^from princess diana jennifer aniston revenge dress real photographic proof^from princess diana jennifer aniston revenge dress real photographic proof^from princess diana jennifer aniston revenge dress real photographic proof^from princess diana jennifer aniston revenge dress real photographic proof^from princess diana jennifer aniston revenge dress real photographic proof^from princess diana jennifer aniston revenge dress real photographic proof^from princess diana jennifer aniston revenge dress real photographic proof^from princess diana jennifer aniston revenge dress real photographic proof^from princess diana jennifer aniston revenge dress real photographic proof^from princess diana jennifer aniston revenge dress real photographic proof^from princess diana jennifer aniston revenge dress real photographic proof^from princess diana jennifer aniston revenge dress real photographic proof^from princess diana jennifer aniston revenge dress real photographic proof^from princess diana jennifer aniston revenge dress real photographic proof^from princess diana jennifer aniston revenge dress real photographic proof^from princess diana jennifer aniston revenge dress real^from princess diana jennifer aniston revenge dress real photographic proof^from princess diana jennifer aniston revenge dress real photographic proof^why hodakotb revolutionary pick replace matt lauer^why hodakotb revolutionary pick replace matt lauer^katieholmes showing support boyfriend jamiefoxx subtle way^katieholmes showing support boyfriend jamiefoxx subtle way^angelinajolie abandoned favorite color opted second favorite neutral beige^times meghan markle kate middleton royal style twins via^kimkardashian says kanyewest warned date sex tape^kimkardashian says kanyewest warned date sex tape^kimkardashian says kanyewest warned date sex tape^kimkardashian says kanyewest warned date sex tape^kyliejenner boyfriend travisscott pleads guilty disorderly conduct week daughter stormi bor^timothee chalamet share smooch set new woody allen film^angelinajolie abandoned favorite color opted second favorite neutral beige^angelinajolie went hike kids chillest athleisure look^angelinajolie found easy stylish way wear summer dresses fall^angelinajolie abandoned favorite color opted second favorite neutral beige^meghanmarkle princeharry engaged adorable pda fraser island boardwalk^what meghan th birthday ask attending wedding prince harry good friend charlie van^meghanmarkle princeharry engaged adorable pda fraser island boardwalk^meghanmarkle princeharry engaged adorable pda fraser island boardwalk^meghanmarkle princeharry engaged adorable pda fraser island boardwalk^meghanmarkle princeharry engaged adorable pda fraser island boardwalk^turned ultimate celebrity crush^turned ultimate celebrity crush^turned ultimate celebrity crush^turned ultimate celebrity crush^turned ultimate celebrity crush^turned ultimate celebrity crush^turned ultimate celebrity crush^turned ultimate celebrity crush^turned ultimate celebrity crush^turned ultimate celebrity crush^turned ultimate celebrity crush^at khloekardashian n't revenge body she revenge life^katieholmes showing support boyfriend jamiefoxx subtle way^katieholmes showing support boyfriend jamiefoxx subtle way^angelinajolie bradpitt reportedly take custody battle trial^as angelina jolie brad pitt intense two year long divorce battle rages onward ca n't help wonder what^as angelina jolie brad pitt intense two year long divorce battle rages onward ca n't help wonder what^so cute sisters law nicole richie cameron diaz pose husbands epic family photo^so cute sisters law nicole richie cameron diaz pose husbands epic family photo^so cute sisters law nicole richie cameron diaz pose husbands epic family photo^so cute sisters law nicole richie cameron diaz pose husbands epic family photo^so cute sisters law nicole richie cameron diaz pose husbands epic family photo^so cute sisters law nicole richie cameron diaz pose husbands epic family photo^so cute sisters law nicole richie cameron diaz pose husbands epic family photo^so cute sisters laws nicole richie cameron diaz pose husbands epic family photo icymi^so cute sisters law nicole richie cameron diaz pose husbands epic family photo^so cute sisters law nicole richie cameron diaz pose husbands epic family photo^so cute sisters law nicole richie cameron diaz pose husbands epic family photo^so cute sisters laws nicole richie cameron diaz pose husbands epic family photo icymi^so cute sisters law nicole richie cameron diaz pose husbands epic family photo^so cute sisters law nicole richie cameron diaz pose husbands epic family photo^so cute sisters law nicole richie cameron diaz pose husbands epic family photo^so cute sisters law nicole richie cameron diaz pose husbands epic family photo^so cute sisters law nicole richie cameron diaz pose husbands epic family photo^so cute sisters law nicole richie cameron diaz pose husbands epic family photo^so cute sisters law nicole richie cameron diaz pose husbands epic family photo^so cute sisters law nicole richie cameron diaz pose husbands epic family photo^so cute sisters law nicole richie cameron diaz pose husbands epic family photo^so cute sisters law nicole richie cameron diaz pose husbands epic family photo^so cute sisters law nicole richie cameron diaz pose husbands epic family photo^so cute sisters law nicole richie cameron diaz pose husbands epic family photo^so cute sisters law nicole richie cameron diaz pose husbands epic family photo^so cute sisters law nicole richie cameron diaz pose husbands epic family photo^so cute sisters law nicole richie cameron diaz pose husbands epic family photo^so cute sisters law nicole richie cameron diaz pose husbands epic family photo^so cute sisters law nicole richie cameron diaz pose husbands epic family photo^so cute sisters laws nicole richie cameron diaz pose husbands epic family photo icymi^so cute sisters law nicole richie cameron diaz pose husbands epic family photo^so cute sisters law nicole richie cameron diaz pose husbands epic family photo^so cute sisters law nicole richie cameron diaz pose husbands epic family photo^so cute sisters law nicole richie cameron diaz pose husbands epic family photo^so cute sisters law nicole richie cameron diaz pose husbands epic family photo^so cute sisters law nicole richie cameron diaz pose husbands epic family photo^so cute sisters law nicole richie cameron diaz pose husbands epic family photo^so cute sisters law nicole richie cameron diaz pose husbands epic family photo^so cute sisters law nicole richie cameron diaz pose husbands epic family photo^so cute sisters law nicole richie cameron diaz pose husbands epic family photo^so cute sisters law nicole richie cameron diaz pose husbands epic family photo^so cute sisters law nicole richie cameron diaz pose husbands epic family photo^so cute sisters law nicole richie cameron diaz pose husbands epic family photo^so cute sisters law nicole richie cameron diaz pose husbands epic family photo^so cute sisters law nicole richie cameron diaz pose husbands epic family photo^so cute sisters law nicole richie cameron diaz pose husbands epic family photo^so cute sisters law nicole richie cameron diaz pose husbands epic family photo^so cute sisters law nicole richie cameron diaz pose husbands epic family photo^so cute sisters law nicole richie cameron diaz pose husbands epic family photo^so cute sisters law nicole richie cameron diaz pose husbands epic family photo^so cute sisters law nicole richie cameron diaz pose husbands epic family photo^so cute sisters law nicole richie cameron diaz pose husbands epic family photo^so cute sisters law nicole richie cameron diaz pose husbands epic family photo^so cute sisters law nicole richie cameron diaz pose husbands epic family photo^so cute sisters law nicole richie cameron diaz pose husbands epic family photo^so cute sisters laws nicole richie cameron diaz pose husbands epic family photo icymi^so cute sisters law nicole richie cameron diaz pose husbands epic family photo^so cute sisters laws nicole richie cameron diaz pose husbands epic family photo icymi^so cute sisters laws nicole richie cameron diaz pose husbands epic family photo icymi^so cute sisters law nicole richie cameron diaz pose husbands epic family photo^so cute sisters law nicole richie cameron diaz pose husbands epic family photo^so cute sisters law nicole richie cameron diaz pose husbands epic family photo^so cute sisters law nicole richie cameron diaz pose husbands epic family photo^so cute sisters law nicole richie cameron diaz pose husbands epic family photo^so cute sisters law nicole richie cameron diaz pose husbands epic family photo^so cute sisters law nicole richie cameron diaz pose husbands epic family photo^so cute sisters law nicole richie cameron diaz pose husbands epic family photo^so cute sisters law nicole richie cameron diaz pose husbands epic family photo^so cute sisters law nicole richie cameron diaz pose husbands epic family photo^so cute sisters law nicole richie cameron diaz pose husbands epic family photo^so cute sisters law nicole richie cameron diaz pose husbands epic family photo^so cute sisters law nicole richie cameron diaz pose husbands epic family photo^so cute sisters law nicole richie cameron diaz pose husbands epic family photo^so cute sisters law nicole richie cameron diaz pose husbands epic family photo^so cute sisters law nicole richie cameron diaz pose husbands epic family photo^so cute sisters law nicole richie cameron diaz pose husbands epic family photo^so cute sisters law nicole richie cameron diaz pose husbands epic family photo^so cute sisters law nicole richie cameron diaz pose husbands epic family photo^so cute sisters law nicole richie cameron diaz pose husbands epic family photo^so cute sisters law nicole richie cameron diaz pose husbands epic family photo^so cute sisters law nicole richie cameron diaz pose husbands epic family photo^so cute sisters law nicole richie cameron diaz pose husbands epic family photo^so cute sisters law nicole richie cameron diaz pose husbands epic family photo^so cute sisters law nicole richie cameron diaz pose husbands epic family photo^so cute sisters law nicole richie cameron diaz pose husbands epic family photo^so cute sisters law nicole richie cameron diaz pose husbands epic family photo^so cute sisters law nicole richie cameron diaz pose husbands epic family photo^so cute sisters law nicole richie cameron diaz pose husbands epic family photo^so cute sisters law nicole richie cameron diaz pose husbands epic family photo^so cute sisters law nicole richie cameron diaz pose husbands epic family photo^so cute sisters law nicole richie cameron diaz pose husbands epic family photo^so cute sisters law nicole richie cameron diaz pose husbands epic family photo^so cute sisters law nicole richie cameron diaz pose husbands epic family photo^so cute sisters law nicole richie cameron diaz pose husbands epic family photo^so cute sisters laws nicole richie cameron diaz pose husbands epic family photo icymi^so cute sisters law nicole richie cameron diaz pose husbands epic family photo^so cute sisters law nicole richie cameron diaz pose husbands epic family photo^angelinajolie reportedly new man life^angelinajolie reportedly new man life^justintheroux finally breaks silence divorce jenniferaniston^justintheroux finally breaks silence divorce jenniferaniston^justintheroux finally breaks silence divorce jenniferaniston^justintheroux finally breaks silence divorce jenniferaniston^justintheroux finally breaks silence divorce jenniferaniston^justintheroux finally breaks silence divorce jenniferaniston^meghanmarkle princeharry announced royal baby news princess eugenie wedding better^from first public handhold invictus games royal wedding kiss see princeharry and^meghanmarkle princeharry announced royal baby news princess eugenie wedding better^meghanmarkle princeharry announced royal baby news princess eugenie wedding better^brad pitt angelina jolie royal tea party prince william princess kate^dennisquaid admitted could n't deal megryan career success marriage^dabbled acting modeling tongue cheek mixed media artwork led he^kyliejenner might return spotlight right baby^kendall jenner confesses kept lot dad caitlyn secrets mom kris^shows incredible bikini body one brand newest swimsuits^bikini body proves n't aged bit^shows incredible bikini body one brand newest swimsuits^shows incredible bikini body one brand newest swimsuits^shows insane bikini body sizzling vacation snaps^feeling empowered completing treatment anxiety^kendalljenner wore cutest 50 jeans mall brand^you pack carry bag like kendalljenner^here help victims mass shooting las vegas^here help victims mass shooting las vegas^courtney love says warned women hollywood harvey weinstein back^celine dion cancels las vegas concerts undergo surgery^celine dion cancels las vegas concerts undergo surgery^styles announces solo world tour dates here going^icymi styles announces solo world tour dates here going^pink covers beautiful issue accompanied two biggest fans kids^westworld tessathompson says attracted women men also addressed rumors janelle mo^it official rose byrne pregnant second child^big congrats order engaged long time girlfriend cherry seaborn^we want someone kiss us like allison janney kissed kate winslet hollywood film awards^engaged boyfriend zandy reich^the bachelor bekah m. elains landed missing persons list^timmcgraw collapses onstage ireland^miss north dakota cara mund crowned miss america^celebrities fashion trends thought would never make comeback^hugh grant eecting fifth child girlfriend anna eberstein^beloved dog samantha cloned twice and photos blow mind^congratulations sam claflin wife laura haddock the couple eecting baby^major congrats order rachel mcadams reportedly pregnant first child^rachel mcadams reportedly pregnant first child^rachel mcadams reportedly pregnant first child^portia de rossi says steven seagal unzipped pants audition^reportedly pregnant first child^reportedly pregnant first child get details^gossip girl star ed westwick accused sexual assault third woman^here matt damon thinks ben affleck enormous back tattoo^kim kardashian shares first solo photo baby chicago kanye west^kim kardashian shares first solo photo baby chicago kanye west^kaleycuoco marries karlcook jaw dropping lace dress cape^it official alicia vikander michael fassbender married^john stamos eecting first child fianc e caitlin mchugh^prince william reveals earned street cred father prince george^introducing hollywood newest power couple nickjonas priyankachopra the two engaged two months o^found first ever golden globes nomination terrifying way^the weeknd ca n't keep hands coachella^the weeknd ca n't keep hands coachella^the weeknd ca n't keep hands coachella^it official joins thevoice season coach^joins season coach^irina shayk bradley cooper welcome first child together see every celeb baby born^rebecca gayheart files divorce eric dane years marriage^here first look ryan murphy new series starring amp jessica lange via^here jennifer aniston since split justin theroux^jennifer aniston makes first public appearance since justin theroux split^jennifer aniston makes first public appearance since justin theroux split^best sister moments instagram nationalsiblingsday^things need know taylor swift new boyfriend joe alwyn^joe co hosts mika brzezinski joe scarborough engaged,309,50,-259,359,0.8607242339832869,-0.7214484679665738,1
45564482,NYMag,867,1798360,14118,160387,0,38,270,10,the ideas people cultural currents forever reshaping world subscribe for subscription questions contact,"in first tv interview trump attorney rudy giuliani contradicted president stories potential^in first tv interview trump attorney rudy giuliani contradicted president stories potential^rudy giuliani made president sound guilty this week george stephanopoulos^rudy giuliani appeared 'this week george stephanopoulos gave another eye opening interview^fox amp friends host abby huntsman referred president dictator live news broadcast sunday m^jeffrey tambor accuser van barnes says actor spied naked^hannibal buress might play teacher spider man homecoming stop actor playing hooky^amazon officially cut jeffrey tambor transparent investigation sexual harassment claims aga^amazon officially cut jeffrey tambor transparent investigation sexual harassment claims aga^pulling ads steve rannazzisi actor lied /11 escape^meet tom holland actor chosen play next spider man^as terry crews sues wme agent adam venit sexual assault actor says family tracked possib^women accused dustin hoffman sexual misconduct come forward thank john oliver confronting the^as terry crews sues wme agent adam venit sexual assault actor says family tracked possib^would like reintroduce profiles actor unlikely style icon makes h^questions the actor bestselling author misses new york slime^would like reintroduce profiles actor unlikely style icon makes h^the look book actor writer illustrator dinner theater star^amazon officially cut jeffrey tambor transparent investigation sexual harassment claims aga^the th anniversary showing wag dog grew tense hbo host actor argued hoffman alleged^last night silicon valley christopher evan welch last the actor died lung cancer december^two women accused james franco sexual misconduct detailed actor alleged inappropriate behavior^jeffrey tambor accuser van barnes says actor spied naked^so actor playing native hawaiian hero new world war ii movie^james franco absolutely harvey weinstein two franco accusers spoken eerie^arts culture minutes with paul bettany the evolution actor can t find god plays darwin put ...^dustin hoffman accusers publicly addressed actor alleged sexual misconduct he abusive h^in new memoir sally field says sexually abused stepfather actor stuntman jock mahoney^jeffrey tambor accuser van barnes says actor spied naked^in new memoir sally field says sexually abused stepfather actor stuntman jock mahoney^kevin costner new moves the actor stepping into racial politics with black white^two days robert deniro anti trump tonyawards speech president responded calling actor punchy a^in new memoir sally field says sexually abused stepfather actor stuntman jock mahoney^jeffrey tambor accuser van barnes says actor spied naked^after domestic abuse allegations gary oldman resurfaced week actor son penned letter defendin^kevin costner new moves the actor stepping into racial politics with black white^the victims however could still potentially sue actor estate civil court^almost lost thegetdown alexjung talks actor^see inside gramercy park apartment design world art lighting guru^dating sometimes exhausting time results nothing i need remember i^rt the surprising thing barely need apply pressure write more^paulie gee slice shop takes inspiration new york best pizzerias^g rard depardieu accused rape sexual assault year old actress dancer^a true nightmare scenario^all episodes thewire ranked worst best^watch ariana grande sing natural woman backed aretha franklin celebration choir^for vaunted populism president trump filled contempt average people general sup^the cleanse supposed unlock elusive g spot orgasms turn act sex spiritual eerien^through voice voice aretha lifted millions inspiring empowering vulnerable dow^i know i beautiful strong powerful goddess worthy love respect i know i discovered noa^why friends set delrusso wishing could hand dating life someone e^when drink wine salty white cheddar popcorn 'll find personal happy place^sex eventually happened m felt like opposite death i fell back sheets laughed.^these hottest restaurants new york right^here five useful ways manage worst aspects perfectionistic personality traits^the man absolutely man i married^for many elevator rides mean daily confrontations fear anxiety even hampered life^some people scared actually watch horror movies read films wikipedia pages instead here^here honored queen soul today^students might still find way nation future kleptocracy present writes^a cornered donald trump midterm defeat could dangerous things fast kilgore writes^the white house withhold ,000 pages documents brett kavanaugh tenure lawyer th^i wish i could stop caring much i could go work job come home stop thinking abo^ask money mom i afford divorce rich husband^here new netflix september including blackpanther new season americanvandal^this coffee shop provides free drinks university students exchange personal data share com^sign newsletter every political compulsive read featuring top stories day plus exclu^see inside gramercy park apartment design world art lighting guru^why gop incapable offering voters credible solutions contemporary challenges^digs bedding trend taken life^being sports fan compromise ethics much willing tolerate decision every fan ha^it true little galette looker but despite significant amount filling incinerated^the year old monkey mondays bite victim fine even need stitches carrabba forced t^morning routine^rt i tested different pairs sneakers course last six years^here rundown four republican dominated states medicaid ballot november^take look inside gorgeously decorated turrets new york city^dating sometimes exhausting time results nothing i need remember i^there one really abusive act three ministers held six half hours screaming i^here leaving netflix september including forgetting sarah marshall version a star is b^women blowouts recurring arguments long simmering tensions significant ov^the fbi arrested california man earlier today threatening kill employees boston globe pap^french actor g rard depardieu accused rape sexual assault year old actress dancer^it focus individual reporter feelings new busybody journalism distinguishes writ^we know meghan markle nickname prince harry^president trump spent labor day weekend engaging golfing venting spleen online^i know i beautiful strong powerful goddess worthy love respect i know i discovered noa^prepare say goodbye mr robot^the sex diary year old enjoying sex new city^some say savior others say ruins lives but i stop thinking pores^meghan markle going secret trips summer including recent visit see friends toronto^askpolly am i kidding is smart way proceed i see^for vaunted populism president trump filled contempt average people general sup^earlier today president trump threatened withdraw u.s. wto^why even active adults feel changed lifestyle eating habits may gain little weight year^padma lakshmi recommended supporting comedians actually funny harassed women gave l^did i create myth chinatown myth create^she wears leather jacket even summer^michael cohen made 7 million earlier month unloaded stake two manhattan apartment buildings^rt including less official state shoe colorado^why gop incapable offering voters credible solutions contemporary challenges^the confirmation hearings supreme court nominee brett kavanaugh next week sure lull anyone paying cl^what careers women louis c.k harassed here 've said actions affected th^the final tally many times sacha baron cohen says wife whoisamerica^a federal judge ruled daca could continue major win dreamers huge loss trump ad^rt i pretty much forget moment i put and sign truly good und^this mess i glad hear actively job searching long term solution^what relationship ex valuable salvage form^hunter point south gives new yorkers something hardly knew needed turns crucial roman^people seaside town bexhill sea say repeatedly terrorized aggressive paraglider^investigates^serena williams bodysuit recently banned french open hardly first time woman athlete^tests seven brands offerings wearing work bed night vacation^rt because n't really want go way ikea^the reasons proactively include people criminal records jobs guarantee program moral prac^woody allen 'a rainy day new york may never see light day^donald trump michael cohen cooked plan buy national enquirer entire treasure trove trump gossi^lady gaga top inspirational diva form promotes astarisborn venice^since end summer marked start pageant season members navajo nation^police say shackled woman last week haunting doorbell video victim domestic violence that^even familiar chiara ferragni a.k.a the blonde salad really know wedding^president trump went eternally embattled jeff sessions today deigning indict members party^we assembled panel wine loving basics eert sommeliers taste canned wines determine w^these seven shocking stunts whoisamerica^ponytails consider dressing halloween looking stand crowd meghans harr^brett kavanaugh supreme court confirmation hearings full doublespeak abortion elains h^it easy overweight balding jewish schizophrenic living among smi vs new york prison sys^this coffee shop provides free drinks university students exchange personal data share com^rt from titanium pearl infused^if encounter sword guy big coastal city know i sex^she plays like normal behavior tech i would totally get i older e^a cornered donald trump midterm defeat could dangerous things fast kilgore writes^a year old woman getting clothing allowance my parents basically insisted cutting even whe^in pajamas comfort couch i could use app almost like atlas give access worlds^everything need know eminem latest including pays homage beastie boys attacks cr^the white house withhold ,000 pages documents brett kavanaugh tenure lawyer th^talking fuzzy boundaries identity identity politics double edged nature o^a woman claims company tricked marrying stranger part training wedding planner^sharpobjects ends radical message motherhood female rage writes^a look happening never ending saga brad pitt angelina jolie divorce^it focus individual reporter feelings new busybody journalism distinguishes writ^we 're seeing evidence elizabeth warren prepping presidential run moving significantly^jerry seinfeld anti talk show made us voyeurs lives comedians see ones top charts which^instead keeping popular promises helped get elected trump instead adopted unpopular stances of^according rigorous new study ,975 people died aftermath hurricane maria number dwarfs the^i lot hand holding sometimes client call ask 'what social security number can se^bill clinton among speakers aretha franklin funeral friday afternoon former president leng^here absolute best steak frites new york^the trump administration assembled secret committee combat recent wave positive press weed gott^i today tell faceless bullies i shamed quitting i ashamed^our ultimate sex playlist great seasons vibes^tests pair underwear claims fight bacteria thus odor^a new entry online dating hall nightmares^we 're seeing evidence elizabeth warren prepping presidential run moving significantly^martha stewart new tote bags hold gallons pounds whatever want put a^to lucky love need replace squirm inducing fear settling exciting idea investi^beto o rourke shied away discussing arrest drunk driving but new report claims th^rt the founder she like us also stress eats giant bag delicious che^rt we 'll adding actually good deals find^why gop incapable offering voters credible solutions contemporary challenges^whoisamerica flawed mostly entertaining occasionally near genius test shameless certain america^these hottest restaurants new york right^since end summer marked start pageant season members navajo nation^even strategy avoid ghosted ways make little less awful^pete davidson kept proposal simple^people think emotion absolutely true we feel way turned^the fbi arrested california man thursday threatening kill employees boston globe paper le^louis ck matt lauer clueless ever women hurt writes^more evidence goats truly qualified man new best friend^do i confront i worried also losing patience feeling disrespected^sex eventually happened m felt like opposite death i fell back sheets laughed.^police say shackled woman last week haunting doorbell video victim domestic violence that^breaking massive new york times pesticide report incredibly important like fruits and^the story extremely heartwarming vows column starts year old adopted man inspired se^here new netflix september including blackpanther new season americanvandal^the design hunter point south redeems wasteland formed construction rubble left desolate for^some pixar movies work better others trying something special.^jeff goldblum problem internet collective crush^rt we asked red lipstick greens supplement sun hat swears^in years following demise first love i found often repeating dad advice friends it^mytwocents i freelancer what i 20,000 savings^a woman discusses decided try getting pregnant husband ill feels like a^askpolly i deal friends drama^lady gaga somehow chill invasion personal space says found bare faced useful acting^the reasons include people criminal records job guarantee program moral practical.^since end summer marked start pageant season members navajo nation^we make way stairs bust bedroom door jim even take shirt i^these interview questions common foolish prepare here answer^these hottest restaurants new york right^ariana grande pete davidson shy kissing public they 're also shy talking kissin^sometime middle night aretha franklin underwent outfit change switched pastel blu^here new netflix september including blackpanther new season americanvandal^we sat kids elained people think marriage means love one person we^askaboss one co workers brings daughter work every day driving crazy^the story extremely heartwarming vows column starts year old adopted man inspired se^these days medicated andrew goldstein quite wrap head around psychotic andrew goldstein did^a conversation director steve james new starz docuseries looks racial inequity chic^the purpose trump rose garden videos simple they make trump feel believes look good.^mytwocents i freelancer what i 20,000 savings^it true little galette looker but despite significant amount filling incinerated^dives separates good underwear great^looking recent study found online daters tend pursue people slightly league^these absolute best chinese restaurants new york^this introduction kelly it everything could possibly need know one nightmare^a cornered donald trump midterm defeat could dangerous things fast kilgore writes^president trump probably find top notch lawyers avoid making legal missteps but course^hailey baldwin paying attention negative attention come way since justin bieber proposed^we know meghan markle nickname prince harry^the design hunter point south redeems wasteland formed construction rubble left desolate for^midterm campaigns entering fall anxious ever looming threats email phishing text hackin^michael cohen made 7 million earlier month unloaded stake two manhattan apartment buildings^askpolly why women obsess babies fertility^the purpose trump rose garden videos simple they make trump feel believes look good.^rt lots goodies good night sleep^these seven shocking stunts whoisamerica^rt a veteran runner best best including old favorites newer pairs from^she wears leather jacket even summer^i pancake ingredients listed fingers i actually regret tattoo i t^watch trailer season wildly popular drama thegooddoctor^the bottom line i paying sex it prostitution which feels really odd clinical think about.^on maps available number apps including snapchat weather channel citibike vandals changed new y^this facial reputation painful leaves grown women tears tried^the design hunter point south redeems wasteland formed construction rubble left desolate for^here leaving netflix september including forgetting sarah marshall version a star is b^the man absolutely man i married^why gop incapable offering voters credible solutions contemporary challenges^arresteddevelopment famously packed gags meant reward hawk eyed fans we 've compiled nearly^every spike lee film ranked worst best^donald trump michael cohen cooked plan buy national enquirer entire treasure trove trump gossi^a recent study found online daters tend pursue people slightly league^why yes twitter i would like improve timeline^this coffee shop provides free drinks university students exchange personal data share com^a number shows summer either drew big crowd managed generate sizable levels buzz critical ac^lady gaga somehow chill invasion personal space says found bare faced useful acting^in edition how i got this baby woman acts like parent one^soda sales tanking boom times seltzer writes^these best askpolly columns self esteem advice^here notable scenes speeches john mccain memorial washington d.c^for vaunted populism president trump filled contempt average people general sup^andrew goldstein thought going gets prison^a woman elains dates recently divorced dads^the gop elites icy disposition toward president trump slowly melted stages first year half i^police say shackled woman haunting doorbell video victim domestic violence boyf^a curated collection dishes drinks events absolutely agenda september^a curated collection dishes drinks events absolutely agenda september^sex eventually happened m felt like opposite death i fell back sheets laughed.^the reasons proactively include people criminal records jobs guarantee program moral prac^water sex sounds exciting theory highly overrated^rt as great queen beyonce says pretty hurts^askpolly i caught lifelong rut close friend family relationships one longer working^watch joe biden emotional eulogy memorial service john mccain phoenix^we spoke dozen papa john owners workers most say changes corporate made wak^here thing casual sex one ever wants admit almost always bad here casual sexting is^lady gaga top inspirational diva form promotes astarisborn venice^comicsgate seen growing tidal wave reactionary hatred directed toward women minorities comic^books anxious person know might find illuminating insightful even life changing^what careers women louis c.k harassed here 've said actions affected th^for vaunted populism president trump filled contempt average people general sup^an intolerance uncertainty linked anxiety depression here get better tolerating^dozens pink cadillacs filled streets outside aretha franklin funeral^andrew gillum appeal young african american voters helped spring upset florida democratic prim^on maps available number apps including snapchat weather channel citibike vandals changed new y^our ask boss columnist responds letters readers confronting unhappiness work^mytwocents i freelancer what i 20,000 savings^sharpobjects wild ending rise angry women wait hit messag^in consider data determine celebrity summer^people seaside town bexhill sea say repeatedly terrorized aggressive paraglider^the sex diary year old enjoying sex new city^everything need know eminem latest including pays homage beastie boys attacks cr^she one night stand morning leaves first^book winners take all jeremiad philanthropy know^in week issue our annual fall preview featuring directorial debut plus look seas^see inside gramercy park apartment design world art lighting guru^i 'the monied spouse eyes law played differently i anticipated^the coalition crushed john mccain rebellion south carolina prevailed ever since writ^if wish honor john mccain wartime sacrifice must remember less example kind heroism^remembrances aretha franklin smokey robinson bill clinton others^rt thigh chafing one things everyone embarrassed talk i get human^i feel so itchy i sweaty i diagnosed sweat allergy without googling whether possibl^sometime middle night aretha franklin underwent outfit change switched pastel blu^these three main ways make money instagram^other coke bottles removed rectum i removed tapeworms jewelry coins paper bills iphones^jeff goldblum problem internet collective crush^the heist film long beloved hollywood staple these best according^what careers women louis c.k harassed here 've said actions affected th^based early critical response neil armstrong biopic first man looks like might film this^katie couric slams today matt lauer completely unacceptable workplace harassment^brad pitt bid k watch episode game thrones emilia clarke^brad pitt bid k watch episode game thrones emilia clarke^where justin timberlake performance rank list best superbowl halftime shows spoiler ve^add lady gaga super bowl halftime show list real life events thesimpsons accurately predicted^where justin timberlake performance rank list best superbowl halftime shows spoiler ve^where justin timberlake performance rank list best superbowl halftime shows spoiler ve^chlo grace moretz outraged marketing campaign movie red shoes amp dwarfs^kim kardashian wore thong dates back also born kim sister kylie jenner^kim kardashian wore thong dates back also born kim sister kylie jenner^meghan markle nephew created new strain cannabis ahead famous aunt royal wedding^mariah carey believes botched new year performance sabotaged they foiled^jessica simpson gives birth son ace knute johnson^why jennifer aniston justin theroux break that weekly gossip column^why jennifer aniston justin theroux break that weekly gossip column^why jennifer aniston justin theroux break that weekly gossip column^why jennifer aniston justin theroux break that weekly gossip column^the ashlee simpson show became beacon showing act feel year old internal compass had^the ashlee simpson show became beacon showing act feel year old internal compass had^the ashlee simpson show became beacon showing act feel year old internal compass had^selena gomez reportedly psychiatric facility admitted last month suffering emotio^selena gomez reportedly psychiatric facility admitted last month suffering emotio^girls come end recaps series finale^donald trump reportedly almost played president sharknado sharknado future living^donald trump reportedly almost played president sharknado sharknado future living^donald trump reportedly almost played president sharknado sharknado future living^oh irony cynthia nin delayed subway tuesday way try fix subway^oh irony cynthia nin delayed subway tuesday way try fix subway^blac chyna granted temporary restraining order rob kardashian^a look best royal wedding dresses time grace kelly princess diana^a look best royal wedding dresses time grace kelly princess diana^a look best royal wedding dresses time grace kelly princess diana",270,48,-222,318,0.8490566037735849,-0.6981132075471698,1
16345202,CosmopolitanUK,1134,361063,2550,200218,0,0,192,71,subscription question cosmo.co.uk,reese witherspoon teased first legally blonde details^reese witherspoon teased first legally blonde details^reese witherspoon teased first legally blonde details^blac chyna request trademark 'angela kardashian denied^chris pratt officially files divorce anna faris^this kate middleton left hospital quickly giving birth^this kate middleton left hospital quickly giving birth^this kate middleton left hospital quickly giving birth^this kate middleton left hospital quickly giving birth^things selena gomez get body^things selena gomez get body^things selena gomez get body^kanye west tweeting texts caitlyn jenner amid feud kim kardashian^kanye west tweeting texts caitlyn jenner amid feud kim kardashian^kanye west tweeting texts caitlyn jenner amid feud kim kardashian^a definitive timeline miley cyrus liam hemsworth relationship^a definitive timeline miley cyrus liam hemsworth relationship^a definitive timeline miley cyrus liam hemsworth relationship^a definitive timeline miley cyrus liam hemsworth relationship^a definitive timeline miley cyrus liam hemsworth relationship^a definitive timeline miley cyrus liam hemsworth relationship^a timeline miley cyrus liam hemsworth relationship^a definitive timeline miley cyrus liam hemsworth relationship^a definitive timeline miley cyrus liam hemsworth relationship^a definitive timeline miley cyrus liam hemsworth relationship^a definitive timeline miley cyrus liam hemsworth relationship^a definitive timeline miley cyrus liam hemsworth relationship^a definitive timeline miley cyrus liam hemsworth relationship^kanye west gave kim kardashian 1million taking certain brand deal^kanye west gave kim kardashian 1million taking certain brand deal^kanye west gave kim kardashian 1million taking certain brand deal^a definitive timeline prince harry meghan markle relationship^a definitive timeline prince harry meghan markle relationship^a definitive timeline prince harry meghan markle relationship^a definitive timeline prince harry meghan markle relationship^a definitive timeline prince harry meghan markle relationship^is real reason jennifer aniston justin theroux split^is real reason jennifer aniston justin theroux split^is real reason jennifer aniston justin theroux split^this real reason tess ward dumped harry styles apparently^fergie josh duhamel split years marriage^fergie josh duhamel split years marriage^kim kardashian reportedly embarrassed kanye west pro trump rant snl^kim kardashian reportedly embarrassed kanye west pro trump rant snl^kim kardashian reportedly embarrassed kanye west pro trump rant snl^kim kardashian reportedly embarrassed kanye west pro trump rant snl^how duchess cambridge maternity leave prince louis different others^how duchess cambridge maternity leave prince louis different others^how duchess cambridge maternity leave prince louis different others^how duchess cambridge maternity leave prince louis different others^how duchess cambridge maternity leave prince louis different others^the crown season reportedly cast young prince charles^the crown confirm play prince charles queen mother third season^the crown confirm play prince charles queen mother third season^kate a rod split kate hudson reportedly dumped madonna reported ex alex rodriguez alex rodriguez obviously ...^lady gaga reveals heartbreaking reason split taylor kinney^lady gaga reveals heartbreaking reason split taylor kinney^here everyone thinks justin bieber hailey baldwin already got married^here everyone thinks justin bieber hailey baldwin already got married^here everyone thinks justin bieber hailey baldwin already got married^here everyone thinks justin bieber hailey baldwin already got married^justin bieber selena gomez timeline relationship^justin bieber selena gomez timeline relationship^justin bieber selena gomez timeline relationship^justin bieber selena gomez timeline relationship^justin bieber selena gomez timeline relationship^justin bieber selena gomez timeline relationship^justin bieber selena gomez timeline relationship^justin bieber selena gomez timeline relationship^justin bieber selena gomez timeline relationship^justin bieber selena gomez timeline relationship^justin bieber selena gomez timeline relationship^justin bieber selena gomez timeline relationship^justin bieber selena gomez timeline relationship^justin bieber selena gomez timeline relationship^justin bieber selena gomez despite reportedly marrying hailey baldwin^justin bieber selena gomez despite reportedly marrying hailey baldwin^justin bieber selena gomez despite reportedly marrying hailey baldwin^justin bieber selena gomez despite reportedly marrying hailey baldwin^rachel weisz daniel craig interesting love story^rachel weisz daniel craig interesting love story^rachel weisz daniel craig interesting love story^kim kardashian left delightfully thirsty comment kanye west instagram^kim kardashian left delightfully thirsty comment kanye west instagram^kim kardashian left delightfully thirsty comment kanye west instagram^kim kardashian left delightfully thirsty comment kanye west instagram^has caitlyn jenner offered 1million star celebrity big brother^has caitlyn jenner offered 1million star celebrity big brother^uh oh kourtney kardashian revealed son mason jealous kim daughter north west^has caitlyn jenner offered 1million star celebrity big brother^has caitlyn jenner offered 1million star celebrity big brother^brody jenner says 'hurt surprised dad caitlyn n't attend wedding^brody jenner says 'hurt surprised dad caitlyn n't attend wedding^brody jenner says 'hurt surprised dad caitlyn n't attend wedding^brody jenner says half sisters kendall kylie n't bother rsvp wedding^kylie jenner mourns damaged hair 'destroyed bleach^kylie jenner mourns damaged hair 'destroyed bleach^kanye west tweeting texts caitlyn jenner amid feud kim kardashian^khloe kardashian ditches tristan thompson name anniversary card^khloe kardashian ditches tristan thompson name anniversary card^khloe kardashian ditches tristan thompson name anniversary card^khloe kardashian ditches tristan thompson name anniversary card^dakota johnson chris martin definitely dating^dakota johnson chris martin definitely dating^dakota johnson chris martin definitely dating^dakota johnson chris martin definitely dating^katy perry threw major shade taylor swift american idol^katy perry threw major shade taylor swift american idol^a celeb divorce guru reveals details brad pitt angelina jolie carefully crafted divorce strategy^a celeb divorce eert reveals new details brad pitt angelina jolie carefully crafted divorce strategy^a celeb divorce guru reveals new details brad pitt angelina jolie carefully crafted divorce strategy^jennifer aniston john mayer back together^khloe kardashian seems well truly shut tristan thompson marriage rumours^khloe kardashian seems well truly shut tristan thompson marriage rumours^khloe kardashian seems well truly shut tristan thompson marriage rumours^khloe kardashian seems well truly shut tristan thompson marriage rumours^kate middleton wore zara jeans safari world freaking^rob kardashian suing ex fianc e blac chyna assault^blac chyna suing rob entire kardashian family 'for getting reality show rob amp chyna axed^a celeb divorce guru reveals details brad pitt angelina jolie carefully crafted divorce strategy^a celeb divorce eert reveals new details brad pitt angelina jolie carefully crafted divorce strategy^a celeb divorce guru reveals new details brad pitt angelina jolie carefully crafted divorce strategy^daniel craig rachel weisz welcome first child together^ryan seacrest texted kris jenner ask kylie pregnancy live tv wrote back^meghan markle could n't excited priyanka chopra nick jonas engagement^meghan markle could n't excited priyanka chopra nick jonas engagement^meghan markle could n't excited priyanka chopra nick jonas engagement^meghan markle could n't excited priyanka chopra nick jonas engagement^kylie jenner could look bored ryan reynolds met gala tried^khloe kardashian reportedly asked tristan thompson watch cheating kuwtk said^khloe kardashian reportedly asked tristan thompson watch cheating kuwtk said^khloe kardashian reportedly asked tristan thompson watch cheating kuwtk said^khloe kardashian live tweeting reaction watching kuwtk cheating ep^niall horan hailee steinfeld a timeline relationship^nick jonas priyanka chopra a timeline relationship^cheryl liam payne timeline relationship^justin bieber selena gomez timeline relationship^cheryl liam payne timeline relationship^cara delevingne ashley benson a timeline relationship^jennifer lopez alex rodriguez a timeline relationship^jennifer lopez alex rodriguez a timeline relationship^emma stone andrew garfield timeline relationship^selena gomez the weeknd timeline relationship^taylor swift joe alwyn a timeline relationship^selena gomez the weeknd timeline relationship^selena gomez the weeknd timeline relationship^justin bieber selena gomez timeline relationship^katy perry orlando bloom timeline relationship^taylor swift joe alwyn timeline relationship^cara delevingne ashley benson a timeline relationship^cheryl liam payne timeline relationship^cara delevingne ashley benson a timeline relationship^niall horan hailee steinfeld a timeline relationship^justin bieber selena gomez timeline relationship^ariana grande pete davidson timeline relationship^selena gomez the weeknd timeline relationship^ariana grande pete davidson timeline relationship^chris pratt anna faris timeline relationship^justin bieber selena gomez timeline relationship^bella hadid the weeknd timeline relationship^nick jonas priyanka chopra a timeline relationship^justin bieber selena gomez timeline relationship^brooklyn beckham chlo grace moretz a timeline relationship^brooklyn beckham chlo grace moretz a timeline relationship^nick jonas priyanka chopra a timeline relationship^cheryl liam payne timeline relationship^justin bieber selena gomez timeline relationship^justin bieber selena gomez timeline relationship^taylor swift joe alwyn a timeline relationship^brooklyn beckham chlo grace moretz a timeline relationship^taylor swift tom hiddleston timeline short relationship^niall horan hailee steinfeld a timeline relationship^ariana grande pete davidson timeline relationship^taylor swift joe alwyn a timeline relationship^niall horan hailee steinfeld a timeline relationship^selena gomez the weeknd timeline relationship^justin bieber selena gomez timeline relationship^ariana grande pete davidson timeline relationship^jennifer lopez alex rodriguez a timeline relationship^cara delevingne ashley benson a timeline relationship^justin bieber selena gomez timeline relationship^cheryl liam payne timeline relationship^nick jonas priyanka chopra a timeline relationship^justin bieber selena gomez timeline relationship^why kylie jenner reportedly wo n't spotlight gives birth rumoured baby^why kylie jenner reportedly wo n't spotlight gives birth rumoured baby^why kylie jenner apparently wo n't spotlight gives birth rumoured baby^katy perry threw major shade taylor swift american idol^katy perry threw major shade taylor swift american idol^kendall jenner anwar hadid spotted 'cosying apparently^chris pratt anna faris timeline relationship^selena gomez reportedly mental health facility hospitalised emotional breakdown^love actually behind scenes red nose day us update sarah^enrique iglesias anna kournikova welcome twins^enrique iglesias anna kournikova welcome twins^enrique iglesias anna kournikova welcome twins^people think empty seat royal wedding princess diana^people think empty seat royal wedding princess diana^people think empty seat royal wedding princess diana^people think empty seat royal wedding princess diana^david schwimmer wife zoe buckman confirm taking time apart^david schwimmer wife zoe buckman confirm taking time apart^ed sheeran says not engaged girlfriend cherry seaborn^ed sheeran announced engaged girlfriend cherry seaborn^ed sheeran says not engaged girlfriend cherry seaborn^ed sheeran announced engaged girlfriend cherry seaborn^ed sheeran announced engaged girlfriend cherry seaborn^why prince harry meghan markle delayed honeymoon^why prince harry meghan markle delayed honeymoon^why prince harry meghan markle delayed honeymoon^why prince harry meghan markle delayed honeymoon^karlie kloss accidentally revealed princess beatrice secret instagram account world^karlie kloss accidentally revealed princess beatrice secret instagram account world^karlie kloss accidentally revealed princess beatrice secret instagram account world^karlie kloss accidentally revealed princess beatrice secret instagram account world^karlie kloss accidentally revealed princess beatrice secret instagram account world^meghan markle dad reportedly attend royal wedding palace asks understanding^bella thorne says sexually abused age^bella thorne says sexually abused age^bella thorne says sexually abused age^the best beauty looks golden globes^the best beauty looks golden globes^the best beauty looks golden globes^the best beauty looks golden globes^in case wondering thackery binx hocus pocus looks like^in case wondering thackery binx hocus pocus looks like^in case wondering thackery binx hocus pocus looks like^in case wondering thackery binx hocus pocus looks like^in case wondering thackery binx hocus pocus looks like^in case wondering thackery binx hocus pocus looks like^in case wondering thackery binx hocus pocus looks like^in case wondering thackery binx hocus pocus looks like^karlie kloss engaged joshua kushner picture cute^karlie kloss engaged joshua kushner picture cute^karlie kloss engaged joshua kushner picture cute^jennifer lawrence darren aronofsky reportedly split^jennifer lawrence darren aronofsky reportedly split^jennifer lawrence darren aronofsky reportedly split^taylor swift music video director boldly declares beyonc copied 'bad blood^are priyanka chopra nick jonas engaged^are priyanka chopra nick jonas engaged^princess charlotte net worth prince george^princess charlotte net worth prince george^meghan markle prince harry n't sit together pippa middleton wedding^cameron diaz elains disappeared hollywood^fergie josh duhamel split years marriage^fergie josh duhamel split years marriage^katy perry addresses plastic surgery rumors reveals procedures done^emilia clarke says filming daenerys final game of thrones scene f**ked^emilia clarke says filming daenerys final game of thrones scene f**ked^emilia clarke says filming daenerys final game of thrones scene f**ked^emilia clarke says filming daenerys final game of thrones scene f**ked^scott disick still insanely jealous kourtney kardashian boyfriend younes bendjima^scott disick still insanely jealous kourtney kardashian boyfriend younes bendjima^scott disick still insanely jealous kourtney kardashian boyfriend younes bendjima^scott disick still insanely jealous kourtney kardashian boyfriend younes bendjima^kylie jenner still missing kardashian christmas card countdown ...^kylie jenner still missing kardashian christmas card countdown but reason^kylie jenner still missing kardashian christmas card countdown ...^all signs channing tatum jenna dewan headed split^all signs channing tatum jenna dewan headed split^all signs channing tatum jenna dewan headed split^chris pratt officially files divorce anna faris,192,71,-121,263,0.7300380228136882,-0.4600760456273764,1
26020465,ETCanada,12445,369725,2471,264535,0,3,138,114,the nation entertainment powerhouse set pace breaking news in-depth profiles exclusives anyone else weeknights :30,cbs issues statement houseguest angela racist remarks spark controversy days season of^in tiff18 interview fahrenheit119 filmmaker wonders ivankatrump may vi^in tiff18 interview fahrenheit119 filmmaker wonders ivankatrump may vi^stop holding comedians standard stop our job make ugliest stuff funny^stands fellow comedians^the 20 million herpes lawsuit filed usher dismissed^the 20 million herpes lawsuit filed usher dismissed^tonight first photos baby girl haven plus robert pattinson back toronto^watch reflects dinner made realize former marriage miserable^watch reflects miserable marriage krishumphries played role^caitlyn jenner halloween costume maker refuses stop selling product despite recent backlash it funny^caitlyn jenner halloween costume maker refuses stop selling product despite recent backlash it funny^crushing bradpitt he single^crushing bradpitt he single^uploaded hilarious video dancing like lindsay lohan^uploaded hilarious video dancing like lindsay lohan^cradles baby bump attending ffany gala plus star spotting^played another prank^played another prank^gave million dollar cheque advising turn sponsorship deal f^gave million dollar cheque advising turn sponsorship deal f^with week half go royal wedding 're taking look prince harry meghan markle^it love right start ... meghanmarkle princeharry relationship timeline^oprah shares gwyneth paltrow first podcast amp stedman graham rarely seen together^it strange i never wanted baby find changed angelina jolie mind^it saved much gwen stefani finding blake shelton split^vanity fair hits back angelina jolie claims parts cover story 'false upsetting'^continues prove quite prankster^played another prank^do think looks like tennis player the rest internet thinks so.^played another prank^justin bieber slams hollywoodlife claims site 'untruthful hurtful^slams hollywoodlife claims site untruthful and hurtful^video fergie talks life split josh duhamel balancing music motherhood^fergie talks life split josh duhamel amp balancing music motherhood^still refuses believe amp leaving^angelina jolie accuses brad pitt paying enough child support^katie couric opening sexual misconduct scandal surrounding former today co host matt lauer^jerryoconnell slays ifeelitcoming ontario karaoke bar^watch jerryoconnell jerryminor parody steveharvey memo help^watch jerryoconnell dances young irish dancers stpatricksday^watch jerryoconnell gets stpaddysday spirit^george clooney reveals family morning routine new bts latest ad thequest natalie d^emilyblunt cast junglecruise workout poke fun^emilyblunt way much fun working^troianbellisario mourns loss best friend baby months pregnant^troianbellisario mourns loss best friend baby months pregnant^rubyrose opens health crisis elains may seeing use wheelchair fans flood twitter^rubyrose opens health crisis elains may seeing use wheelchair fans flood twitter^amp share how they stay in shape^bradpitt go rehab despite tabloid reports source says^brad pitt go rehab despite tabloid reports source says^watch kanyewest hospital saint pablo tour put hold indefinitely^brad pitt jennifer lawrence leonardo dicaprio quentin tarantino among stars fighting money owed weins^angelinajolie reportedly fighting bradpitt request joint custody six children^another royalbaby way congratulations prince harry meghan markle^bradpitt revs official starter year lemans24 race^video brad pitt amp join jason statham race track^brad pitt turns race car driver weekend see pics^video brad pitt hits race track amp talks doc 'hitting the apex^kristen stewart admits dating co star robert pattinson thought public enemy.^dapper vincevaughn wife hit red carpet plus stars spotted venicefilmfestival^why matthew mcconaughey telling americans time us embrace donald trump^nicole kidman donald trump we as a country need to support whoever the president^find took selena gomez followed person^sources claim benaffleck lindsayshookus split year dating^ben affleck lindsay shookus split year dating^sources claim benaffleck lindsayshookus split year dating^find primetime hunk play boyfriend new movie second act^denies dating justin bieber new interview says they 've friends years^despite reports hailee steinfeld dating justin bieber^it took dakotajohnson months preparation dance scenes suspiria remake^it took months preparation dakotajohnson dance scenes suspiria remake^vanity fair hits back angelina jolie claims parts cover story 'false upsetting'^mileycyrus says regrets naked wrecking ball music video^hodakotb anchors host first megynkelly official departure^hodakotb host first megynkelly official departure^cradles baby bump attending ffany gala plus star spotting^the weeknd tells album changed following split selena gomez i want perform something tha^caitlyn jenner attending brody jenner wedding bali kendall amp kylie^shots fired apparent drive set tekashi69 kanyewest video beverly hills^at least shots fired apparent drive set tekashi69 kanyewest video beverly hills^watch katy perry reaction americanidol hopeful confesses loves taylor swift^blake shelton calls meeting gwen stefani 'a miracle 'hitting rock bottom^angelinajolie releases statement relieved investigation bradpitt child abuse claims ended^angelinajolie releases statement relieved investigation bradpitt child abuse claims ended^brad pitt rumored love interest neri oxman addresses romance reports first time^brad pitt rumoured love interest neri oxman setting record straight^from julia roberts nicole kidman lady gaga 're rounding anticipated actresses coming to^juliaroberts husband dannymoder say goodbye summer^angelina jolie breaks silence brad jlo talks drake liveonfacebook^notoriously private angelinajolie breaks silence divorce bradpitt talks putting family first 'gma^video angelina jolie breaks silence divorce pitt parenting skills^engaged to boyfriend matt rutler^gwen stefani addresses rumors blake shelton getting married^nicole kidman kids pumped role aquaman sdcc2018^watch nicole kidman superhero role aquaman plus highlights trip sdcc^this minute aquaman trailer nicole kidman amber heard jason momoa epic^video jason momoa opens monumental role aquaman including working alongside tal^source claims rumours kimkardashian ready divorce kanyewest true^source claims rumours kimkardashian ready divorce kanyewest true^kanyewest told date kimkardashian sex tape reality show kuwtk^kimkardashian says people told kanyewest date someone sex tape reality television show^kim kardashian reveals kanye west advised date sex tape^update reveals yandhi album delayed november missing origin^selenagomez co stars rebeccahall donate salaries woodyallen movie charitabl^report woodyallen new movie starring selenagomez timotheechalamet indefinitely shelved^from julia roberts nicole kidman lady gaga 're rounding anticipated actresses coming to^juliaroberts husband dannymoder say goodbye summer^celebrities share mother day well wishes twitter^emmastone gushes lalaland co star^emmastone imagine life without^oliviacolman amp emmastone discuss sex scene thefavourite^kendall jenner khloe kardashian shop around guns latest keeping up with the kardashians^spokesperson angelinajolie denies report splitting lawyer custody battle with^sharon osbourne slams angelina jolie ongoing battle brad pitt^bradpitt angelinajolie reportedly heading court prepare take custody battle trial^amid ongoing custody battle brad pitt spends fathersday london kids angelina jolie visits^trending tonight bradpitt angelinajolie headed court finalize custody battle kids^spokesperson angelinajolie denies report splitting lawyer custody battle with^bradpitt angelinajolie reportedly heading court prepare take custody battle trial^katie couric opening sexual misconduct scandal surrounding former today co host matt lauer^christina aguilera hits voice shuts gwen stefani rumour^kid pics rebecca romijn jerry oconnell*s twins^christina aguilera hits voice shuts gwen stefani rumour^blake shelton calls meeting gwen stefani 'a miracle 'hitting rock bottom^carey mulligan talks husband marcus mumford yawning prince harry meghan markle royal wedding^princeharry reveals moment asked princecharles walk meghanmarkle aisle royalwedding^a new doc reveals moment prince harry asked father walk meghan markle aisle royalwedding^carey mulligan spoken attending prince harry meghan markle royal wedding^kim kardashian opened fights kanye west last night kuwtk^davidbeckham also opens parenting lessons learned years^thecrown doctorwho star mattsmith play role charlesmanson charliesays^doctorwho thecrown star mattsmith stars charlesmanson charliesays^justin theroux speaks success married life jennifer aniston battle tabloids^wendywilliams calls kim kardashian stealing spotlight kylie jenner baby video^celebs including ariana grande bill clinton tyler perry jennifer hudson faith hill gather detroit^icymi watch powerful tribute aretha^watch katy perry reaction americanidol hopeful confesses loves taylor swift^watch talks feeling empowered set cover shoot^selenagomez seeks mental health treatment following emotional breakdown^gigi hadid poses boyfriend zayn malik 'vogue amp answers mag questions^lifetime found prince harry amp meghan markle find play royalcouple^mel b sister slams stephen belafonte abuse claims you sorry excuse man^princess eugenie engaged jack brooksbank marry church prince harry amp meghan markle^princess eugenie engaged jack brooksbank pair marry church prince harry meghan markle^oscarisaac reveals named son late mother^oscarisaac says named son late mother talks finding solace playing hamlet^kelly ripa says nobody better new co host live ryan seacrest^courtney love warned women harvey weinstein watch^amy schumer hospitalized 'horrible kidney infection^strangerthings officially renewed season^jada pinkett smith shuts tupac biopic alleyezonme calls reimagining hurtful^will jada pinkett smith admit longer call married emotional redtabletalk chat^laura prepon ben foster married^what think returning host oscars second year row^returning host oscars academyawards^jimmy kimmel opens returning host the academy awards sunday one year envelopegate oscars^david schwimmer wife zoe buckman taking time apart nearly seven years marriage^ed sheeran clarifies whether engaged girlfriend cherry seaborn^icymi engaged girlfriend cherry seaborn^former bachelor producer claims sexually harassed set warner brother responds^youtuber shanedawson apologizes really s***ty f***ing old jokes pedophilia emerge^congratulations starz revealed engaged see ring^justin theroux cancels late show appearance jennifer aniston split^kelly clarkson opens battle bulimia when i really skinny i wanted kill myself^kylie minogue says trademark battle kylie jenner n't personal^welcome first child^blake lively injured set 'the rhythm section production temporarily suspended^engaged boyfriend zandy reich see ring^bello joins tv hit show cbs series regular season^meghan markle arrives london pippa middleton wedding^update rep demilovato says singer awake family apparent overdose^actress paz de la huerta accuses harvey weinstein raping twice^jesus christ superstar nbc next live musical actors played jesus past^taylor swift helped homeless pregnant fan buy house^helped pregnant nearly homeless fan buy house^video host alex trebek opens recovering brain surgery^jenny slate joins chris evans family christmas^watch adam driver former marine surprise military family scholarship^sam smith admits 'obsessive weight 'my body image is always going be issue'^rachel mcadams welcomes first child boyfriend jamie linden report^says kim cattrall 'sex city comment left 'heartbroken^sarah jessica parker reveals kim cattrall 'sex city comment left 'heartbroken'^katie cassidy breaks silence father david death amp shares last words^watch jennifer lawrence hilariously take lie detector test^donates 1 million british anti sexual harassment campaign^donates 1.4 million anti sexual harassment campaign uk^donates 1 million british anti sexual harassment campaign^ariana grande mac miller break^congratulations rachelmcadams reportedly pregnant first child^rachel mcadams reportedly pregnant first child^vin diesel announces 'fast amp furious live tour^kermit frog getting new voice years^why elle king skipped wedding^'law amp order svu star diane neal running congress^we ca n't get enough two petedavidson make relationship instagram official^teases new song gets ready drop gorgeous midnight^louisck accused sexual misconduct five women iloveyoudaddy premiere cancelled^olympic gold medalist shawn johnson reveals suffered miscarriage heartbreaking video^jada pinkett smith responds leah remini scientology claims^chris evans jenny slate break months dating^jesse camp former mtv vj reported missing^annabelle neilson ladies london star dead^victoriassecret angel i take clothes anymore empty cause^victoria secret angel adriana lima i take clothes anymore empty cause^victoriassecret angel i take clothes anymore empty cause^announces 'the man woods tour kick toronto^seal sexual battery case rejected los angeles district attorney^prince william pays tribute victims manchester attack fa cup final^amp styles ca n't stop singing inappropriate times new skit^engaged joshua kushner^says wants marry celebrity crush frances mcdormand sweetest reason^wife lauren welcome first child see pics^michael fassbender alicia vikander married^it jennifer lawrence darren aronofsky split year dating^new couple alert nina dobrev glen powell dating^taylor swift music video director joseph kahn hits beyonce 'she copied bad blood^taylor swift music video director claims beyonce copied bad blood^how prince william earned street cred son prince george^george and amal clooney donate 1 million grant fight hate groups^george amal clooney donate 1 million grant fight hate groups^sophie turner admits still ca n't believe engaged joe jonas^'harry potter star matthew lewis marries angela jones^surpasses number youtube subscribers^responds halsey calling f**king moron interview^kim cattrall mourns late brother christopher memorial service^meghan markle makes first public appearance since pippa middleton wedding suits event texas^andrew garfield faces backlash saying interview 'i am gay man right now just without physical act^bradley cooper irina shayk welcome first child^icymi gameofthrones stars kit harington rose leslie married see wedding day pics^buffy vampire slayer star nicholas brendon arrested alleged domestic violence girlfriend^is sophia bush really leaving chicago pd seasons^brooke burke breaks silence divorce david charvet^kim kardashian attends year high school reunion see pics^former wwe star vader dead amp stars lost^wonderwoman london premiere cancelled manchester bombing^david foster katharine mcphee engaged^'the originals end season^lcd soundsystem synth superstar gavin russom comes transgender^geazy pleads guilty arrested assault cocaine possession sweden^icymi taylor swift announces new album reputation first song dropping tonight^jennifer aniston gives first major interview since split justin theroux^prince harry meghan markle reveal details behind non traditional wedding cake^the bachelor bekah martinez elains mom reported missing^tis season binge watching getting cozy front tv here picks watch netfli^richard simmons hospitalized 'severe indigestion rep told us today^video khloe kardashian reportedly ready move back los angeles newborn baby daughter n^is khloe kardashian ready start family canadian star tristan thompson^reveals ready marry canadian^lorde clarifies comments taylorswift girl squad calls dear friend^we 're looking forward seeing sagawards frontrunner margot robbie red carpet look tonight take look back at^meghan markle admits misses suits ahead show season premiere^happy rd birthday see model best moments instagram sister^kaley cuoco karl cook celebrate engagement disneyland see pics,138,117,-21,255,0.5411764705882353,-0.08235294117647059,1
28785486,ABC,539,14569703,57026,268431,7,213,8,17,all news information need see curated news team tips,"more federal complaint alleges suspect posted statement facebook page morning o^nyc bombing suspect allegedly wrote facebook alleged attack trump failed protect nation^morning alleged attack nyc bombing suspect wrote trump failed protect nation facebook accordi^she still us we need yet george h.w bush touching letter late daught^she still us we need yet george h.w bush touching letter late daught^more later today pres george h.w bush buried long hoped next wife barbara^they love former president george h.w bush still heartbroken death barbara bush when^director national intelligence dan coats says wishes pres trump made different statement russia e^new pres trump joint statement european commission pres jean claude juncker we agree today first of^nancy pelosi the attack rosenstein course attack mueller investigation what 're maki^sen. flake praises pompeo response possibility allowing kremlin question us officials that statement^officials investigating cases possible acute flaccid myelitis afm condition polio like sym^fertility rates declined u.s. women giving birth first time later later according^the centers disease control prevention alerting public asian longhorned tick species of^the centers disease control prevention alerting public asian longhorned tick species of^rudy giuliani says trump legal team close determining president agree interview w^pres trump personal attorney rudy giuliani says trump legal team close determining president^rudy giuliani says trump legal team close determining president agree interview w^this week george stephanopoulos airs p sunday wabc new york due nyc marathon tune and^this week george stephanopoulos airs p sunday wabc new york due nyc marathon tune and^the last jedi director rian johnson took twitter hit back internet trolls targeted actress kelly mar^pres trump former pres obama plan trips georgia week lend support state heated race^a south carolina dentist went beyond make patients smile week participating internet'^sen. blumenthal pres trump upcoming supreme court nomination the president outsourced decision to^authorities identified two women whose bodies bound together duct tape found floating along ne^the center disease control prevention put warning week say no to raw dough^alan dershowitz you question president motives president acts if presi^this week george stephanopoulos airs p sunday wabc new york due nyc marathon tune and^a mourner hugged pittsburgh police officer outside rodef shalom temple following funeral brothers cecil ro^sen. mazie hirono tells brett kavanaugh supreme court doubts court actuall^just in bill clinton thank law enforcement agencies responded week^years ago week rep. geraldine ferraro selected democratic presidential candidate walter mondale to^pres trump made least eight public statements week true supported known ev^senate majority leader mitch mcconnell says 'll voting brett kavanaugh week let make ver^globe trotting chef author tv host anthony bourdain worth 1.2 million died last month left mo^alan dershowitz frequent trump defender says mueller report devastating president it^rep. adam schiff murder jamal khashoggi it certainly testing proposition enemy e^rep. jerrold nadler says brett kavanaugh supreme court senate n't investigated h^rm twt tells nervous giving remarks unga earlier week my hands sh^gop sen. susan collins key vote trump scotus nominee says a candidate important position wo^jared polis could make history week first openly gay man win u.s. gubernatorial election.^kellyanne conway tells this week many women including saw brett kavanaugh someone politica^rudy giuliani congress going impeach somebody lying press come they do^starbucks raising price regular drip coffee week u.s. stores^justice kavanaugh seen tainted he seen somebody went seven fbi investig^tells summit pres trump kim jong un entirely different past d^the world longest cross sea bridge hong kong zhuhai macao bridge officially opens week the mile s^investigators frantically looking clues suspicious packages delivered two former democratic presi^raising the steaks knickers australian steer stands 4 gained internet fame week but dozer a^a long overdue library book finally returned week years checked out.^seven kangaroos removed temporarily florida wildlife officials home based sanctuary y^prince william set arrive israel palestinian territories week first official visit of^new court filings due week could offer road map mueller probe next steps^dnc chair tom perez says democrats absolutely defeat pres trump democratic victories w^firefighters video shows chopper flying low woolseyfire southern california killed le^at least people killed week flames raging wildfire engulfed vehicles homes n^u.s. mortgage rates jumped week highest level seven years trend pulling home sales a^if thought early snow think less inch snow fell stevens pass washington th^yanny versus laurel consumed internet ruined productivity offices everywhere week.^majority leader mitch mcconnell says senate vote brett kavanaugh week i 'm confident 'll hea^massachusetts police reportedly find three bodies home man arrested week connection beating and^anthony bourdain seemed 'cheerful work week says onlooker^former obama national security adviser susan rice says trump putin private meeting historic mistake^sen. mazie hirono says brett kavanaugh accusing democrats kind conspiracy bizar^new first lady melania trump plans visit another center housing migrants point week spokesperson^a sales representative found dead maryland model home week police say evidence scene indicate^timelapse video shows destructive woolseyfire spreading malibu seen venice beach miles^new hillary clinton elosive device sent new york residence i 'm grateful hard work commit^senate majority leader mitch mcconnell says 'll voting brett kavanaugh week let make very^democratic rep. luis gutierrez says pres trump immigration rhetoric meant energize political base ahea^in former sex worker catherine healy helped get prostitution decriminalized new zealand this week she^former obama national security adviser susan rice says trump putin private meeting historic mistake^ford launches initiative help save nation dwindling population honeybees six hives containing ,000^new state dept michael r. pompeo meeting officials democratic people republic korea sched^sen. mazie hirono says brett kavanaugh accusing democrats kind conspiracy bizar^sen. jeff flake fbi investigation brett kavanaugh i would liked started earlier h^drone video shows devastation wake flash floods hit ellicott city maryland neighborhood saw^then florida sheriff deputy n't rush building parkland massacre scheduled testify week^gop sen. james lankford says russia still attempting interfere u.s. elections regardless can^wildlife officials florida actively searching storm grey kangaroo reported missing earlier wee^the florida man allegedly killed four children shot police officer hours long standoff authoritie^water levels quickly dropping texas river soared flood stage week destroying bridge fo^trump personal attorney rudy giuliani says biases elored surrounding special counsel^the nba back action week and firing predictions^the senate vote nomination week senate majority leader mitch mcconnell says repeating sta^stunning timelapse video shows destructive woolseyfire spreading malibu seen venice beach about^rep. adam schiff says ought determine whether financial motives motiving president first fam^rnc chair ronna mcdaniel says absolutely resigned republicans losing house especially th^senate democrats really face toughest political map years remarkable 're strong po^raising the steaks knickers australian steer stands 4 gained internet fame week but dozer a^from hockney painting marie antoinette pearl record breaking collectibles auctioned week.^high list discussions israeli prime minister benjamin netanyahu likely pres trump at^nasa loses second spacecraft week spacecraft stopped communicating flight controllers.^two turkeys south dakota arrive room willard intercontinental hotel washington d.c. ahead t^rep. adam schiff murder jamal khashoggi it certainly testing proposition enemy e^new suspect arrested murder rapper xxxtentacion fatally shot south florida earlier week br^pres trump former pres obama planning trips georgia week lend support state hea^pres trump personal attorney rudy giuliani tells michael cohen cooperate gove^rep. adam schiff leading democrat house intelligence committee says pres trump business com^this week george stephanopoulos airs p sunday wabc new york due nyc marathon tune and^activist behind trump baby blimp eected fly parliament pres trump uk visit wee^live gov rick scott gives update preparations ahead hurricane michael forecast become maj^ford launches initiative help save nation dwindling population honeybees six hives containing ,000^a man currently sitting texas prison may among prolific serial killers u.s. history accordin^gop sen. susan collins pres trump list potential supreme court nominees there people list wh^fire officials release redacted audio call led demi lovato hospitalization earlier week.^sen. mazie hirono tells brett kavanaugh supreme court doubts court actuall^this week in pictures the incredible photographs past seven days^the allegheny county courthouse thronged yesterday demonstrators protesting death antwon rose jr.^the year old allegedly opened fire illinois high school week used gun purchased b^sen. bernie sanders says crisis mode climate change larry kudlow comments irresponsibl^white house releases photos pres trump north korean leader kim jong un week summit singapore.^sen. mazie hirono says brett kavanaugh accusing democrats kind conspiracy bizar^chris christie says way pres trump would pardon if president pardon h^kenyan authorities optimistic find italian woman kidnapped gunmen week national polic^new court filings due week could offer 'road map mueller probe next steps^u.s. long term mortgage rates steady slightly week highest levels nearly eight years a^bush family arrives joint base andrews escorting casket george h.w bush lie state washi^sen. lindsey graham sen. mazie hirono saying kavanaugh temperament would n't make fair impartial jud^storms italy kill two people raising death toll least heavy rains strong winds m^just in i feeling great amp look forward getting back home white house soon first lady melania trump tweets^a new book coauthored james patterson former pres bill clinton week^story world trade set open week following years delays^this week in history years ago arnold schwarzenegger elected governor california promising make th^leonard leo helped craft pres trump supreme court shortlist calls argument pres trump be^mother teen kidnapped front home earlier week pleads girl safe return saying s^a burglar attempt rob florida earlier week goes wrong cashier grabs pizza server ch^colin powell calls george h.w bush perfect american he perfect president ... he seen one of^jared polis could make history week first openly gay man win u.s. gubernatorial election.^the world longest cross sea bridge hong kong zhuhai macao bridge officially opens week the mile s^a man currently sitting texas prison may among prolific serial killers u.s. history accordin^republican sen. james lankford sits senate intelligence committee responds pres trump saying that^anti defamation league ceo jonathan greenblatt says encouraged pres trump condemned anti semitism b^story world trade set open week following years delays^life in pictures president john f. kennedy assassinated dallas texas week years the^a man currently sitting texas prison may among prolific serial killers u.s. history accordin^year old allegedly opened fire illinois high school week used gun purchased mother author^in midst tense diplomatic negotiations fate american pastor jailed turkey earlier this^new pres trump personal attorney rudy giuliani michael cohen as long tells truth 're home fre^alan dershowitz frequent trump defender says mueller report devastating president it^the world deadliest offshore oil disaster piper alpha elosion happened years week.^former obama homeland security secretary jeh johnson americans really listen leaders including p^rudy giuliani whether concerned michael cohen could flip pres trump i concerns michael^the world longest cross sea bridge hong kong zhuhai macao bridge officially opens week the mile s^anti defamation league ceo jonathan greenblatt says encouraged pres trump condemned anti semitism b^asked whether candidates pres trump supreme court shortlist likely opponents roe v. wade leonar^sen. jeff flake urges gop colleagues push back pres trump the judiciary stood well the^with economy strong wages rising unemployment near five decade low federal reserve remains tr^sen. lindsey graham defends brett kavanaugh performance hearing the temperament i saw man was^sen. lindsey graham called comments rudy giuliani made stormy daniels week inappropriate bottom lin^sen. jeff flake says republicans need take action climate change there things should^new nypd deputy commissioner suspicious package found morning manhattan post office the nypd bomb s^former secretary state james baker tells former pres george h.w bush peaceful passing^ken starr it likely paul manafort indicated counsel directly provide^globe trotting chef author tv host anthony bourdain worth 1.2 million died last month left mo^tells summit pres trump kim jong un entirely different past d^a long overdue library book finally returned week years checked out.^a burglar attempt rob florida earlier week goes wrong cashier grabs pizza server ch^sen. lindsey graham defends brett kavanaugh performance hearing the temperament i saw man was^jared polis could make history week first openly gay man win u.s. gubernatorial election.^sen. jeff flake calls pres trump rhetoric democrats unwillingness support border security bothersome.^meet peas carrots one receive official presidential pardon week their names ann^amazon launched new program week helps people united states start businesses deliv^five children two adults injured hit car tampa bus stop police say it least fifth tr^former trump homeland security adviser tom bossert fallout family separation this week been^i wish well pres trump says ruth bader ginsburg suffered fractured ribs fall week i hop^a gun salute greets casket former president george h.w bush joint base andrews maryland st^from hockney painting marie antoinette pearl four record breaking collectibles auctioned week^i want mom never feel pain antwon rose unarmed black teen killed pittsburgh police officer th^indonesian tv footage shows divers handing say black box lion air jet crashed i^latest michael strengthens hurricane churns gulf mexico forecast become major^as parent nothing terrifying kid go school feel safe em^rep. adam schiff says roger stone vulnerable charges lying congress it also looks like mr. stone was^sen. lindsey graham it clear something happened ms. ford ... troubled somethi^a long overdue library book finally returned week years checked out.^former appalachian coal miners supporters washington week urge lawmakers extend tax be^roger stone there circumstance i would testify president becaus^the second egypt three famed pyramids giza set open tourists week completion res^gop sen. susan collins discussion pres trump scotus nominee i told i looking^do view justice brett kavanaugh legitimate justice sen. mazie hirono he going on^rep. jerrold nadler said brett kavanaugh confirmed supreme court justice house i^story world trade set open week following years delays^pres trump calls cabinet members draw proposals cut spending agency budgets the call^alec baldwin made return saturday night live week show tackled insanity kanye^starbucks raising price regular drip coffee week u.s. stores^new republican national committee selects charlotte north carolina host convention we look forward to^hillary clinton arrives hofstra university first presidential debate debates^pres trump addressed several familiar themes campaign first address joint session congress^senate majority leader mitch mcconnell issues statement executive order signed pres trump i glad pr^pres trump hugged american flag conclusion remarks national federation independent busi^pres trump hugged american flag conclusion remarks national federation independent busi^officials investigating cases possible acute flaccid myelitis afm condition polio like sym^fertility rates declined u.s. women giving birth first time later later according^the centers disease control prevention alerting public asian longhorned tick species of^director atlanta based centers disease control prevention changes stance abstinence.^the centers disease control prevention alerting public asian longhorned tick species of^the best person ever really beloved doctor among shooting victims chicago hospital^people evacuate hospital chicago police say multiple victims including police officer inj^happening now vigil held chicago hospital shooting victims^latest chicago fire department spokesman says suspect hospital shooting dead three victims including off^just in pres trump signs new executive order protection nation foreign terrorist entry into^watch live vice president biden deliver statement rose garden^alert news special report vice president biden makes statement rose garden^just in vice president biden deliver statement rose garden :10 pm est^coming up former pres obama returns campaign trail two weeks midterm elections appearing a^happening now pres trump holds campaign rally las vegas nevada^watch live pres trump holds campaign rally las vegas^george w. bush this is year an hour long interview rd president via hoover institution^years heroism vietnam war retired marine sgt maj. john l. canley receives medal ho^years heroism vietnam war retired marine sgt maj. john l. canley receives medal ho^outgoing ohio gov john kasich tells considering run president trump se^outgoing ohio gov john kasich tells considering run president trump se^live sec state mike pompeo holds press briefing white house^one two turkeys appealing thanksgiving pardon pres trump appears white house press briefi^new press sec sarah sanders give camera press briefing :30 p.m. white house says.^one turkeys hoping pardon pres trump later today made appearance white house press bri^starting now press sec sarah sanders holds white house press briefing amid continued fallout pres trump s^you said something podium was accurate press sec sarah sanders questioned multiple times du^read transcript exclusive interview former trump attorney fixer michael cohen^happening now pres trump delivers remarks electrical contractor convention philadelphia.^katie couric breaks silence longtime former 'today co host matt lauer sexual misconduct alleg^kanye west apologized wednesday chicago radio station calling slavery choice broke air^best selling japanese author haruki murakami hosting special radio show featuring favorite songs he^dancing with stars judge carrie ann inaba host miss america competition amid turmoil th^oprah winfrey actively considering running president close friend gayle king says.^oprah winfrey actively considering running president close friend gayle king says.^i shaking whole time mother tasha ofordu daughter taejah describe excited meet prin^i wish i father meghan markle duchess sussex speaks first time since missing her^family actor bill paxton files wrongful death lawsuit california hospital surgeon operated o^family actor bill paxton files wrongful death lawsuit california hospital surgeon operated o^david spade donates 100,000 mental health organization following sister law kate spade death.^david spade donates 100,000 mental health organization following sister law kate spade death.^james franco denies sexual misconduct allegations the things i heard twitter accurate.^magical harry potter river cruise set sail summer^new julia louis dreyfus awarded st annual mark twain prize american humor^all money world director ridley scott n't completely surprised kevin spacey allegations space^eat pray love author elizabeth gilbert partner rayya elias dies battling cancer^i regretted i really wanted walk aisle father meghan markle duchess sussex br^law amp order svu star diane neal running congress new york^first look wonder woman reveals chris pine character steve trevor still alive.^new supreme court declines hear appeal brendan dassey whose murder conviction subject netfli^after big oscars night allison janney went right back day job showing oscar statue scrip^nathaniel glover also known rapper kidd creole arrested charged fatal stabbing homeless ma^all details prince harry meghan markle wedding rings^every giraffe produced win species april giraffe gained prominence live stream",15,230,215,245,0.061224489795918366,0.8775510204081632,0
17895820,Daily_Express,619,796663,3335,682766,0,3,145,90,home daily sunday eress,ukweather forecast met office issues yellow warning ahead scorching weekend^chicago hospital shooting multiple victims gunman opens fire^the fortnite week challenges live here find haunted hills treasure best way visit^meghan markle wedding dress aimed 'bring joy austere life stella mccartney^talk press meghan markle prince harry shock warning friends^prince harry meghan markle relationship timeline pictures photos romance^prince harry meghan markle relationship timeline pictures photos love^prince harry meghan markle relationship timeline pictures photos love^prince harry meghan markle relationship timeline pictures photos romance^prince harry meghan markle relationship timeline pictures photos romance^prince harry meghan markle relationship timeline pictures photos romance^prince harry meghan markle relationship timeline pictures photos romance^prince harry meghan markle relationship timeline pictures photos love^prince harry meghan markle relationship timeline pictures^prince harry meghan markle relationship timeline pictures photos romance^prince harry meghan markle relationship timeline pictures photos romance^prince harry meghan markle relationship timeline pictures photos love^prince harry meghan markle relationship timeline pictures^prince harry meghan markle relationship timeline pictures photos romance^prince harry meghan markle relationship timeline pictures photos romance^prince harry meghan markle relationship timeline pictures photos love^prince harry meghan markle relationship timeline pictures photos love^prince harry meghan markle relationship timeline pictures photos love^prince harry meghan markle relationship timeline pictures photos romance^prince harry meghan markle relationship timeline pictures photos romance^prince harry meghan markle the royal couple relationship timeline^prince harry meghan markle relationship timeline pictures^prince harry meghan markle relationship timeline pictures photos love^prince harry meghan markle relationship timeline pictures photos love^prince harry meghan markle the royal couple relationship timeline^prince harry meghan markle relationship timeline pictures photos love^prince harry meghan markle relationship timeline pictures photos romance^prince harry meghan markle relationship timeline pictures photos love^prince harry meghan markle the royal couple relationship timeline^james bond is this real reason danny boyle quit daniel craig last movie^james bond daniel craig revealed biggest boozer new stats jamesbond danielcraig^fergie josh duhamel confirm shock split eight years marriage^meghan markle duchess sussex reveals one trick staying happy^meghan markle pregnant mother doria ragland happy become grandmother meghanmarkle royalbaby^meghan markle pregnant mother doria ragland happy become grandmother royalbaby meghanandharry meghan^meghan markle duchess sussex reveals one trick staying happy^meghan markle sister speaks out royal baby news include dad i won t happy^meghan markle duchess sussex reveals one trick staying happy^kate middleton what title duchess cambridge prince william king^kate middleton what title duchess cambridge prince william king^kate middleton broke royal protocol new zealand official tour^kate middleton the duchess cambridge surprising link kim kardashian^you never guess high street shop duchess cambridge used work ...^kate middleton the duchess cambridge surprising link kim kardashian^kate middleton what title duchess cambridge prince william king^kate middleton the duchess cambridge surprising link kim kardashian^the crown true shock book supports prince charles 'absolute hell gordonstoun^thecrown recreate iconic prince charles moment^thecrown season cast update who play prince charles^thecrown season cast update who play prince charles^thecrown recreate iconic prince charles moment new pictures netflix drama^the crown true shock book supports prince charles 'absolute hell gordonstoun^new fears benaffleck quitting batman director and star walk away whole dceu^new fears benaffleck quitting batman director and star walk away whole dceu^britney spears terrified fan storms stage las vegas 'he got gun^britney spears terrified fan storms stage las vegas 'he got gun^britney spears terrified fan storms stage las vegas 'he got gun^britney spears terrified fan storms stage las vegas 'he got gun^britney spears terrified fan storms stage las vegas 'he got gun^charmed actress shannen doherty shares frank post results breast cancer marker test results elevated i^what amal clooney net worth^see george clooney staggering hourly earnings amal clooney net worth revealed^what amal clooney net worth george clooney stunning wife worth this sum^what amal clooney net worth the human rights lawyer worth this sum^see hollywood a lister george clooney staggering hourly earnings amal clooney net worth revealed^what amal clooney net worth george clooney wife worth this staggering sum^the long goodbye irina shayk gives bradley cooper farewell kiss leaving london^fifty shades darker jamie dornan leaves dakota johnson behind new movie fiftyshades^fifty shades darker dominatrix slams critics jamie dornan dakota johnson hit^fifty shades darker great news dakota johnson jamie dornan unrated version^'they 're barely talking eva mendes ryan gosling 'on verge split^royal silence thomas markle claims meghan cut him off since paparazzi scandal^thecrown cast season update sophie turner princess diana here evidence^thecrown cast season update sophie turner princess diana here evidence^thecrown cast season update sophie turner princess diana here evidence^the crown season who play princess diana thecrown^kate middleton pregnant duchess eecting twins baby bump bigger previous births^is kate middleton twins do double births run royal family^kate middleton pregnant duchess eecting twins baby bump bigger previous births^is kate middleton twins do double births run royal family^kate middleton pregnant duchess eecting twins baby bump bigger previous births^is kate middleton twins do double births run royal family^is kate middleton twins do double births run royal family^is kate middleton twins do double births run royal family^royal baby will kate middleton prince william twins^is kate middleton twins do double births run royal family^meghan harry set travel country threat zika virus sign baby plans hol^meghanmarkle father hits royal family urging break the silence thomasmarkle^meghanmarkle father hits royal family urging break the silence thomasmarkle^meghan markle pregnancy drama brother writes urging duchess contact father^meghanmarkle father hits royal family urging break the silence thomasmarkle^james blunt hit back royal wedding viewer asked invited wedding prince harry and^new bbc drama motherfatherson starring richard gere currently production here latest ...^prince harry meghan markle moving next door beckhams cotswolds house^prince harry meghan markle moving next door beckhams cotswolds house^prince harry meghan markle moving next door beckhams cotswolds house^prince harry meghan markle moving in kensington palace apartment together meghanmarkle^prince harry meghan markle moving next door beckhams cotswolds house^prince harry meghan markle moving next door beckhams cotswolds house^prince harry meghan markle moving in kensington palace apartment together^prince harry meghan markle moving next door beckhams cotswolds house^prince harry meghan markle moving next door beckhams cotswolds house^prince harry meghan markle moving next door beckhams cotswolds house^prince harry meghan markle moving next door beckhams cotswolds house^prince harry meghan markle moving next door beckhams cotswolds house^prince harry meghan markle moving next door beckhams cotswolds house^prince harry meghan markle moving next door beckhams cotswolds house^prince harry meghan markle moving next door beckhams cotswolds house^my trousers tight prince william shock confession prince harry^are meghan markle prince harry heading us sources say meghan excited show harry around^are meghan markle prince harry going us meghan 'excited show harry around^mission impossible fallout reviews stupefyingly awesome like mad max fury road^mission impossible fallout reviews stupefyingly awesome like mad max fury road^fans begging know kim kardashian shared adorable message new mum khloe kardashian^jennifer aniston justin theroux split celebrity breakups divorces pictures^as jennifer aniston announces divorce justin theroux take look famous exes^why sporty kate middleton banned marathons royal rule revealed^sir billy connolly wife pamela stephenson brands sir michael parkinson 'daft couple hit back claims comedi^pamela stephenson brands sir michael parkinson 'daft sir billy connolly hits back claims struggling to^billy connolly struggling recognise pals living parkinson pal sir michael parkinson reveals^sir billy connolly wife pamela stephenson brands sir michael parkinson 'daft couple hit back health claims^sir billy connolly struggling recognise friends amid parkinson battle billyconnolly^pamela stephenson calls sir michael parkinson 'daft sir billy connolly responds claims struggling r^why queen warn prince harry meghan markle behaviour royal wedding^fifty shades darker jamie dornan leaves dakota johnson behind new movie fiftyshades^fifty shades darker dominatrix slams critics jamie dornan dakota johnson hit^fifty shades darker great news dakota johnson jamie dornan unrated version^heidi klum flaunts incredible bikini body showers tomboy vito schnabel floral look^heidi klum flaunts incredible bikini body showers tomboy vito schnabel floral look^heidi klum flaunts incredible bikini body showers tomboy vito schnabel floral look^heidi klum flaunts incredible bikini body showers tomboy vito schnabel floral look^heidi klum flaunts incredible bikini body showers tomboy vito schnabel floral look^heidi klum flaunts incredible bikini body showers tomboy vito schnabel floral look^heidi klum flaunts incredible bikini body showers tomboy vito schnabel floral look^heidi klum flaunts incredible bikini body showers tomboy vito schnabel floral look^heidi klum flaunts enviable bikini body continues loved european holiday^kim kardashian leaves nothing imagination victoria secret halloween outfit^kim kardashian leaves nothing imagination victoria secret halloween outfit^angelina jolie brad pitt fans devastated waxworks separated madame tussauds^angelina jolie brad pitt fans devastated waxworks separated madame tussauds^angelina jolie brad pitt fans devastated waxworks separated madame tussauds^missing meghan markle prince harry royal couple set appear very soon^meghan markle missing piece harry jigsaw according astrologist says royals destine^ladies london star annabelle neilson cause death revealed found dead age^ladies london star annabelle neilson cause death revealed found dead age^suspect dedrick d. williams arrested murder rapper xxxtentacion shot dead florida age^breaking sam shepard dead oscar nominated actor pulitzer prize winner passes away^breaking sam shepard dead oscar nominated actor pulitzer prize winner passes away^breaking sam shepard dead oscar nominated actor pulitzer prize winner passes away^breaking sam shepard dead oscar nominated actor pulitzer prize winner passes away^breaking sam shepard dead oscar nominated actor pulitzer prize winner passes away^hugh grant 'eecting fifth child seven years girlfriend anna eberstein^hugh grant 'eecting fifth child seven years girlfriend anna eberstein^hugh grant 'eecting fifth child seven years girlfriend anna eberstein^hugh grant 'eecting fifth child seven years girlfriend anna eberstein^hugh grant 'eecting fifth child seven years girlfriend anna eberstein^hugh grant 'eecting fifth child seven years girlfriend anna eberstein^hugh grant 'eecting fifth child seven years girlfriend anna eberstein^hugh grant 'eecting fifth child seven years girlfriend anna eberstein^hugh grant 'eecting fifth child seven years girlfriend anna eberstein^hugh grant 'eecting fifth child seven years girlfriend anna eberstein^hugh grant 'eecting fifth child seven years girlfriend anna eberstein^hugh grant 'eecting fifth child seven years girlfriend anna eberstein^hugh grant 'eecting fifth child seven years girlfriend anna eberstein^hugh grant 'eecting fifth child seven years girlfriend anna eberstein^hugh grant 'eecting fifth child seven years girlfriend anna eberstein^erin moran dead happy days stars lead heartbreaking tributes actress dies aged^erin moran dead happy days stars lead heartbreaking tributes actress dies aged^erin moran dead happy days stars lead heartbreaking tributes actress dies aged^hugh hefner cause death revealed playboy founder documents leaked^hugh hefner cause death revealed playboy founder documents leaked^hugh hefner cause death revealed playboy founder documents leaked^hugh hefner cause death revealed playboy founder documents leaked^hugh hefner cause death revealed playboy founder documents leaked^hugh hefner cause death revealed playboy founder documents leaked^hugh hefner cause death revealed playboy founder documents leaked^royal wedding meghan markle parents will attend father walk aisle^revealed meghan markle father will walk daughter aisle royal wedding^meghan markle dad 'will not attend royal wedding heart attack photo scandal^meghan markle harry set rehearsal kensington palace reveal dad thomas not attend royal wedding^kim kardashian instagram reality star shares first photo daughter chicago west^kim kardashian instagram reality star shares first photo daughter chicago west^kim kardashian instagram reality star shares first photo daughter chicago west^kim kardashian instagram reality star shares first photo daughter chicago west^kim kardashian instagram reality star shares first photo daughter chicago west^kim kardashian instagram reality star shares first photo daughter chicago west^kim kardashian instagram reality star shares first photo daughter chicago west^kim kardashian instagram reality star shares first photo daughter chicago west^kim kardashian instagram reality star shares first photo daughter chicago west^kim kardashian instagram reality star shares first photo daughter chicago west^kim kardashian instagram reality star shares first photo daughter chicago west^kim kardashian instagram reality star shares first photo daughter chicago west^meghan markle deletes instagram facebook twitter accounts statement reveals why^meghan markle deletes instagram facebook twitter accounts statement reveals why^meghan markle half sister slams royals this pippa middleton wedding^meghan markle half sister slams royals this pippa middleton wedding^meghan markle amp prince harry 'not allowed sit together pippa middleton wedding^meghan markle amp prince harry 'did not sit together pippa middleton wedding reception^meghan markle half sister slams royals this pippa middleton wedding^meghan markle half sister slams royals this pippa middleton wedding^meghan markle is this prince harry girlfriend missed pippa middleton wedding^meghan markle half sister slams royals this pippa middleton wedding^royal wedding will pippa middleton go harry meghan wedding^meghan markle amp prince harry 'did not sit together pippa middleton wedding reception^meghan markle is this prince harry girlfriend missed pippa middleton wedding^meghan markle is this prince harry girlfriend missed pippa middleton wedding^meghan markle amp prince harry 'did not sit together pippa middleton wedding reception^meghan markle half sister slams royals this pippa middleton wedding^meghan markle amp prince harry 'did not sit together pippa middleton wedding reception^meghan markle is this prince harry girlfriend missed pippa middleton wedding^meghan markle is this prince harry girlfriend missed pippa middleton wedding^meghan markle is this prince harry girlfriend missed pippa middleton wedding^meghan markle amp prince harry 'did not sit together pippa middleton wedding reception meganmarkle^meghan markle amp prince harry 'did not sit together pippa middleton wedding reception^meghan markle is this prince harry girlfriend missed pippa middleton wedding^meghan markle amp prince harry 'did not sit together pippa middleton wedding reception^bradley cooper victoria secret model irina shayk welcome first child^bradley cooper victoria secret model irina shayk welcome first child^bradley cooper victoria secret model irina shayk welcome first child^bradley cooper victoria secret model irina shayk welcome first child^bradley cooper victoria secret model irina shayk welcome first child^bradley cooper victoria secret model irina shayk welcome first child^bradley cooper victoria secret model irina shayk welcome first child^royal wedding who meghan markle prince harry page boys bridesmaids revealed^revealed why prince harry meghan markle good engaged^smiley jennifer aniston justin theroux seen together first time since brangelina split^smiley jennifer aniston justin theroux seen together first time since brangelina split^smiley jennifer aniston justin theroux seen together first time since brangelina split^smiley jennifer aniston justin theroux seen together first time since brangelina split^meghan markle prince harry wedding cake details revealed chef named claire ptak^is meghan markle missing acting career duchess admits misses suits^meghan markle admits misses suits days season eight release^meghan markle admits misses former suits role days season eight premiere,145,93,-52,238,0.6092436974789915,-0.2184873949579832,1
20177423,ELLEmagazine,1211,6791697,19510,198815,4,3,160,45,follow elle youtube,"new women elected u.s. house representatives making incoming class diverse race^new women elected u.s. house representatives making incoming class diverse hist^on november new women elected u.s. house representatives they join nearly women incu^new women elected u.s. house representatives making incoming class diverse race^highlights from hillary clinton campaign launch speech^highlights from hillary clinton campaign launch speech^highlights hillary clinton campaign launch speech^jennifer aniston is not heartbroken over justin theroux^jennifer aniston is not heartbroken over justin theroux^jennifer aniston is not heartbroken over justin theroux^reese witherspoon teases very first details 'legally blonde^reese witherspoon teases very first details 'legally blonde^kendall jenner definitely single according selena gomez^kendall jenner definitely single according selena gomez^gwen stefani blake shelton valentine day official^kylie jenner baby stormi hang poolside celebrate month birthday^the full downward spiral justin bieber selena gomez relationship^the complete downward spiral justin bieber selena gomez relationship^the full downward spiral justin bieber selena gomez relationship^the complete downward spiral justin bieber selena gomez relationship^a timeline miley cyrus liam hemsworth relationship^a timeline miley cyrus liam hemsworth relationship^a timeline miley cyrus liam hemsworth relationship^a timeline miley cyrus liam hemsworth relationship^a timeline miley cyrus liam hemsworth relationship^a definitive timeline miley cyrus liam hemsworth relationship^a timeline miley cyrus liam hemsworth relationship^a timeline miley cyrus liam hemsworth relationship^a timeline miley cyrus liam hemsworth relationship^a definitive timeline miley cyrus liam hemsworth relationship^a definitive timeline miley cyrus liam hemsworth relationship^a timeline miley cyrus liam hemsworth relationship^a timeline miley cyrus liam hemsworth relationship^a timeline miley cyrus liam hemsworth relationship^a timeline miley cyrus liam hemsworth relationship^a timeline miley cyrus liam hemsworth relationship^a timeline miley cyrus liam hemsworth relationship^justin bieber 'upset trying decompress following news selena gomez hospitalization^a definitive timeline prince harry meghan markle relationship^a definitive timeline prince harry meghan markle relationship^a definitive timeline prince harry meghan markle relationship^a definitive timeline prince harry meghan markle relationship^a definitive timeline prince harry meghan markle relationship^justin bieber reveals real reason relationship selena gomez fell apart^justin bieber reveals real reason relationship selena gomez fell apart^justin bieber reveals real reason relationship selena gomez fell apart^justin bieber reveals real reason relationship selena gomez fell apart^kim cattrall responds sarah jessica parker latest 'sex city comments^kim cattrall responds sarah jessica parker latest 'sex city comments^kim kardashian is reportedly 'not surprised but 'embarrassed by kanye west maga rant^kim kardashian is reportedly 'not embarrassed kanye white house visit^kim kardashian is reportedly 'not embarrassed kanye white house visit^miley cyrus is reportedly planning most secret secret wedding liam hemsworth^miley cyrus is reportedly planning most secret secret wedding liam hemsworth^a resurfaced clip katie couric talking former today cohost matt lauer causing stir interne^a resurfaced clip katie couric talking former today cohost matt lauer causing stir interne^a resurfaced clip katie couric talking former today cohost matt lauer causing stir interne^katie couric breaks her silence on matt lauer firing from the today show^john krasinski flew ,400+ miles every weekend see emily blunt his daughters^john krasinski flew ,400+ miles every weekend see emily blunt his daughters^john krasinski flew ,400+ miles every weekend see emily blunt his daughters^why does kim cattrall hate sarah jessica parker a timeline sex city feud^lady gaga reveals heartbreaking reason she split taylor kinney^why kylie jenner actually removed all her lip fillers^why kylie jenner actually removed all her lip fillers^fans think kylie jenner looks like old kylie after she removes all her filler^fans think kylie jenner looks like old kylie after she removes all her filler^anna faris divorce with chris pratt has made her question point marriage^looks like selena gomez n't woman justin bieber instagramming^looks like selena gomez n't woman justin bieber instagramming^cindy crawford kaia gerber looked seriously alike^cindy crawford kaia gerber looked seriously alike^ryan reynolds responds rumors his marriage blake lively is in trouble^ryan reynolds responds rumors his marriage blake lively is in trouble^cindy crawford kaia gerber looked seriously alike^cindy crawford kaia gerber looked seriously alike^all justin bieber wants is get back together with selena gomez^justin bieber is reportedly 'not over selena gomez despite marrying hailey baldwin^justin bieber is reportedly 'not over selena gomez despite marrying hailey baldwin^kylie jenner adidas falcon sneakers will be stock this week^nikki ogunnaike even tried kylie jenner famous orange dress^pippa middleton announces her pregnancy fitness column^pippa middleton announces her pregnancy fitness column^pippa middleton announces her pregnancy fitness column^pippa middleton announces her pregnancy fitness column^selena gomez may sent secret message justin bieber latest instagram^selena gomez may have sent secret message justin bieber her latest instagram^selena gomez may sent secret message justin bieber latest instagram^angelina jolie is reportedly secretly dating handsome regular older looking real estate agent^angelina jolie is secretly dating handsome regular older looking real estate agent^dakota johnson wows red dior couture gown venice film festival 'suspiria premiere^jennifer garner is reportedly not pleased 'surprised ben affleck is dating year old playboy model^jennifer garner is reportedly not pleased 'surprised ben affleck is dating year old playboy model^meghan markle prince harry reportedly told royal family their baby news princess eugenie wedding^the full list winners golden globes^the full list winners golden globes^it official jamie foxx katie holmes dating^it official jamie foxx katie holmes dating^kim kardashian is reportedly considering asking her surrogate carry another baby her^kim kardashian is reportedly considering asking her surrogate carry another baby her^how to win a breakup according selena gomez kourtney kardashian cazzie david^a very handy guide kourtney kardashian younes bendjima breakup drama^how kourtney kardashian is actually feeling about her younes bendjima breakup^miley cyrus really opened up about living with liam hemsworth^miley cyrus really opened up about living with liam hemsworth^wild rumor kendall jenner publicly ripped into caitlyn restaurant 'turning her back family^dakota johnson chris martin officially dating^dakota johnson chris martin officially dating^how katy perry artfully shaded taylor swift 'american idol^how katy perry artfully shaded taylor swift 'american idol^angelina jolie breaks her silence divorce^angelina jolie breaks her silence divorce^angelina jolie breaks her silence divorce^angelina jolie breaks her silence divorce^angelina jolie breaks her silence divorce^angelina jolie breaks her silence divorce^angelina jolie breaks her silence divorce^all justin bieber wants is get back together with selena gomez^times kate middleton princess charlotte dressed like twins^times kate middleton princess charlotte dressed like twins^kylie jenner wants everyone know that she 'never misses night with travis scott^taylor swift new song gorgeous finally here and seems calvin harris reference^taylor swift new song gorgeous finally here and seems calvin harris reference^taylor swift new song gorgeous finally here and seems calvin harris reference^jennifer aniston is living her life dating two 2 dudes^kim kardashian secretly modeling kanye west new jewelry line^kim kardashian secretly modeling kanye west new jewelry line^oprah winfrey queen america attends royal wedding prince harry meghan markle^emma watson is replacing emma stone greta gerwig 'little women^alexandra daddario shuts down zac efron dating reports second time^alexandra daddario shuts down zac efron dating reports second time^alexandra daddario shuts down zac efron dating reports second time^alexandra daddario shuts down zac efron dating reports second time^alexandra daddario shuts down zac efron dating reports second time^prince harry meghan markle rumored be moving countryside^could you train like victoria secret angel one brave editor attempted work alessandra ambrosio and^train like angel alessandra ambrosio^train like angel alessandra ambrosio^could you train like victoria secret angel one brave editor attempted work alessandra ambrosio and^train like angel alessandra ambrosio^could you train like victoria secret angel one brave editor attempted work alessandra ambrosio and^could you train like victoria secret angel one brave editor attempted work alessandra ambrosio and^ryan seacrest texted kris jenner ask about kylie pregnancy live tv here what she wrote back^ryan seacrest texted kris jenner ask about kylie pregnancy live tv here what she wrote back^ryan seacrest texted kris jenner kylie pregnancy live tv kris not^ryan seacrest texted kris jenner kylie pregnancy live tv kris not^ryan seacrest texted kris jenner ask about kylie pregnancy live tv here what she wrote back^meghan markle will spend her first royal birthday wedding with prince harry^meghan markle will spend her first royal birthday wedding with prince harry^meghan markle prince harry reportedly told royal family their baby news princess eugenie wedding^how katy perry artfully shaded taylor swift 'american idol^how katy perry artfully shaded taylor swift 'american idol^taylor swift madly love with joe alwyn privacy^taylor swift madly love with joe alwyn privacy^taylor swift madly love with joe alwyn privacy^taylor swift madly love with joe alwyn privacy^selena gomez makes it instagram official with justin bieber birthday post^selena gomez makes it instagram official with justin bieber birthday post^selena gomez new song 'back you is here full justin bieber inspired lyrics^selena gomez new song 'back you is here full justin bieber inspired lyrics^selena gomez new song 'back you is here full justin bieber inspired lyrics^selena gomez new song 'back you is here full justin bieber inspired lyrics^selena gomez long tease her seemingly justin bieber inspired music video is over^selena gomez long tease her seemingly justin bieber inspired music video is over^kylie jenner declares family war kim kardashian ding dong ditch prank^scott disick kourtney kardashian are reportedly back together^scott disick kourtney kardashian are reportedly back together^enrique iglesias anna kournikova welcome twins after dating years^enrique iglesias anna kournikova welcome twins after dating years^looks like selena gomez n't woman justin bieber instagramming^looks like selena gomez n't woman justin bieber instagramming^ed sheeran is engaged his girlfriend cherry seaborn^things know pippa middleton fiance james matthews^things know pippa middleton fiance james matthews^miley cyrus elains why she retracted her apology that nude 'vanity fair photo^miley cyrus elains why she retracted her apology that nude 'vanity fair photo^rachel mcadams pregnant first child^rachel mcadams is reportedly pregnant with her first child^rachel mcadams pregnant first child^rachel mcadams is reportedly pregnant with her first child^ryan reynolds responds rumors his marriage blake lively is in trouble^ryan reynolds responds rumors his marriage blake lively is in trouble^kit harington rose leslie wedding date has been revealed^how princess eugenie wedding dress compares meghan markle kate middleton princess diana gowns^prince william says he kate middleton are 'still working new royal baby name^alicia vikander michael fassbender are reportedly married^alicia vikander michael fassbender are reportedly married^this riverdale actress says she getting death threats because bughead^this riverdale actress says she getting death threats because bughead^this riverdale actress says she getting death threats because bughead^jennifer lawrence darren aronofsky reportedly split^prince william recalls how he earned street cred with prince george^prince william recalls how he earned street cred with prince george^khlo kardashian reveals her biggest parenting fear^khlo kardashian reveals biggest parenting fear^everything you need know about princess eugenie amp jack brooksbank royal wedding^everything you need know about princess eugenie amp jack brooksbank royal wedding^everything you need know about princess eugenie amp jack brooksbank royal wedding^bradley cooper irina shayk welcome first child^bradley cooper irina shayk welcome first child^lena dunham apologizes defending girls writer accused sexual assault rape^everything you need know about riverdale season^beyonc shares extremely rare photos her twins sir rumi carter europe^beyonc shares extremely rare photos her twins sir rumi carter europe^beyonc shares extremely rare photos her twins sir rumi carter europe^beyonc shares extremely rare photos her twins sir rumi carter europe^reasonswhy finally officially renewed season^justin theroux posts savvy first instagram since split from jennifer aniston^here everything know reasonswhy season^prince william is officially prince harry best man royal wedding^prince william is officially prince harry best man royal wedding^prince william is officially prince harry best man royal wedding",164,48,-116,212,0.7735849056603774,-0.5471698113207547,1
357564628,NatEnquirer,234,21611,332,20189,0,0,202,6,this official twitter account national enquirer enquiring minds need know,blake shelton gunnin for 'gunsmoke movie with gwen stefani as miss kitty^jennifer aniston divorce gets ugly over 'selfish justin theroux insiders say he wants engagement ring amp his com^jennifer aniston blasted by ex pal chelsea handler over losing justin theroux^jennifer aniston heartbreak over justin theroux 'other woman sad secrets from the doomed marriage^jennifer aniston her humiliation over husband justin theroux bizarro behavior^jennifer aniston justin theroux heads back to paris where their marriage ended over cheating claims^jennifer aniston cleansing her home of justin theroux why she furious over secret divorce deal^jennifer aniston her humiliation over 'womanizing justin theroux as marriage fell apart after months^jennifer aniston amp justin theroux divorce gets dirty over money heartbreaking claims of big bucks she put into do^jennifer aniston heartbreak over justin theroux 'other woman sad secrets from the doomed marriage^jennifer aniston blasted by ex pal chelsea handler over losing justin theroux^jennifer aniston struggling star heartbreak over justin theroux amp emma stone^jennifer aniston furious over justin theroux busy love life^jennifer aniston amp justin theroux have to reunite over honeymoon killer as heartbroken parents plead for their he^jennifer aniston amp justin theroux divorce gets dirty over money heartbreaking claims of big bucks she put into do^jennifer aniston her humiliation over 'womanizing justin theroux marriage fell apart as he was out with naomi w^alex rodriguez cheating on jennifer lopez sex crazed jock left a paper trail^alex rodriguez cheating on jennifer lopez mistress tells all from kinky sex secrets to demands for steroids^amp make official pda thevoice judges^goldie hawn secret split with kurt russell the other man that insiders say she never stopped seeing^brad pitt how the struggling star won the kids in custody war as angelina jolie brings in new lawyers^charlize theron is desperate for a date and is thinking about going online^george clooney amp julia roberts caught cheating as amal demands 220 million divorce^caitlyn jenner amp younger woman sophia vow no sex until marriage^david letterman retired host risks fortune on gambling obsession^david letterman retired host risks fortune on gambling obsession^julia roberts marriage crisis over danny s nut job sister^matt lauer out with his wife as disgraced today host cleans up his image for a comeback^matt lauer already caught with a new woman reported fling with young blonde could cost disgraced today host big^matt lauer cutting the lawn while nbc plots comeback dropped today anchor life after megyn kelly^matt lauer plays victim in first post today interview says groups 'taking advantage of his 'difficult times '^matt lauer hits today hq to plot comeback^matt lauer already caught with a new woman reported fling with young blonde could cost disgraced today host big^matt lauer amp al roker secret history of hateful today feuds how the weatherman got his other last laugh^matt lauer wife bans him from introducing bimbos to his kids latest twist as disgraced today host fights to se^matt lauer tried stepping out with his wife as disgraced today host cleans up his image for a comeback^kathie lee gifford amp hoda kotb at war on today set sources cite fallout over post matt lauer promotion^matt lauer cutting the lawn while nbc plots comeback the dropped today anchor life after megyn kelly^matt lauer set to be banned from /11 museum why the other disgraced today host ca n't enjoy last laugh on megyn^matt lauer laughs it up at women charity event today star latest comeback bid just days before shocking new^betty white has a bucket list why she working to the end^betty white bucket list why she working to the very end^betty white has a bucket list why the tv legend plans to keep working to the very end^liam hemsworth to miley cyrus ditch drugs or we 're done^caitlyn jenner already set for her second boob job shocking claims as she carries on with younger woman^angelina jolie hunger strike pals panic as star hits new low of pounds while divorcing brad pitt^ryan seacrest in trial marriage to save his career^megyn kelly vs. rachel maddow in today war over tom brokaw^caitlyn jenner crushing on boy george^demi moore becomes miley cyrus marriage mentor advice from three time divorc e^sofia richie fears scott disick wants kourtney kardashian back in new kuwtk love triangle^brad pitt relapse fears as struggling star gets back with sean penn^ellen degeneres dumps portia de rossi shocking reports of 400 million split^ellen degeneres dumps portia de rossi shocking reports of 400 million split^kylie jenner gets stiffed by 'kardashians kuwtk^caitlyn jenner is crushing on hugh hefner widow^katie couric blasts 'eloitive matt lauer secrets behind shocking 'today show betrayal^katie couric back at nbc how her surprise return started with matt lauer amp today show scheming^teresa giudice real housewife of new jersey eyes governor mansion rhnoj^meghan markle has her wild past erased by british agents after engagement to prince harry^charlie sheen slams accuser as 'hooker in hiv lawsuit^brad pitt how the struggling star won the kids in custody war as angelina jolie brings in new lawyers^selena gomez sparks fears amid shocking slim down pals speak out after pop diva caught in troubling pics^selena gomez in mental ward amid new health fears the inside story behind struggling star heartbreaking year^selena gomez in mental ward amid new health fears the inside story behind struggling star heartbreaking year^selena gomez sparks fears amid shocking slim down pals speak out after pop diva caught in troubling pics^britney spears 'terrified of returning to las vegas for final shows^ellen degeneres and portia de rossi want a baby to save their marriage^carrie fisher secrets of the starwars icon drug fueled final flight^jennifer lawrence director darren aronofsky ready to move on from hollywood romance^caitlyn jenner rich bitch how the star is spoiling her pet^celine dion starts her surprising new life makeover madness as pop diva puts her grieving behind^celine dion scary skinny diva has insiders fearing a breakdown^celine dion plastic surgery disaster diva actually looking aged amid rumors of work^celine dion scary skinny diva has insiders fearing a breakdown^celine dion inside the diva battle to save her voice after health crisis^jennifer aniston heartbreak over justin theroux 'other woman sad secrets from the doomed marriage^divorce option julia roberts husband danny moder couples therapy together^selena gomez rehab is ruining justin bieber new marriage say insiders^brad pitt amp angelina jolie divorce secrets what they 're fighting to hide and threatening to ee^brad pitt amp son attend therapy superstar fighting to keep his family together during split with angelina jolie^blake shelton ready to quit thevoice over gwen stefani^blake shelton making late night calls to miranda lambert and gwen stefani does n't know thevoice star secret^blake shelton scaring gwen stefani as he breaks down thevoice star is n't ready to get hollywood healthy^blake shelton thevoice star converting to catholicism for gwen stefani^blake shelton thevoice star becoming a catholic for gwen stefani^blake shelton ready to quit thevoice over gwen stefani^blake shelton scaring gwen stefani as he breaks down thevoice star is n't ready to get hollywood healthy^blake shelton making late night calls to miranda lambert and gwen stefani does n't know thevoice star secret^jennifer aniston racing to 225 million divorce from justin theroux^prince harry paternity scandal with plans for his real dad to attend royal wedding to meghan markle^prince harry paternity scandal as real dad makes plan to attend royal wedding to meghan markle^kim kardashian sex life suffering over kanye west claims of intimate kuwtk crisis as couple strugglesto stay to^jennifer aniston divorce gets ugly over 'selfish justin theroux insiders say he wants engagement ring amp his com^brad pitt drawing up love nest for dream architect neri oxman secrets of his new artistic passions^brad pitt rents summer love nest to be close to brainy beauty neri oxman sources say penthouse is pit stop before^brad pitt drawing up love nest for dream architect neri oxman secrets of his new artistic passions^brad pitt rents summer love nest to be close to brainy beauty neri oxman sources say penthouse is pit stop before^britney spears her secret plan for another las vegas wedding^brad pitt fuming over angelina jolie pervert pal but his ex ties to sexual predator could hand him a custody^jennifer aniston furious over justin theroux busy love life^selena gomez rehab secrets as star struggles over justin bieber health eerts fear for pop diva broken heart^sofia richie fears scott disick wants kourtney kardashian back in new kuwtk love triangle^jessica alba businesswoman put new baby on board to save marriage^caitlyn jenner sex swap wedding plans have kris jenner amp kim kardashian fuming insiders say planned vows have rei^nicole kidman ca n't get keith urban to nip 'n tuck country star puts down his boot over going hollywood^angelina jolie prepares 'dirt diary for divorce court insiders claim angry ex wants to ee brad pitt at his w^alec baldwin done doing donald trump on snl^jennifer aniston her marriage crisis in paradise bikini beauty hiding out amid divorce claims^meghan markle has a secret first husband bombshell new claims set to rock her royal wedding to prince harry^meghan markle secret first husband found the scandal that followed her right to the royalwedding^jennifer aniston amp justin theroux in trial separation^brad pitt how the struggling star won the kids in custody war as angelina jolie brings in new lawyers^kim kardashian sex life suffering over kanye west claims of intimate kuwtk crisis as couple strugglesto stay to^giuliana rancic e network power play in feud with maria menounos^kourtney kardashian in secret crisis over breakup with younger man boy toy was also her kuwtk revenge on scott d^jennifer aniston her mom revenge from beyond the grave^jennifer aniston showing off her revenge makeover for justin theroux^angelina jolie takes her revenge on brad pitt over seeing jennifer aniston^jennifer aniston her mom revenge from beyond the grave^jennifer aniston shows off her 'revenge body in italy^jennifer aniston showing off her revenge makeover for justin theroux^jennifer aniston shows off her 'revenge body in italy^caitlyn jenner amp younger woman sophia vow no sex until marriage^katy perry ends feud with taylor swift for americanidol the inside story behind the pop peacemaking^kanye west amp caitlyn jenner become a couple kuwtk outcasts take comfort in each other^kanye west amp caitlyn jenner become a couple kuwtk outcasts take comfort in each other^angelina jolie blasted by jon voight over court battle insiders say dad fuming over brad pitt divorce battle^angelina jolie blasted by jon voight over court battle insiders say dad fuming over brad pitt divorce battle^hoda kotb how she beat out megyn kelly to replace matt lauer on savannahhodatoday the inside story^katie holmes shocking '35 lb weight loss amid tom cruise family drama^brad pitt how the struggling star won the kids in custody war as angelina jolie brings in new lawyers^brad pitt drawing up love nest for dream architect neri oxman secrets of his new artistic passions^brad pitt rents summer love nest to be close to brainy beauty neri oxman sources say penthouse is pit stop before^brad pitt drawing up love nest for dream architect neri oxman secrets of his new artistic passions^brad pitt rents summer love nest to be close to brainy beauty neri oxman sources say penthouse is pit stop before^matt lauer dumped by his showbiz pals fired today host even too toxic for howard stern^matt lauer dumped by his showbiz pals fired today host even too toxic for howard stern^ellen degeneres and portia de rossi want a baby to save their marriage^celine dion plastic surgery disaster diva actually looking aged amid rumors of work^angelina jolie blasted by jon voight over court battle insiders say dad fuming over brad pitt divorce battle^brad pitt how the struggling star won the kids in custody war as angelina jolie brings in new lawyers^ellen degeneres dumps portia de rossi shocking reports of 400 million split^ellen degeneres dumps portia de rossi shocking reports of 400 million split^mariah carey satanic sex shocker singer raised in kinky cult bent on animal sacrifice^emma watson grown up to be an on set diva shocking claims from insiders^katie holmes shocking '35 lb weight loss amid tom cruise family drama^ryan seacrest miserable in nyc new concerns over co host future on 'live with kellyandryan '^steve harvey faces 400 million divorce over kris jenner^britney spears her secret plan for another las vegas wedding^caitlyn jenner did n't tell kris jenner amp kardashians she had final surgery why she 'did n't trust them '^ellen degeneres storms out of marriage to portia de rossi sources say couple set for a 400 million divorce^matt damon in hiding over sexual harassment disaster blasted by fans amp accused of covering for ben affleck^george clooney amp amal named as royal godparents by prince harry amp meghan markle palace insiders tell all^george clooney amp amal named as royal godparents by prince harry amp meghan markle palace insiders tell all^brad pitt amp angelina jolie secrets of their bitter custody battle^george clooney brings brad pitt amp angelina jolie together insiders credit old pal for cooling down divorce battle^brad pitt could get a full time kid in angelina jolie custody battle judge says oldest son can set his own deal^brad pitt mother miserable over missing her grandkids innocent victim of global custody battle with angelina jo^brad pitt mother miserable over missing her grandkids innocent victim of global custody battle with angelina jo^angelina jolie blasted by jon voight over court battle insiders say dad fuming over brad pitt divorce battle^angelina jolie blasted by jon voight over court battle insiders say dad fuming over brad pitt divorce battle^angelina jolie health crisis over custody battle with brad pitt struggling star back to scary skinny^will ferrell amp amy poehler 'ca n't stand each other thehouse haunted by behind the scenes drama^selena gomez pop diva secret rehab stint over drug relapse^is xenu burning tom cruise s nazi fury baddad^meghan markle chose prince harry over being one of 'charlie angels^brad pitt fuming over angelina jolie pervert pal but his ex ties to sexual predator could hand him a custody^kim kardashian sex life suffering over kanye west claims of intimate kuwtk crisis as couple strugglesto stay to^exclusive boozy world of kris jenner *hic*^jennifer aniston divorce gets ugly over 'selfish justin theroux insiders say he wants engagement ring amp his com^jennifer aniston amp justin theroux celebrity divorce turns into a real dog fight^jennifer aniston cleansing her home of justin theroux why she furious over secret divorce deal^jennifer aniston amp justin theroux divorce gets dirty over money heartbreaking claims of big bucks she put into do^jennifer aniston amp justin theroux divorce gets dirty over money heartbreaking claims of big bucks she put into do^mila kunis envious of year old demi moore beach body^blake shelton making late night calls to miranda lambert and gwen stefani does n't know thevoice star secret^blake shelton making late night calls to miranda lambert and gwen stefani does n't know thevoice star secret^angelina jolie amp brad pitt secret affairs before their brutal divorce^angelina jolie amp brad pitt secret affairs before their divorce^angelina jolie amp brad pitt secret affairs before their divorce^angelina jolie amp brad pitt secret affairs before their divorce^jim carrey health crisis pals fear lb comic is dieting himself to death^jim carrey health crisis pals fear lb comic is dieting himself to death^brad pitt how the struggling star won the kids in custody war as angelina jolie brings in new lawyers^brad pitt how the struggling star won the kids in custody war as angelina jolie brings in new lawyers^icymi brad pitt breakdown as angelina jolie plotted to be the new princess diana^brad pitt breakdown as angelina jolie plots to be 'the new princess diana^icymi brad pitt breakdown as angelina jolie plotted to be the new princess diana^brad pitt breakdown as angelina jolie plots to be 'the new princess diana^jennifer aniston inside the battle to get her to sign 'ironclad prenup and how justin theroux changed her mind^jennifer aniston inside the battle to get her to sign 'ironclad prenup and how justin theroux changed her mind^jennifer aniston inside the battle to get her to sign 'ironclad prenup and how justin theroux changed her mind^katy perry ends feud with taylor swift for americanidol the inside story behind the pop peacemaking^justin bieber caught up in church child molester scandal^sandra bullock getting hitched to 'badass bryan george clooney helped^jessica simpson in 'diet or die crisis^angelina jolie takes her revenge on brad pitt over seeing jennifer aniston^jennifer aniston her secret miscarriage heartbreak^jennifer aniston divorce 'she does n't want to get back with brad pitt^jennifer aniston divorce 'she does n't want to get back with brad pitt^reese witherspoon amp nicole kidman feuding stars back for more 'big little lies after emmy win^'superman star margot kidder dead at years old sudden end for troubled actress who found fame as lois lane^erin moran dead 'happy days star snubbed by emmys tragic actress never forgiven for blasting hollywood^prince harry paternity scandal with plans for his real dad to attend royal wedding to meghan markle^prince harry paternity scandal as real dad makes plan to attend royal wedding to meghan markle^'the young and the restless actor found guilty of child molestation corey sligh still facing additional charges^roger ailes dead at former fox news ceo disgraceful end,202,6,-196,208,0.971153846153846,-0.9423076923076924,1
32746529,AOLEntertain,393,34718,637,63501,2,0,116,87,aol entertainment ultimate destination everything celebrity news style fashion,calls donaldtrump 'a f**king nightmare instagram take look^calls donaldtrump 'a f**king nightmare instagram take look^justin theroux still 'heartbroken jennifer aniston split despite dating rumors exclusive^ben affleck 'bender jennifer garner took rehab source says^selena gomez justin bieber 'broken working 'issues source says exclusive^it official blake shelton gwen stefani cutest bbmas^kim kardashian sounds 'fake stories kylie jenner pregnancy defends caitlyn jenner^kanye west shares texts caitlyn jenner one year falling kim kardashian^meghan markle finally meets queen elizabeth ii report^why brad pitt 'not looking leap serious relationship right exclusive^how caitlyn jenner secretly fighting trump white house transgender rights^matt lauer inching 'his way back society 'today show ousting^international women day reese witherspoon harry styles stars celebrate powerful females^shameless enlists katey sagal courteney cox season^what exactly katie holmes relationship tabloids^kendall jenner majorly shades scott disick photo sofia richie kids^sarah jessica parker wants exual beast ellen degeneres play samantha 'sex city^hannibal buress arrested disorderly intoxication miami^fergie josh duhamel split years marriage^justin theroux stayed guest house jennifer aniston split^kourtney kardashian poses topless sofia richie celebrates th birthday neon bikini^jennifer lopez alex rodriguez visit old stomping ground yankee stadium see pic^gwen stefani blake shelton put baby wedding plans hold^is beyonce pregnant fans buzzing possible baby bump^katie couric breaks silence matt lauer 'today scandal 'it incredibly upsetting^inside julia roberts danny moder really solid loving marriage^shameless enlists katey sagal courteney cox season^justin theroux says oscars need best comedy most popular category 'i want see judd apatow win oscar^queer eye fab five dish bromance renaissance man justin theroux exclusive^jennifer lopez talks marriage alex rodriguez 'i would love grow old somebody^kourtney kardashian breaks 'evil human kim 'kuwtk screaming match exclusive^inside julia roberts danny moder really solid loving marriage^tyga calls kim kardashian instagram^justin bieber still selena gomez tattoo getting engaged^meghan markle lost sleep relatives wedding nears^halloween kelly ripa ryan seacrest parody classic tv characters 'live^justin theroux still 'heartbroken jennifer aniston split despite dating rumors exclusive^jennifer aniston justin theroux split a look back private relationship^gwen stefani blake shelton put baby wedding plans hold^derek hough sweetly reflects julianne wedding 'i witnessed baby sister marry man dreams^mike fisher amazing husband pregnant carrie underwood^kim kardashian trolled kanye west tribute 'imagine married trump supporter^ellen degeneres wife portia de rossi makes cry th birthday gift^president trump slams arnold schwarzenegger exiting 'the apprentice 'he fired^kourtney kardashian poses topless sofia richie celebrates th birthday neon bikini^ellen degeneres wife portia de rossi makes cry th birthday gift^halloween kelly ripa ryan seacrest parody classic tv characters 'live^stars like share vday snaps social media leaving us jealous^billboard music awards nominations see full list^caitlyn jenner 'was n't happy first kylie jenner becoming young mom source says exclusive^ben affleck jennifer garner settle divorce three years split report^jennifer lopez campaigns boyfriend alex rodriguez next new york yankees manager^justin theroux spotted model erika cardenas nyc see pic^pregnant khloe kardashian says baby mend relationship caitlyn jenner^angelina jolie braless look meeting archbishop canterbury turns heads^'today anchors savannah guthrie hoda kotb dish ister like friendship^gwen stefani blake shelton put baby wedding plans hold^caitlyn jenner attending son brody jenner wedding 'because lucrative business opportunity report^chris pratt anna faris still living together claims reality star patti stanger^lady gaga holds hands bradley cooper 'a star is born photcall venice^a star is born film review bradley cooper lady gaga reinvigorate classic^kourtney kardashian spotted ex younes bendjima month breakup^kourtney kardashian flaunts insane bikini body post breakup detox^kanye west shares texts caitlyn jenner one year falling kim kardashian^dakota johnson chris martin dating^blake shelton calls meeting gwen stefani 'a miracle 'hitting rock bottom^the biggest celebrity feuds^brigitte nielsen pregnant fifth child see baby bump^brad pitt rumored love interest neri oxman addresses romance reports first time^not everyone thrilled taylor swift got political instagram 'be quiet sing^angelina jolie breaks silence bombshell divorce brad pitt^cindy crawford shows supermodel swims 'morning dip gif^kim kardashian reveals kanye west advised date sex tape^halloween kelly ripa ryan seacrest parody classic tv characters 'live^jennifer lopez talks marriage alex rodriguez 'i would love grow old somebody^did liam payne first solo single diss one direction^ivanka trump slammed fishing royal wedding invite^bffs nicole comes angelina aid messy brad pitt divorce drama drags^the biggest celebrity feuds^watch live the royal wedding prince harry meghan markle^taylor swift boyfriend joe alwyn looks gq red carpet emma stone^'dancing with stars season pros revealed one power couple missing^prince harry meghan markle fairy tale wedding include horse carriage pics^everyone freaking picture queen elizabeth ii kate middleton^everyone freaking picture queen elizabeth ii kate middleton^meghan markle moving london is royal engagement prince harry next^gayle king says oprah winfrey joking running president^bffs nicole comes angelina aid messy brad pitt divorce drama drags^ben affleck 'bender jennifer garner took rehab source says^brad pitt angelina jolie truce custody battle^brad pitt ickened angelina jolie letting child custody battle play public^angelina jolie reportedly 'ramping battle brad pitt divorce gets uglier^brad pitt 'was done mr. nice guy custody battle angelina jolie^portia de rossi ellen divorce rumors make us feel 'accepted^kim kardashian trolled kanye west tribute 'imagine married trump supporter^larry david snl holocaust joke ripped anti defamation league offensive insensitive^jennifer lopez talks marriage alex rodriguez 'i would love grow old somebody^jennifer aniston drops jaws leather mini dress supports husband justin theroux 'the leftovers premiere^justin theroux says oscars need best comedy most popular category 'i want see judd apatow win oscar^halloween kelly ripa ryan seacrest parody classic tv characters 'live^kourtney kardashian poses topless sofia richie celebrates th birthday neon bikini^kourtney kardashian poses topless sofia richie celebrates th birthday neon bikini^blake shelton calls meeting gwen stefani 'a miracle 'hitting rock bottom^prince harry praises prince charles walking meghan markle aisle royal wedding^jennifer aniston talks justin theroux we know truth^robert pattinson praises kristen stewart following recent reunion exclusive^dakota johnson chris martin enjoy malibu date night see pic^gwen stefani blake shelton put baby wedding plans hold^nick cannon quitting 'america got talent 'one best decisions i ever made career^teen choice awards complete winners list^heidi klum shows insane bikini body jumping ocean next rainbow watch^gwen stefani blake shelton put baby wedding plans hold^jenna dewan tatum reveals learned working jennifer lopez 'world dance^report reese witherspoon 'furious 'big little lies co star nicole kidman^james corden apologizes harvey weinstein jokes amfar gala 'sexual assault laughing matter^are taylor swift jake gyllenhaal dating^how caitlyn jenner secretly fighting trump white house transgender rights^the biggest celebrity feuds^'chicago fire star dushon monique brown cause death revealed^anna kournikova enrique iglesias reportedly welcome twins secret pregnancy^beyonce turned role beauty beast director bill condon says^heather locklear pleads guilty attacking police officers^caitlyn jenner confirms n't spoken kim kardashian 'in long time 'i keep distance^courtney love warned young women harvey weinstein^amy schumer hospitalized 'horrible kidney infection^'modern family renewed abc closes deal seasons^'dance moms star abby lee miller sentenced year prison bankruptcy fraud^former 'glee star charice pempengco changes name jake zyrus^'dancing with stars pros val chmerkovskiy jenna johnson engaged^pippa middleton billionaire fiance things know james matthews^teen choice awards complete winners list^meet ines rau playboy first transgender playmate^michael buble wife luisana lopilato welcome baby no^'jesus christ superstar set nbc next live musical^scott hutchison frightened rabbit frontman found dead police^jenny slate joins chris evans family christmas^'ladies london star annabelle neilson cause death revealed^'2 broke girls star beth behrs marries michael gladis^josh brolin addresses diane lane domestic abuse arrest^icymi check complete list nominations year tony awards^icymi check complete list nominations year tony awards^check complete list nominations tony awards^tony awards nominations the complete list^suspect arrested xxxtentacion murder^tamar braxton files divorce husband vincent herbert source^jeremy meeks files divorce wife melissa summer pda chloe green^prince charles replace meghan markle dad royal wedding walk aisle^pippa middleton marries james matthews breathtaking ceremony^david foster katharine mcphee ca n't keep hands paris^tina turner son craig raymond turner dead apparent suicide^ariana grande ex mac miller opens breakup moving 'i happy^meghan markle family shut live tv royal wedding snub will father walk aisle^jason priestley says punched harvey weinstein face^mindy kaling pregnant first child^miley cyrus poses nearly nude fairy princess david lachapelle new book 'lost found^jesse camp former mtv vj reported missing riverside^legendary comedian don rickles dies^harvey weinstein pleads guilty additional sexual assault charges^'ladies of london star annabelle neilson dead^here complete list bet awards winners^this matt damon thinks ben affleck massive back tattoo^justin timberlake announces new album 'man woods reveals release date^ben affleck drops 'triple frontier film focus 'wellness family^danielle herrington everything know sports illustrated swimsuit issue cover model^everything know pippa middleton wedding james matthews far^paris jackson cleans graffiti radio host michael jackson hollywood walk fame star^abby lee miller undergoes 'emergency surgery amid cancer battle details^kaley cuoco marries karl cook see gorgeous wedding look^michael fassbender alicia vikander married^joel taylor star discovery channel 'storm chasers dead^john stamos eecting first child fianc e caitlin mchugh 'i 'll fun dad^mtv 'road rules star danny dias dead^kim kardashian thanks donald trump granting alice marie johnson clemency^jennifer lawrence darren aronofsky split^brooke burke files divorce david charvet^nick jonas priyanka chopra apparently engaged fans not happy^selena gomez the weeknd ca n't keep hands coachella see pics^'harry potter star matthew lewis marries angela jones^billy bush estranged wife sydney davis files divorce^did meghan markle attend pippa middleton wedding prince harry girlfriend nowhere found ceremony^bradley cooper irina shayk reportedly welcome first child^'game thrones stars kit harington rose leslie are married^carson daly mom pattie daly caruso dies^meghan markle reportedly wants mom walk aisle wedding day^lady gaga announces las vegas residency 'i 'll leave heart stage every single night^fergie josh duhamel split years marriage^melissa etheridge smokes weed kids 'it brings closer^katharine mcphee david foster engaged^billboard music awards nominations see full list^tom daley dustin lance black eecting first child^everything know 13 reasons why season^lena dunham joins 'american horror story season^'icarly star nathan kress eecting first child wife london 'our hearts full^jennifer aniston justin theroux barely spoken since split^jennifer aniston steps support jason bateman first public event since justin theroux split^scott disick facetimes sofia richie spending time together cannes^meryl streep joins 'big little lies season^sarah jessica parker wants exual beast ellen degeneres play samantha 'sex city^khloe kardashian talks kim robbery reveals ready marry tristan thompson 'we 've talked^weinstein company file bankruptcy^lorde says taylor swift squad still considers friend^meghan markle admits misses 'suits ahead show season premiere^michael jackson musical coming broadway^josh duhamel defends ex fergie national anthem performance^pauley perrette confirms leaving ncis seasons,118,87,-31,205,0.5756097560975609,-0.15121951219512195,1
185708207,goss_ie,2508,13360,136,86048,0,0,106,96,first celebrity news showbiz goss interviews favourite stars email news.ie gossie,jennifer lawrence darren aronofsky reportedly split year age gap^jennifer lawrence darren aronofsky reportedly split year age gap^kim kardashian defends kylie jenner elf made fortune^kim kardashian defends kylie jenner elf made fortune^kanye west tweets texts caitlyn jenner amid feud kardashians^kanye west tweets texts caitlyn jenner amid feud kardashians^kim kardashian brands ex ray j 'pathological liar eing 'intimate secrets'^kim kardashian brands ex ray j 'pathological liar eing 'intimate secrets'^the queen 'warned prince harry meghan markle behaviour following row tiara^the queen 'warned prince harry meghan markle behaviour following row tiara^cheryl cole wants more babies relationship liam payne strained^cheryl cole wants more babies relationship liam payne strained^cheryl cole wants more babies relationship liam payne strained^cheryl cole wants more babies relationship liam payne strained^cheryl cole wants more babies relationship liam payne strained^cheryl cole wants more babies relationship liam payne strained^sarah jessica parker 'heartbroken kim cattrall sex city comments^fergie josh duhamel announce shock split^fergie josh duhamel announce shock split^cheryl new music '100 per cent personal following split liam payne^cheryl reveals finished dating following split liam payne^cheryl new comeback track liam payne split^liam payne admits feeling fragile split cheryl cole^cheryl new music '100 per cent personal following split liam payne^cheryl reveals finished dating following split liam payne^cheryl finally set move liam payne mansion following split^cheryl new comeback track liam payne split^liam payne cheryl cole planned record duet split^liam payne cheryl cole planned record duet split^cheryl finally set move liam payne mansion following split^liam payne admits feeling fragile split cheryl cole^scott disick jets sofia richie mexico th birthday^kris jenner questions scott disick sofia richie new keeping up with the kardashians^kim kardashian reveals kanye west warned date sex tape scandal^ray j weighs kanye west nick cannon feud kim kardashian^beyonce jay z ever ties kim kardashian kanye west donald trump^ray j weighs kanye west nick cannon feud kim kardashian^kim kardashian reveals kanye west warned date sex tape scandal^beyonce jay z ever ties kim kardashian kanye west donald trump^justin bieber hailey baldwin may already married^justin bieber hailey baldwin may already married^justin bieber sparks rumours already married fianc e hailey baldwin^justin bieber sparks rumours already married fianc e hailey baldwin^scott disick jets sofia richie mexico th birthday^kris jenner questions scott disick sofia richie new keeping up with the kardashians^channing tatum jenna dewan announce separation^channing tatum jenna dewan announce separation icymi^caitlyn jenner sparks celebrity big brother rumours lands heathrow^caitlyn jenner sparks celebrity big brother rumours lands heathrow^caitlyn jenner sparks celebrity big brother rumours lands heathrow^caitlyn jenner sparks celebrity big brother rumours lands heathrow^kim kourtney kardashian blasted peta^kim kourtney kardashian blasted peta^the kardashian jenner clan officially snubbed brody jenner wedding^the kardashian jenner clan officially snubbed brody jenner wedding^chris martin dakota johnson dating^watch katy perry throws subtle shade taylor swift american idol^watch katy perry throws subtle shade taylor swift american idol^david beckham reportedly refused appear victoria vogue cover^kim kardashian reveals kanye west warned date sex tape scandal^kim kardashian reveals kanye west warned date sex tape scandal^kim kardashian furious racial jokes comparing kanye west get out characters^kim kardashian furious racial jokes comparing kanye west get out characters^kim kardashian furious racial jokes comparing kanye west get out characters^kim kardashian furious racial jokes comparing kanye west get out characters^kim kardashian furious racial jokes comparing kanye west get out characters^travis scott pleads guilty disorderly conduct days welcoming baby kylie jenner^kanye west returns twitter bizarre video 'mind control^claudine keane could set replace amanda byram dancing stars^poll who replace amanda byram dancing with the stars^amanda byram left dancing with the stars^poll who replace amanda byram dancing with the stars^here think appear dancing with the stars season^poll who replace amanda byram dancing with the stars^amanda byram quit dancing with the stars landing huge job la^here think appear dancing with the stars season^exclusive here could replacing amanda byram rte dancing with the stars^rob kardashian suing blac chyna strangling iphone cord^rob kardashian suing blac chyna strangling iphone cord^meghan markle excited priyanka chopra nick jonas engagement^priyanka chopra opens meghan markle pregnancy i really excited^priyanka chopra opens meghan markle pregnancy i really excited^meghan markle excited priyanka chopra nick jonas engagement^meghan markle excited priyanka chopra nick jonas engagement^this taylor swift hiding since landed ireland^this taylor swift hiding since landed ireland^khloe kardashian reportedly urged tristan thompson watch cheating scandal kuwtk^khloe kardashian reportedly urged tristan thompson watch cheating scandal kuwtk^on thedailygoss khloe kardashian reportedly urged tristan thompson watch cheating scandal kuwtk^kim kardashian reveals kanye west warned date sex tape scandal^ray j weighs kanye west nick cannon feud kim kardashian^beyonce jay z ever ties kim kardashian kanye west donald trump^ray j weighs kanye west nick cannon feud kim kardashian^kim kardashian reveals kanye west warned date sex tape scandal^beyonce jay z ever ties kim kardashian kanye west donald trump^scott disick jets sofia richie mexico th birthday^scott disick jets sofia richie mexico th birthday^kim kardashian says daughter north beyond jealous siblings^kim kardashian says daughter north beyond jealous siblings^watch katy perry throws subtle shade taylor swift american idol^watch katy perry throws subtle shade taylor swift american idol^selena gomez 'hit hard justin bieber engagement suffering 'emotional breakdown'^selena gomez 'hit hard justin bieber engagement suffering 'emotional breakdown'^selena gomez alleged emotional breakdown reportedly caused feels responsible people^selena gomez alleged emotional breakdown reportedly caused feels responsible people^selena gomez alleged emotional breakdown reportedly caused feels responsible people^meghan markle getting wax figure madame tussauds^meghan markle getting wax figure madame tussauds^anna kournikova enrique iglesias welcome twins^anna kournikova enrique iglesias welcome twins^watch anna kendrick impression kristen stewart absolutely spot^watch anna kendrick impression kristen stewart absolutely spot^justin bieber spotted mystery woman amid reports split selena gomez^justin bieber spotted mystery woman amid reports split selena gomez^harrystyles announces world tour irish dates fans outraged^harrystyles announces world tour irish dates irish fans outraged^harrystyles announces world tour irish dates fans outraged^kourtney kardashian slams scott disick photographed different hooker every day^kourtney kardashian slams scott disick photographed different hooker every day^kate upton details sexual misconduct allegations guess co founder paul marciano^do ariana grande pete davidson matching tattoos^do ariana grande pete davidson matching tattoos^justin theroux cancels late show appearance news jennifer aniston split^justin theroux cancels late show appearance news jennifer aniston split^justin theroux cancels late show appearance news jennifer aniston split^brie larson reveals famous friends jennifer lawrence emma stone aved life^brie larson reveals famous friends jennifer lawrence emma stone aved life^james franco will attend sag awards amid scandal^james franco will attend sag awards amid scandal^fan reveals helped buy house pregnant homeless^fan reveals helped buy house pregnant homeless^fan reveals helped buy house pregnant homeless^aaron paul wife lauren reveals sex first child^aaron paul wife lauren reveals sex first child^lily collins complimented weight loss playing anorexic character^lily collins complimented weight loss playing anorexic character^ariana grande debuts new tattoo dedicated pete davidson dad died /11^ariana grande debuts new tattoo dedicated pete davidson dad died /11^colin firth wife livia admits past affair alleged stalker^colin firth wife livia admits past affair alleged stalker^wife julia carey welcome third child^wife julia carey welcome third child^mindy kaling reportedly pregnant first child^mindy kaling reportedly pregnant first child^meghan markle dad will attend royal wedding^meghan markle dad will attend royal wedding^comedian louis ck accused sexual misconduct five women^comedian louis ck accused sexual misconduct five women^jada pinkett smith responds leah remini shocking scientology claims^jada pinkett smith responds leah remini shocking scientology claims^blac chyna granted temporary restraining order rob kardashian^blac chyna granted temporary restraining order rob kardashian^cardi b breaks silence offset car accident^cardi b breaks silence offset car accident^rushed hospital accident london home^rushed hospital accident london home^pics amy schumer marries chef chris fischer surprise wedding^pics amy schumer marries chef chris fischer surprise wedding^pics amy schumer marries chef chris fischer surprise wedding^tristan thompson starting athletic apparel line^pics kaley cuoco marries karl cook stunning ceremony^pics kaley cuoco marries karl cook stunning ceremony^jennifer lawrence darren aronofsky reportedly split year age gap^jennifer lawrence darren aronofsky reportedly split year age gap^jay z admits relationship beyonc 'was n't totally built truth^jay z admits relationship beyonc 'was n't totally built truth^timoth e chalamet donates salary woody allen movie three charities^timoth e chalamet donates salary woody allen movie three charities^timoth e chalamet donates salary woody allen movie three charities^rebel wilson accuses powerful 'male star sexual harassment^rebel wilson accuses powerful 'male star sexual harassment^bradley cooper irina shayk welcome first child^bradley cooper irina shayk welcome first child^pic celine dion poses naked vogue^pic celine dion poses naked vogue^announces las vegas residency^announces las vegas residency^cardi b confirms secretly married offset last year^cardi b confirms secretly married offset last year^pics enrique iglesias anna kournikova share first photos twins^pics enrique iglesias anna kournikova share first photos twins^pics enrique iglesias anna kournikova share first photos twins^rosie huntington whiteley jason statham welcome baby boy share first photo^lcd soundsystem gavin russom comes transgender^tom daley dustin lance black eecting first child^tom daley dustin lance black eecting first child^john cena nikki bella split six years together^john cena nikki bella split six years together^khloe kardashian ready marry tristan thompson 'would love family^watch khloe kardashian kylie jenner joke 'having many babies^watch khloe kardashian kylie jenner joke 'having many babies^harvey weinstein georgina chapman reach multi million dollar divorce settlement^harvey weinstein georgina chapman reach multi million dollar divorce settlement^kris jenner reveals kept kylie jenner pregnancy secret^kris jenner reveals kept kylie jenner pregnancy secret^kris jenner reveals kept kylie jenner pregnancy secret^the hills star spencer pratt reacted very strangely reports kylie jenner pregnant^kris jenner responds reports daughter kylie pregnant^kris jenner responds reports daughter kylie pregnant^kris jenner responds reports daughter kylie pregnant^the hills star spencer pratt reacted very strangely reports kylie jenner pregnant^details prince harry meghan markle wedding rings revealed royalwedding,106,96,-10,202,0.5247524752475248,-0.049504950495049514,1
23482952,Cosmopolitan,2220,1675456,8001,211584,0,0,129,53,parts cranberry parts vodka .5 part triple sec .5 part lime,angelina jolie is secretly dating handsome older guy^blac chyna request trademark angela kardashian has been denied^blac chyna request trademark angela kardashian has been denied^what is roseanne barr net worth^kim kardashian defends kylie jenner amid controversy over her 'forbes cover^things selena gomez get body^things selena gomez did get body she has now^things selena gomez get body^things selena gomez get body^things selena gomez did get body she has now^people not happy way vanity fair described margot robbie^a definitive timeline miley cyrus liam hemsworth relationship^a definitive timeline miley cyrus liam hemsworth relationship^a definitive timeline relationship^a definitive timeline miley cyrus liam hemsworth relationship^a definitive timeline miley cyrus liam hemsworth relationship^a definitive timeline miley cyrus liam hemsworth relationship^a definitive timeline miley cyrus liam hemsworth relationship^a definitive timeline miley cyrus liam hemsworth relationship^a definitive timeline miley cyrus liam hemsworth relationship^a definitive timeline miley cyrus liam hemsworth relationship^justin bieber reportedly feeling upset happening selena gomez^a definitive timeline prince harry meghan markle relationship^a definitive timeline prince harry meghan markle relationship^a definitive timeline prince harry meghan markle relationship^a definitive timeline prince harry meghan markle relationship^a definitive timeline prince harry meghan markle relationship royalwedding^a definitive timeline prince harry meghan markle relationship^a definitive timeline prince harry meghan markle relationship^updated a definitive timeline prince harry meghan markle relationship^a definitive timeline prince harry meghan markle relationship^a definitive timeline prince harry meghan markle relationship^channing tatum jenna dewan tatum split after years marriage^wow this hot tennis player is legit liam hemsworth doppelg nger^fergie performs first time since announcing her split from josh duhamel damn she looks good^kanye west pro trump rant 'snl reportedly embarrassed kim kardashian^justin bieber was asked if hailey baldwin is pregnant he got *so pissed*^justin bieber was asked if hailey baldwin is pregnant he got so pissed^update ryan phillippe issues statement saying saddened disgusted false allegations him^here meghan markle kate middleton royal 'firsts compare other including first official r^meghan markle kate middleton absolutely slayed royal 'firsts like first official meeting the^meghan markle kate middleton absolutely slayed royal 'firsts like first official meeting the^here meghan markle kate middleton royal 'firsts compare other including first official r^here meghan markle kate middleton royal 'firsts compare other including first official r^how kate middleton first appearance with royal baby no compares george charlotte debuts^katie couric breaks her silence on matt lauer firing from the today show^katie couric finally breaks her silence on matt lauer firing from the today show^kim kardashian speaks out about khlo kardashian tristan thompson relationship status^justin bieber hailey baldwin spotted making out amid reports he not over selena gomez^justin bieber hailey baldwin spotted making out amid reports he not over selena gomez^here everything you need know about justin bieber hailey baldwin wedding^we asked body language eert compare biebs pda hailey baldwin vs. selena gomez ... turns new^we asked body language eert compare biebs pda hailey baldwin vs. selena gomez ... turns new^we asked body language eert compare biebs pda hailey baldwin vs. selena gomez ... turns new^we asked body language eert compare biebs pda hailey baldwin vs. selena gomez ... turns new^we asked body language eert compare biebs pda hailey baldwin vs. selena gomez ... turns new^we asked body language eert compare biebs pda hailey baldwin vs. selena gomez ... turns new^we asked body language eert compare biebs pda hailey baldwin vs. selena gomez ... turns new^khlo kardashian calls out kris jenner tense new 'keeping up kardashians clip^khlo kardashian calls out kris jenner tense new 'keeping up kardashians clip^are kim kardashian kanye west going marriage counseling^are kim kardashian kanye west going marriage counseling^are kim kardashian kanye west going marriage counseling^chris rock getting trouble tweeting joke lamar odom^the juiciest celebrity feuds^are more royal babies on the way fans may found *a clue* prince harry meghan markle already^why people think prince charles is n't harry real dad^why people think prince charles is n't harry real dad^taylor swift is countersuing just 1 her sexual assault trial^taylor swift is countersuing just 1 her sexual assault trial^justin bieber reportedly feeling upset happening selena gomez^justin bieber is reportedly not over selena gomez despite marrying hailey baldwin^justin bieber hailey baldwin spotted making out amid reports he not over selena gomez^justin bieber hailey baldwin spotted making out amid reports he not over selena gomez^khlo kardashian calls out kris jenner tense new 'keeping up kardashians clip^khlo kardashian calls out kris jenner tense new 'keeping up kardashians clip^trump has no idea why civil war happened twitter has field day^kim kardashian denies hooking up drake never happened^kim kardashian denies hooking up drake never happened^kim kardashian left delightfully thirsty comment kanye west instagram^kim kardashian left delightfully thirsty comment kanye west instagram^kim kardashian trolling her own bikini pic instagram is everything^khlo kardashian is boycotting facetime because baby true elanation is hilarious^khlo kardashian is boycotting facetime because baby true elanation is hilarious^kim kardashian might meet donald trump today discuss prison reform twitter is upset^meghan markle prince harry literally told royals their baby news eugenie 's wedding^meghan markle prince harry literally told royals their baby news eugenie 's wedding^selena gomez complicated relationship with her mom reportedly goes beyond justin bieber drama^selena gomez complicated relationship with her mom reportedly goes beyond justin bieber drama^selena gomez complicated relationship with her mom reportedly goes beyond justin bieber drama^channing tatum jenna dewan tatum split after years marriage^are more royal babies on the way fans may found *a clue* prince harry meghan markle already^someone just confirmed that katie holmes jamie foxx are dating^someone just confirmed that katie holmes jamie foxx are dating^caitlyn jenner skipped son brody jenner wedding so did kendall kylie^brody jenner is hurt not surprised caitlyn jenner did n't come his wedding^caitlyn jenner ex just posted shadiest instagram calling her out skipping brody wedding^kim kardashian reportedly considering asking surrogate carry another baby^kim kardashian reportedly considering asking surrogate carry another baby^kim kardashian reportedly considering asking surrogate carry another baby^rihanna rumored to have broken up with her billionaire boyfriend because she 'gets tired men'^katy perry subtly shaded taylor swift 'american idol^the juiciest celebrity feuds^angelina jolie finally breaks silence divorce brad pitt^angelina jolie breaks her silence divorce^taylor swift spent her fourth july turks caicos boyfriend joe alwyn^whoa brad pitt literally morphed girlfriends and now we ca n't unsee it.^rihanna rumored to have broken up with her billionaire boyfriend because she 'gets tired men'^people are freaking out over kate middleton new hair^people are freaking out over kate middleton new hair^people are freaking out over kate middleton new hair^whoa brad pitt literally morphed girlfriends and now we ca n't unsee it.^ryan seacrest texted kris jenner ask about kylie pregnancy live tv here what she wrote back^ryan seacrest texted kris jenner ask about kylie pregnancy live tv here what she wrote back^ryan seacrest texted kris jenner ask about kylie pregnancy live tv here what she said^kylie jenner could not look more bored ryan reynolds met gala if she tried^kylie jenner could not look more bored ryan reynolds met gala if she tried^'kuwtk dropped clip khlo kardashian labor it so intense^'kuwtk dropped clip khlo kardashian labor it highly intense^meghan markle prince harry literally told royals their baby news eugenie 's wedding^meghan markle prince harry literally told royals their baby news eugenie 's wedding^go behind scenes august cover star mila kunis^selena gomez reveals she had kidney transplant^selena gomez reveals she had kidney transplant^katy perry subtly shaded taylor swift 'american idol^prince harry meghan markle getting ready walk aisle soon one crucial thing missing^prince harry meghan markle getting ready walk aisle soon one crucial thing missing^selena gomez friends send support following reported emotional breakdown^justin bieber is comforted church friends after selena gomez reported emotional breakdown^enrique iglesias anna kournikova welcome twins after dating years^enrique iglesias anna kournikova welcome twins after dating years^enrique iglesias anna kournikova welcome twins after dating years^singer jason mraz opens up about his 'two spirit sexuality^courtney love warned young women about harvey weinstein in^courtney love warned young women about harvey weinstein in^dance moms star abby lee miller sentenced one year prison^dance moms star abby lee miller sentenced one year prison^ed sheeran engaged girlfriend cherry seaborn^lena dunham jack antonoff break up after five years together^things know about pippa middleton fianc james matthews^khlo kardashian makes first public appearance since pregnancy news^ashton kutcher pays tribute mila kunis their kids emotional heartwarming speech^actress rachel brosnahan pays tribute her aunt kate spade^listen taylor swift new song gorgeous^kylie jenner steps out with giant diamond ring sparks engagement rumors^um karlie kloss just accidentally revealed princess beatrice secret instagram account world^meghan markle dad will attend royal wedding despite her brother saying he was n't invited^breaking meghan markle dad wo n't attend royal wedding after fallout from staged pictures^praise be hulu already renewed the handmaid tale season^everything we know so far about pippa middleton wedding^everything we know about pippa middleton wedding dress so far^karlie kloss just got engaged joshua kushner love is real alive^alicia vikander michael fassbender are reportedly married^alicia vikander michael fassbender are reportedly married^a new riverdale actress says she already getting death threats from bughead fans^a new riverdale actress says she already getting death threats from bughead fans^jennifer lawrence darren aronofsky reportedly split^taylor swift music video director declared beyonc copied bad blood fans are coming down hard^nick jonas priyanka chopra reportedly engaged dating months is summer sun heating t^meghan markle prince harry did n't sit together pippa middleton wedding^bradley cooper irina shayk welcome their first child^george clooney hospitalized after scooter crash italy^'shameless '' jeremy allen white addison timlin eecting their first child^everything you need know about 'this is us season^jamie lynn spears is pregnant with her second child^jamie lynn spears is pregnant with her second child^jamie lynn spears is pregnant with her second child^jamie lynn spears is pregnant with her second child^taylor swift announces new album reputation^khlo kardashian confesses she thinks about getting nose job every day^jenelle evans says she wants quit teen mom^stop everything reasons why officially renewed season netflix^stop everything reasons why officially renewed season netflix^justin theroux broke social media silence since jennifer aniston split^justin theroux broke social media silence since jennifer aniston split^justin theroux broke social media silence since jennifer aniston split^justin theroux broke social media silence since jennifer aniston split^fiona famous baby hippo dad henry dies^scheana marie speaks out ronnie ortiz magro relationship drama^shia labeouf was arrested again booked public drunkenness disorderly conduct^khlo kardashian is reportedly living hell amid tristan thompson cheating scandal^all signs channing tatum jenna dewan were headed split,129,53,-76,182,0.7087912087912088,-0.4175824175824176,1
179298078,yasminmitri,102,46200,71,99447,1,7,30,138,actress cinema lover,entertainment miley cyrus not voting for donald trump calls him a 'f king nightmare popcrush yasminmitri^topstories criminal inquiry sought hillary clinton use email new york times new york times yasminmitri^topstories full transcript david axelrod interviews president barack obama the axe files cnn yasminmitri^trump considers benching giuliani tv interviews chicago tribune chicago tribune trump considers bench^what players need know win week 868m mega millions lottery jackpot abc news abc news what pla^'multiple people shot night art event nj capital city police say fox news fox news 'multiple people'^'multiple people shot night art event nj capital city police say fox news fox news 'multiple people'^one us soldier killed four wounded somalia attack one us sol^kendall jenner hangs out with anwar hadid amid ben simmons split rumors entertainment tonight entertainment to^entertainment khloe kardashian i want nothing to do with lamar odom but ... yasminmitri^entertainment jennifer lawrence reveals hilarious way amy schumer comforted her after darren aronofsky split^entertainment chris pratt files divorce anna faris chr^topstories alex rodriguez jennifer lopez dating history hooked new york daily yasminmitri^entertainment angelina jolie secret hunger strike call attention syrian refugees and yasminmitri^topstories trump rescinds rules bathrooms transgender students new york times new york yasminmitri^entertainment did justin bieber mom just confirm her son is dating selena gomez again see her yasminmitri^meghan markle kate middleton first official royal speeches had just one thing common^entertainment did lindsay lohan convert islam page six metro did lindsay lohan convert to yasminmitri^entertainment meghan markle pens emotional essay about being biracial actress i 'could n't book a yasminmitri^angelina jolie making divorce so hostile ... her lawyer quitting tmz tmz angelina jolie making divorce so hos^entertainment brad pitt quitting drinking divorcing angelina jolie fighting his kids yasminmitri^entertainment brad pitt becomes race car driver le mans hours just jared just jared brad yasminmitri^entertainment brad pitt becomes race car driver le mans hours just jared just jared brad yasminmitri^entertainment why caitlyn jenner decided undergo sex reassignment surgery yasminmitri^tony awards complete list nominees winners us weekly us weekly tony awards complete list n^trump used racial slur during 'celebrity apprentice former white house aide says new york times new york times^entertainment jason priestley dishes dirt on divas and former roomie brad pitt in tell all ... ... yasminmitri^bella hadid amp the weeknd share steamy kiss in cannes after his split with selena gomez hollywood life hollywood^entertainment tyga still wants paternity test kylie jenner newborn baby stormi aceshowbiz aceshowbiz ty^entertainment kris jenner cries tears of joy in 'kuwtk teaser is it the moment she learned of kylie pregnancy^entertainment gwen stefani amp blake shelton how janet jackson has inspired her to have another baby yasminmitri^entertainment at last kim kardashian admits selfie obsession ridiculous yasminmitri^entertainment did lindsay lohan convert islam page six metro did lindsay lohan convert to yasminmitri^brad pitt visited his 'genius gorgeous new friend professor neri oxman mit last fall^story about tyga wanting to meet kylie jenner daughter stormi is made up gossip cop gossip cop story about tyg^entertainment jennifer aniston justin theroux 'we know what our truth is people magazine yasminmitri^entertainment jennifer aniston justin theroux 'we know what our truth is people magazine yasminmitri^entertainment justin bieber showering selena gomez with tlc to help her prepare for amas hollywood life holly^topstories inside jennifer aniston justin theroux 240 million empire e online e online inside jennifer^most inspiring quotes from oprah winfrey usc commencement speech e online e online most inspiring quotes^entertainment jimmy fallon daughters winnie frances steal show his ride opening e yasminmitri^entertainment game thrones spinoffs we 'd be happy watch e online e online game of yasminmitri^the bachelorette keeps chugging in spite everything e online e online the bachelorette keeps chugging^topstories aaron carter breaks up with madison parker e online e online aaron carter breaks up yasminmitri^brigitte nielsen pregnant see more eecting stars over e online e online brigitte nielsen pregnant^nbc orders 'law order hate crimes rolling stone rolling stone nbc orders 'law order hate crimes roll^grammy winner pink graces cover people beautiful issue her two kids^entertainment dance moms abby lee miller sentenced year prison e online e online dance yasminmitri^entertainment caitlyn jenner opens up about her changed relationship with her kids e online e yasminmitri^entertainment kaia gerber makes her new york fashion week runway debut e online e online kaia yasminmitri^entertainment all details inside jennifer lopez alex rodriguez met gala date night e yasminmitri^entertainment former melrose place star antonio sabato jr. is running congress california e yasminmitri^entertainment minnie driver takes aim ex matt damon men like him '' can understand what abuse is like e^entertainment charlie murphy dies actor comedian brother eddie murphy was e online e yasminmitri^topstories charlie murphy dies actor comedian brother eddie murphy was e online e yasminmitri^entertainment janet jackson visits hurricane harvey victims after kicking off state world tour yasminmitri^entertainment drink it sink it celebrities weigh in new unicorn frappuccino e online yasminmitri^entertainment taylor swift is too pretty draw properly courtroom sketch artist says e online yasminmitri^keri russell talks 'star wars episode ix report fox news fox news keri russell talks 'star wars^entertainment american idol officially returning abc season e online e online yasminmitri^entertainment pippa middleton undergoing bridal body boot camp ahead wedding e online e yasminmitri^entertainment blake lively injured set the rhythm section production temporarily suspended e online e^entertainment luke bryan amp lionel richie officially join american idol judges e online e yasminmitri^entertainment austin jones arrested child pornography charges more biggest youtube star yasminmitri^entertainment khloe kardashian makes first public appearance since pregnancy news photos us weekly yasminmitri^entertainment meghan markle arrives london pippa middleton wedding us weekly us weekly yasminmitri^entertainment drunk driver crashes into fixer upper ''three little pigs '' house e online e yasminmitri^entertainment here why shia labeouf is now living alone remote cabin finland e online yasminmitri^entertainment nikki reed gives birth baby girl with ian somerhalder find out her unique name yasminmitri^entertainment katy perry becomes first person reach million twitter followers e online e yasminmitri^entertainment the bachelor bekah m. was missing persons list until fan recognized her show^tristan thompson leaves cleveland one week after birth his daughter with khloe kardashian e online e online^entertainment this is us fans we 're going learn how jack died season e online e online yasminmitri^entertainment j.k. rowling sorry killing beloved harry potter character e online e online yasminmitri^entertainment emma stone responds teen viral la la land inspired promposal e online e yasminmitri^ariana grande has tattoo dedicated pete davidson dad who died /11 e online e online ariana grande h^entertainment mel b files divorce from stephen belafonte after nearly years marriage e yasminmitri^entertainment why once upon time should follow jennifer morrison lead amp end with season e yasminmitri^entertainment pink responds recording academy call women step up after grammys e online e^topstories the bachelor chris soules checked kenneth mosher pulse call reveals e online yasminmitri^entertainment radiohead eeriences major technological issues during coachella performance e yasminmitri^entertainment radiohead eeriences major technological issues during coachella performance e yasminmitri^entertainment beyonc in homestretch inside her third trimester pregnancy with twins e yasminmitri^entertainment bobby moynihan leaving saturday night live my life dream was be that show yasminmitri^vince vaughn arrested dui resisting arrest california vi^entertainment kylie jenner cuddles babies health clinic during philanthropic trip peru e yasminmitri^entertainment aaron carter enters facility ''improve his health '' e online e online aaron yasminmitri^entertainment scarlett johansson gets trashed with her grandma twin e online e online yasminmitri^entertainment why fixer upper chip joanna gaines are choosing family over fame e online e yasminmitri^entertainment jessica alba gives birth actress cash warren welcome baby no e online e online jessica^entertainment michael nance life after the bachelorette e online e online michael nance life yasminmitri^entertainment selena gomez releases new single music video ''bad liar '' e online e yasminmitri^entertainment jimmy kimmel drags matt damon into united airlines bad press e online e online yasminmitri^entertainment jimmy kimmel drags matt damon into united airlines bad press e online e online yasminmitri^entertainment chris brown karrueche tran migos quavo spark love triangle drama e online e yasminmitri^entertainment the bachelor ben higgins calls off wedding lauren bushnell will they break up yasminmitri^topstories ryan lochte gets rushed protesters after dancing with stars performance e online yasminmitri^entertainment charlie murphy laid rest dave chappelle other comedians say goodbye e yasminmitri^topstories chrissy teigen awkwardly corrects ivanka trump tweet and it pure internet gold e yasminmitri^entertainment patti lupone calls madonna movie killer says she dead behind eyes e yasminmitri^entertainment what pippa middleton wedding dress might look like e online e online what pippa yasminmitri^entertainment the story fergie dramatic comeback after hitting rock bottom e online e online the story o^entertainment ryan murphy elains feud ending e online e online ryan murphy elains feud yasminmitri^entertainment justin theroux breaks social media silence after jennifer aniston split e online e online justi^entertainment ben affleck girlfriend lindsay shookus has no relationship with jennifer garner yasminmitri^entertainment jennifer aniston split from justin theroux is uneected and disappointing e online e online^entertainment the cw fall premiere dates revealed here starts entertainment weekly yasminmitri^entertainment survivor moves on after zeke smith shares his story with new tribe mates e online yasminmitri^entertainment sasheer zamata quietly becomes rd star leave snl after this season e online e yasminmitri^entertainment kendall jenner is basically naked met gala e online e online kendall yasminmitri^entertainment harry styles never felt need define his sexuality e online e online harry yasminmitri^entertainment everything we know about scrapped sex city movie e online e online yasminmitri^entertainment star wars the last jedi sneak peek see vanity fair four exclusive covers e online yasminmitri^entertainment coachella all access go inside this year star studded music festival e online yasminmitri^kaley cuoco marries karl cook e online e online kaley cuoco marries karl cook e online kaley cuocohas said i^topstories carrie fisher had cocaine ecstasy heroin methadone her system autopsy reveals yasminmitri^kim kardashian shares cutest video yet chicago west e online e online kim kardashian shares cutest video ye^entertainment prince harry once wanted out royal family e online e online prince harry yasminmitri^entertainment the bachelorette alum britt nilsson marries jeremy byrne e online e online the yasminmitri^entertainment kaley cuoco is engaged boyfriend karl cook watch her emotional reaction proposal^entertainment gorilla dances maniac channels flashdance jennifer lopez e online e yasminmitri^entertainment meghan mccain joins the view as regular co host e online e online meghan mccain yasminmitri^billionaire matthew mellon ex husband jimmy choo tamara mellon dies mexican rehab report^reports priyanka chopra nick jonas engaged two months dating usa today usa today reports priy^entertainment selena gomez the weeknd ca n't keep their hands off each other coachella e yasminmitri^entertainment danny masterson fired from netflix the ranch over sexual assault allegations i 'm obviously very^entertainment jennifer hudson join 'the voice coach season ethan miller/getty yasminmitri^entertainment jennifer hudson join 'the voice coach season ethan miller/getty yasminmitri^entertainment meghan markle reportedly wears black dress pippa middleton wedding reception yasminmitri^entertainment rob kardashian accuses blac chyna cheating during elicit social media war e yasminmitri^entertainment bradley cooper irina shayk welcome their first child yasminmitri^game thrones kit harington rose leslie are married e online e online game thrones kit harington an^entertainment conrad hilton has courtroom outburst while being ordered go psychiatric hospital yasminmitri^entertainment scarlett johansson hooking up with snl colin jost all details their fun yasminmitri^entertainment rebecca gayheart files divorce from eric dane after years marriage^entertainment southern charm naomie olindo admits she got nose job two weeks ago e online e online southe^entertainment scott disick sofia richie get flirty yacht e online e online scott disick yasminmitri^entertainment kylie jenner newest photo baby stormi is her sweetest yet e online e online kylie jenner^wwe star vader dead e online e online wwe star vader dead e online wwe wrestler vader whose real^entertainment chris evans millie bobby brown snoop dogg more stars shower bullied student keaton jones with^entertainment 'rent set fox next live musical hollywood reporter hollywood reporter 'rent' yasminmitri^entertainment 'rent set fox next live musical hollywood reporter hollywood reporter 'rent' yasminmitri^kylie jenner travis scott step out date night new york city e online e online kylie jenner trav^entertainment carolina herrera speaks out after nephew killed venezuela wwd carolina herrera yasminmitri^entertainment whitney port gives birth inside her love hate relationship with being pregnant e yasminmitri^topstories shockers from caitlyn jenner memoir what kardashians have say e online yasminmitri^eva longoria gives birth baby boy e online e online eva longoria gives birth baby boy e online eva^why fans just ca n't give up jennifer garner ben affleck romance e online e online why fans just can't^entertainment arrow things know about what come rest season e online e yasminmitri^entertainment dancing with stars tour bus involved fatal multiple vehicle accident e online e online d^stormy daniels husband glendon crain files divorce restraining order us weekly us weekly stormy daniels^entertainment richard simmons hospitalized california 'severe indigestion says manager yasminmitri^entertainment richard simmons hospitalized california battling severe indigestion abc news yasminmitri^entertainment heidi montag spencer pratt are eecting baby boy e online e online heidi yasminmitri^entertainment kim zolciak biermann year old son kash hospitalized after dog bite e online e yasminmitri^entertainment chris cornell wife vicky believes his suicide was accidental e online e online yasminmitri^entertainment grey anatomy spin off coming abc e online e online grey anatomy spin off yasminmitri^entertainment rosario dawson finds year old cousin dead her l.a. home e online e online yasminmitri^entertainment adam levine delivers emotional tribute christina grimmie the voice e online yasminmitri^entertainment cmt music awards nominations announced see complete list e online e yasminmitri^entertainment miley cyrus reveals katy perry is her oldest friend hollywood e online e online yasminmitri^colton haynes addresses jeff leatham cheating rumors amid split speculation e online e online colton haynes ad^entertainment miley cyrus gives emotional ''malibu '' performance billboard music awards yasminmitri^entertainment you 'll have time travel for chance rock kim kardashian spring break bikinis yasminmitri^entertainment jennifer garner sets record straight ben affleck divorce story e online e yasminmitri^entertainment bow wow lied about flying private jet twitter wo n't let go e online e yasminmitri^entertainment madonna announces she moved portugal is working new music e online e yasminmitri^ving rhames says police held him at gunpoint in his own home after neighbor reported robbery vulture vulture vin^entertainment ben affleck jennifer garner officially file divorce e online e online ben yasminmitri^entertainment biggest benefit concerts all time how much they really made e online yasminmitri^entertainment everything need know 'once upon time season entertainment weekly yasminmitri^entertainment tom cruise just confirmed top gun sequel is in works e online e online tom yasminmitri^entertainment things you need to know about taylor swift new boyfriend joe alwyn e online e yasminmitri^entertainment chris pratt files divorce anna faris chr^entertainment morning joe co hosts joe scarborough mika brzezinski are engaged huffington post yasminmitri^april giraffe is pregnant again viral star eecting another baby calf,31,145,114,176,0.17613636363636365,0.6477272727272727,0
55204143,MirrorCeleb,2164,98412,952,184441,0,0,129,43,the official daily mirror celebrity news account follow depth news updates follow latest discounts deals,jennifer aniston 'upset pics justin theroux embracing naomi watts^jennifer aniston justin theroux agree custody 'children^kim kardashian bra joy joined equally miserable kanye west birthday party last nigh^kim kardashian ribs visible poses miserable looking kanye west kuwtk^jennifer lawrence opens split darren aronofsky^katie holmes jamie foxx get sweaty together joint workout rubbishing split claims^is jennifer aniston baby news 've waiting^skinny angelina jolie reveals painfully thin arms red carpet brad pitt stays away netflix premiere^cheryl liam payne relationship timeline x factor flirting baby calling quits^how angelina jolie brad pitt split 400 million fortune^brad pitt 'apologises jennifer aniston 'absentee husband leaving angelina jolie^ed sheeran cherry seaborn double date courteney cox johnny mcdaid wedding rumours^ed sheeran cherry seaborn double date courteney cox johnny mcdaid^blake shelton says gwen stefani saved life following split miranda lambert^fergie tears split josh duhamel admits 'wanted stay married forever years togethe^i want babies kristen reveals family plans rob weeks cheated^cheryl new music '100 personal show fans 'vulnerable side split liam payne^cheryl cole doomed love life liam payne split^liam payne makes shock relationship status announcement months cheryl split^cheryl wants mum move look baby bear liam payne split^cheryl plit liam payne 'left raise baby bear alone^the d man liam payne wants rise negativity split cheryl^cheryl plans move amazing 3.75m mansion bear split liam payne^'cheryl uses liam payne split music enough maintain popstar career says^liam payne makes shock relationship status announcement months cheryl split^cheryl breaks silence split liam payne emotional comeback single^liam payne makes shock relationship status announcement months cheryl split^liam payne admits secretly split cheryl weeks confirmed break^cheryl set move 3.75million mansion bear split liam payne^beyonce knowles narrowly avoids epic fall staircase live show^beyonce knowles narrowly avoids epic fall staircase live show^beyonce knowles narrowly avoids epic fall staircase live show^beyonce knowles narrowly avoids epic fall staircase live show^beyonce knowles narrowly avoids epic fall staircase live show^beyonce knowles narrowly avoids epic fall staircase live show^katie holmes jamie foxx plit call wedding five years^katie holmes jamie foxx plit call wedding five years^katie holmes jamie foxx plit call wedding five years^katie holmes jamie foxx plit call wedding five years^katie holmes jamie foxx plit call wedding five years^ben affleck looks dumps tense outing jennifer garner^ed sheeran cherry seaborn double date courteney cox johnny mcdaid wedding rumours^ed sheeran cherry seaborn double date courteney cox johnny mcdaid^is gavin rossdale convinced timing gwen stefani blake shelton romance^breaking kylie jenner is pregnant rapper boyfriend travis scott baby reps confirm^'remorseful justin bieber sobs selena gomez enters mental health facility following hailey baldwin marriage^lady gaga taylor kinney love story couple plit five years together^brad pitt 'apologises jennifer aniston 'absentee husband leaving angelina jolie^angelina jolie 'consoled johnny depp gears divorce battle brad pitt^greasy justin bieber sobs selena gomez wife hailey baldwin comforts^justin bieber 'makes hailey baldwin priority sobbing selena gomez 'breakdown^kendall jenner fumes kris jenner refusing invite caitlyn christmas party kuwtk^is kim kardashian losing hair reality star seen 'bald patches workout^drake enjoys 'cosy date hailey baldwin 'hooking memorial day party^is real reason drake hooking jennifer lopez^drake ecretly hooking walsall singer jorja smith spotted local co op^brad pitt takes pax shiloh maddox unbroken premiere angelina jolie misses^is anne hathaway pregnant star 'eecting first child husband adam shulman^is kourtney kardashian jealous sister kim hanging scott disick^miley cyrus liam hemsworth 'cancel honeymoon bora bora^this jennifer lopez fell 'new boyfriend drake^jennifer lopez confirms relationship new boyfriend drake^beyonce could reunite destiny child coachella fans losing it^beyonce 'to reunite destiny child coachella fans losing^beyonce 'to reunite destiny child coachella fans losing^beyonce fans lose amid reports going reunite destiny child coachella^the real reason mel b ended turbulent marriage stephen belafonte revealed^brad pitt 'apologises jennifer aniston 'absentee husband leaving angelina jolie^desperate brad pitt begs angelina jolie see children footage clears physical abuse^selena gomez breaks silence the weeknd split opens reconciliation justin bieber^kim kardashian 'hoping strike royal friendship meghan markle^kourtney kardashian splits toyboy boyfriend blasted bum posts^kourtney kardashian splits toyboy boyfriend blasted bum posts^kourtney kardashian splits toyboy boyfriend blasted bum posts^caitlyn jenner scolded skipping son brody wedding charity ball kuwtk^caitlyn jenner scolded skipping son brody wedding charity ball kuwtk^brody jenner mum linda thompson takes jab ex caitlyn jenner missing son wedding^brody jenner mum takes jab ex caitlyn jenner snubbing wedding^caitlyn jenner scolded skipping son brody wedding charity ball kuwtk^caitlyn jenner scolded skipping son brody wedding charity ball kuwtk^brody jenner n't happy caitlyn attended event rumoured fiancee instead going his^brody jenner hits dad caitlyn jenner wedding snub^caitlyn jenner scolded skipping son brody wedding charity ball kuwtk^caitlyn jenner scolded skipping son brody wedding charity ball kuwtk^date night katie holmes goes dinner mystery man^angelina jolie says relieved ex brad pitt cleared child abuse probe^kanye west told date kim kardashian sex tape revelation^kim kardashian admits furious kanye west slavery comments cried screamed him^caitlyn jenner breaks silence kylie jenner baby reveal misses birth^travis scott pleads guilty disorderly conduct days daughter birth^watch kendall jenner break tears praises dad bruce sex change^watch kendall kylie jenner break tears caitlyn gives heartfelt speech espys^kris vs caitlyn jenner the bitter rows nasty jibes endless power struggle^prince harry 'no rush make meghan markle princess claims 're moving together^kris jenner fires back critics life kylie branded 'fake 'boring viewers^hurt kanye west slams mentor jay z failed visit kim kardashian robbery ordeal^angelina jolie brad pitt 'going head head custody battle six kids^angelina jolie brad pitt 'going head head custody battle six children^angelina jolie brad pitt 'going head head custody battle six kids^piers morgan tears elfish angelina jolie brad pitt custody battle^angelina jolie brad pitt 'reach interim arrangement bitter custody battle^lady gaga 'channels inner madonna steps paris platinum hair^kylie jenner slammed looking bored jennifer lopez vmas performance^kylie jenner slammed looking bored jennifer lopez vmas performance^kylie jenner slammed looking bored jennifer lopez vmas performance^kris jenner throws boozy valentine day bash gets control^jennifer aniston net worth divorce justin theroux affect^jennifer aniston justin theroux wedding pictures inside doomed fairytale day ended divorce^kourtney kardashian shows hot bikini body firing back fan said never works^kourtney kardashian shows impressive bikini body firing back fan accused never working^billy connolly wife pamela hit michael parkinson comments health^billy connolly wife pamela blast michael parkinson comments made comic memory^billy connolly wife pamela blast michael parkinson comments health^billy connolly wife pamela hit back michael parkinson comments health^as love island gabby marcel call quits timeline nine month relationship^david beckham smirks speeding trial thrown 'mr loophole technicality^angelina jolie brad pitt marriage breakdown 'things got bad i cry shower'^brad pitt lams reports secretly dating princess monaco^why kylie jenner decided stay spotlight sources claim 'very happy pregnancy'^'pregnant kylie jenner take ix months spotlight^robert pattinson insists n't ignore charlie hunnam the lost city z set^kim kardashian leaves fans divided poses naked sell new eyeshadow kuwtk^kim kardashian leaves fans divided strips naked advertise eyeshadow kuwtk^kim kardashian leaves fans divided poses naked advertise eyeshadow kuwtk^kim kardashian leaves fans divided advertises eyeshadow posing naked kuwtk^marion cotillard absolutely devastated brad pitt affair allegations^brad pitt 'has crying devastated angelina jolie surprise divorce^selena gomez 'feeling empowered completing treatment programme^kylie jenner declares war kim kardashian penis shaped cake prank^chicagofire star dushon monique brown cause death revealed^chicagofire star dushon monique brown cause death revealed^chicagofire star dushon monique brown cause death revealed^chicagofire star dushon monique brown cause death revealed^chicagofire star dushon monique brown cause death revealed^glee star mark salling cause death revealed^dance moms star abby lee miller breaks silence sentenced year prison^breaking ed sheeran engaged girlfriend cherry seaborn^see glamorous red carpet arrivals met gala metgala^breaking iconic us comedian jerry lewis dies age^rita ora kisses cardi b raunchy girls music video backlash lyrics^khloe kardashian hides stomach loose fitting shirt makes first public appearance since 'pregnancy news^cardi b flashes enormous carat diamond engagement ring offset proposes live stage^fourth xxxtentacion murder suspect arrested florida^fourth xxxtentacion murder suspect arrested turning^breaking xxxtentacion murder suspect arrested hunt killer ends georgia^final xxxtentacion murder suspect arrested turning^breaking justin bieber cancels remaining purpose world tour dates^pregnant jessica simpson accidentally tells world i 'm baby boy^storm chasers star joel taylor cause death revealed^hugh hefner cause death revealed playboy founder dies aged^quincy jones claims dated ivanka trump labels the beatles worst musicians world^mtv star clay adler dead apparent suicide^blac chyna smiles outside court granted temporary restraining order rob kardashian^stranger things star shannon purser comes bisexual^simon cowell rushed hospital accident london home^anna wintour daughter bee shaffer engaged late italian vogue editor son francesco carrozzini^this could sort dress meghan markle wore pippa middleton wedding^cardi b confirms secretly married migos rapper offset last year^paris jackson shares rare photo younger brother blanket grown^kanye west mysteriously deletes twitter instagram profiles^billboard music awards nominations ed sheeran leads full list^billboard music awards nominations ed sheeran leads full list^the billboard music awards complete winners list billboardmusicawards^kate winslet leonardo dicaprio still quote titanic lines^bedraggled jennifer aniston seen first time since justin theroux split pair prepare 240million sl^weinstein company 'left choice file bankruptcy^lorde insists taylor swift dear friend clarifies quad comment^reese witherspoon confirms legally blonde happening^the weeknd beyonce eminem headline coachella^mission impossible actor ving rhames says police held gunpoint home^travis scott high spirits gig following reports kylie jenner pregnant^mila kunis makes mum cry surprise makeover parents home nine months pregnant,129,43,-86,172,0.75,-0.5,1
19538986,JustJared,2926,750284,6176,196865,0,0,101,66,your entertainment authority also follow,"jennifer aniston justin theroux separately attended jimmy kimmel son birthday party weekend^brad pitt reveals children think parents finally getting married^jennifer lawrence getting candid split darren aronofsky^lindsay lohan encouraging everyone dothelilo dancing went viral watch video^jessica simpson stepped holding baby bump new york city today^jessica simpson cradled baby bump airport afternoon hours announcing pregnant^jessica simpson cradled baby bump tonight walking red carpet qvc fashion event^molly shannon reveals thoughts kim cattrall feud divorce co star sarah jessica parker watch^duchess kate middleton photographed first time since leaving hospital giving birth she heade^see kate middleton subtly paid tribute queen elizabeth leaving hospital newborn son^keith urban hitting stage latest tour stop friday connecticut^caitlyn jenner rumored girlfriend sophia hutchins head malibu chili cook off^yandhi n't released kanye west originally said ... kim kardashian revealed album brand new re^ed sheeran spotted double date longtime friend courteney cox last night^gwen stefani talks blake shelton torture split gavin rossdale amp^caitlyn jenner stepped kim kardashian posted throwback photo ... happened fans are^people social media think tennis player looks like liam hemsworth check side side compa^sarah jessica parker brilliant idea sex city^cheryl cole made statement love life split liam payne^scott disick sofia richie kick holiday weekend double date^sofia richie celebrates th birthday boyfriend scott disick mexico^scott disick girlfriend sofia richie step dinner malibu th birthday trip mexico^sofia richie showing super hot bikini bod mexico^julia roberts hangs niece emma roberts evan peters labor day weekend^duchess kate middleton looked stunning erdem dress first official visit royal patron v amp a mus^duchess kate middleton returning maternity leave see official announcement^duchess kate middleton officially back maternity leave see photos first official royal appearance^meet actor playing young prince charles third season thecrown^ed sheeran spotted double date longtime friend courteney cox last night^justin theroux zips streets morning bike ride^went revealed real story convinced take peop^angelina jolie took kids shiloh zahara knox vivienne hike hollywood hills^gerard butler morgan brown blast malibu chili cook off^brad pitt fighting joint custody children angelina jolie^lady gaga amp taylor kinney reportedly split five years together^brad pitt back l.a spending time france le mans hours race^brad pitt became race car driver lemans24 today see hot pics^hailey baldwin responding rumors already married justin bieber^vince vaughn walked red carpet venice tonight wife kyla side^scott disick sofia richie kick holiday weekend double date^sofia richie celebrates th birthday boyfriend scott disick mexico^scott disick girlfriend sofia richie step dinner malibu th birthday trip mexico^sofia richie showing super hot bikini bod mexico^jessica simpson no wedding dress yet jessica simpson wears sequined dress leaving^kim kardashian left sexy suggestive comment kanye west instagram account getting lot atten^miley cyrus amp liam hemsworth reportedly cancelled honeymoon plans go different route^looked super sexy date new boyfriend alex rodriguez last night^hits red carpet boyfriend new york city sports legends dinner^jennifer lopez new boyfriend alex rodriguez hit gym together today miami^justin theroux seen year old model erika cardenas source saying^julia roberts hangs niece emma roberts evan peters labor day weekend^dakota johnson heading home attending venice film festival^selena gomez seen stepping religious reading hand^selena gomez steps pilates class religious reading hand^jessica simpson stepped holding baby bump new york city today^jessica simpson cradled baby bump airport afternoon hours announcing pregnant^jessica simpson cradled baby bump tonight walking red carpet qvc fashion event^did brody jenner new wife shade caitlyn jenner skipping wedding^caitlyn jenner n't attending brody jenner wedding find went instead^brody jenner broken silence caitlyn jenner skipping wedding^congrats brody jenner new wife kaitlynn carter get details wedding^caitlyn jenner rumored girlfriend sophia hutchins head malibu chili cook off^shots rang home tekashi ix9ine kanye west shooting music video^katie holmes steps grab grub big apple^katie holmes cute comfy big apple^julia roberts hangs niece emma roberts evan peters labor day weekend^kim kardashian rocked skin tight dress date night kanye west last night check pics^yandhi n't released kanye west originally said ... kim kardashian revealed album brand new re^misses sister away modeling^bffs amp shop together latter misses flight^duchess kate middleton returning maternity leave see official announcement^selena gomez timothee chalamet shared romantic kiss set upcoming woody allen film^selena gomez timothee chalamet spotted filming rain together^selena gomez timothee chalamet blast together set upcoming woody allen movie^selena gomez timothee chalamet met the met continue filming^angelina jolie took kids shiloh zahara knox vivienne hike hollywood hills^angelina jolie took kids shiloh zahara knox vivienne hike hollywood hills^kendall jenner spoke extensively pepsi commercial controversy broke tears^katie holmes steps grab grub big apple^katie holmes cute comfy big apple^emma stone sweetest things say co star friend ryan gosling^rob kardashian reportedly suing blac chyna assault battery vandalism^teri hatcher calls reports broke homeless hurtful untrue^scott disick says kourtney kardashian always family^financial details come light ongoing angelina jolie brad pitt child support battle^angelina jolie hitting back brad pitt latest filing ongoing child support battle^teri hatcher calls reports broke homeless hurtful untrue^ryan seacrest texted kris jenner live air ask kylie jenner pregnant happened^chris pratt spotted grabbing coffee mystery blonde wednesday see new pics^justin theroux zips streets morning bike ride^scott disick sofia richie kick holiday weekend double date^sofia richie celebrates th birthday boyfriend scott disick mexico^scott disick girlfriend sofia richie step dinner malibu th birthday trip mexico^sofia richie showing super hot bikini bod mexico^scott disick sofia richie kick holiday weekend double date^sofia richie celebrates th birthday boyfriend scott disick mexico^scott disick girlfriend sofia richie step dinner malibu th birthday trip mexico^sofia richie showing super hot bikini bod mexico^brad pitt has breakdown brad pitt 8217 vintage motorcycle breaks residential area near frank..^rachel bilson eddie cibrian smiles taking break filming upcoming series taketwo in^heidi klum shows killer bikini body^rachel platten pregnant first child read announcement post^anna kendrick kristen stewart impression tv last night it pretty spot^kendall jenner shows lip tattoo got drunk watch^the name oscar isaac two month old son revealed ... named baby late mother^pink named cover star people annual most beautiful issue she posed kids cove^blac chyna packs pda year old boyfriend ybn almighty jay lashed ladies event la^the full list nominees mtv movie amp tv awards released blackpanther scoring nomi^dance moms abby lee miller reacting prison sentence year day^bachelor paradise carly waddell evan bass eecting first child together^'teen mom star mackenzie mckee mom diagnosed stage four brain cancer^taylor swift amp boyfriend joe alwyn photographed together first time months^taylor swift photographed first time months^ah outlander engaged she debuted engagement ring tonight goldenglobes check^youtube star austin jones arrested two counts child pornography charges^surprise tosh comedian daniel tosh secretly married two years^harvey weinstein faces another rape allegation new class action lawsuit^shailene woodley spilling dating life fijian rugby player ben volavola^shailene woodley spilling dating life fijian rugby player ben volavola^taylor swift new song gorgeous listen stream read lyrics^'ladies london star annabelle neilson reported cause death revealed^tony awards nominations see complete list here^former disney star tiffany thornton pregnant third child^reports emerging rachel mcadams pregnant first child here know^why n't lorde performing grammys tonight here source saying happened^pregnant first child celebrated baby shower weekend^hugh hefner cause death revealed^singer elle king says skipped wedding weekend ...^north west apparently really like brother saint west kim kardashian says n't phase watch^mindy kaling reportedly pregnant first child get details^mindy kaling pregnant first child revealed mindyproject final season details today^comedian louis ck accused sexual misconduct five women^my big fat greek wedding actress lainie kazan arrested today shoplifting^former mtv vj jesse camp reported missing sister hours stopped police^good news former mtv vj jesse camp reported missing family found^the goldenglobes live streamed first time year here watch^the title americanhorrorstory season revealed^anna wintour hosted daughter wedding home weekend congrats bee shaffer amp francesco carrozzini^anna wintour daughter bee shaffer francesco carrozzini got married second time smaller ceremony in^gabrielle union jada pinkett smith open year feud watch^bryan singer reportedly fired directing job queen biopic bohemian rhapsody^says wants marry frances mcdormand watch^rumors swirling michael fassbender alicia vikander getting married next month^michael fassbender alicia vikander rumored getting married weekend celebrated friday^jennifer lawrence darren aronofsky split year dating^mila kunis makes monthly donation planned parenthood vp mike pence name^joel kinnaman says regrets letting will smith give tattoo^nina dobrev glen powell reportedly dating get scoop^taylor swift music video director says believes beyonce copied taylor bad blood video^jennifer hudson joins thevoice coach season^meghan markle stepped today austin attending pippa middleton wedding prince harry see photos^gameofthrones stars kit harington rose leslie married see pics wedding^is michelle williams engaged a new report emerged saying getting married boyfriend andrew youman^kevin federline wants increase 20,000 monthly child support britney spears^katharine mcphee david foster engaged^the complete list billboard music awards nominations check full list^the full list billboard music awards nominations see stars nominated year^yes amp jimmy fallon hilarious fast dance '70s slow jams watch^watch kendall jenner kourtney kardashian answer ellen degeneres burning questions^nick jonas joe jonas step double date night priyanka chopra sophie turner^ryan murphy shared first look cory monteith farewell episode today w ...^here first look susan sarandon amp jessica lange ryan murphy upcoming show feud^jennifer aniston made first appearance red carpet since split justin theroux^it official scandal ending season seven read shonda rhimes said statement^tyga responding reports ex kylie jenner pregnant n't lot say ...^jennifer lopez returning 'will amp grace playing two different characters^pauley perrette made official leaving ncis seasons read statement",101,66,-35,167,0.6047904191616766,-0.20958083832335328,1
16312576,EW,5808,6644781,25581,238352,0,2,46,115,keeping plugged pop culture,in interview ew john mccain shared pop culture favorites including abba batman^in interview ew john mccain shared pop culture favorites including abba batman^twitter heartbroken jennifer aniston justin theroux split^twitter heartbroken jennifer aniston justin theroux split^chris pratt files divorce anna faris^chris pratt files divorce anna faris^donald trump blasts kathy griffin beheading photo^american idol season finale the best twitter reactions^sarah jessica parker suggests ellen degeneres play samantha sex city^hannibal buress arrested disorderly intoxication miami^fergie josh duhamel cutest couple moments split^celebrities react social media betsy devos confirmation secretary education^celebrities react superstar glen campbell death^celebrities react release trump tax returns social media^katie couric breaks silence matt lauer sexual misconduct allegations today firing^katie couric opens matt lauer firing today show^kaley cuoco gives update shoulder surgery recovery 'ice best friend^urges gwen stefani convince blake shelton vote trump^shannen doherty charmed reboot 'terrible offensive description^charmed turns shannen doherty loving prue n't want appear reboot charmed20^charmed turns shannen doherty elains n't want appear reboot^lorde sets record straight taylor swift friendship fiery letter^amal george clooney welcome twins^julia roberts says seeing pretty woman the musical 'bittersweet^selena gomez 'remarkable split the weeknd reuniting justin bieber^jack nicholson gave great performance seven takes a few good men^ariana grande leads support victims london terror attack^megyn kelly trashes donna karan defending harvey weinstein^jennifer lawrence darren aronofsky split year together^jessica alba cash warren welcome son hayes alba^the weeknd bares broken heart new ep selena gomez split^selena gomez 'remarkable split the weeknd reuniting justin bieber^celebrities salute troops veterans day^american idol contestant apologizes katy perry admitting idolizes taylor swift^robert pattinson near firing twilight i playing edward 'a little bit miserable^game thrones costars kit harington rose leslie engaged^travis scott pleads guilty disorderly conduct allegedly inciting riot concert^blake lively keeps dark secret anna kendrick a simple favor trailer^teri hatcher denies 'broke homeless living van^teri hatcher denies 'broke homeless living van^teri hatcher denies 'broke homeless living van^teri hatcher denies 'broke homeless living van^katie couric shares hilarious today show throwback dawn internet^celebs rip 'racist 'cowardly trump pardoning former arizona sheriff joe arpaio^celebs rip racist cowardly trump pardoning former arizona sheriff joe arpaio^here everyone donald trump called overrated twitter since^selena gomez reveals kidney transplant due lupus^american idol contestant apologizes katy perry admitting idolizes taylor swift^mario batali includes cinnamon roll recipe sexual misconduct apology^giuliana rancic returning co host e news 'best friend jason kennedy^ryan reynolds reveals saved nephew life^emma watson beauty beast coming netflix september^queen elizabeth sits next anna wintour front row london fashion week^strangerthings officially renewed season^strangerthings officially renewed season but return^pink graces cover people beautiful issue two kids^james franco denies sexual misconduct allegations colbert interview^here picks best tv shows year see^the mindy project fortune feimster engaged mindy kaling 'will officiate wedding^luann de lesseps accuses russell simmons groping elevator^glee star charice pempengco changes name jake zyrus^glee star charice pempengco changes name jake zyrus^tony awards see full list winners^tisha campbell martin files divorce husband duane years marriage^outlander star caitriona balfe engaged^lin manuel miranda grandmother dies christmas 'my heart pieces^jessica chastain talks join sequel stephen king it^darren criss engaged girlfriend mia swier years dating^'glee alum lea michele engaged boyfriend zandy reich^the twilight saga almost went without robert pattinson the actor nearly fired first film^marvelous mrs. maisel star rachel brosnahan pays tribute aunt kate spade^sam smith gender fluid identity 'i feel much woman i man^and winner bigbrother season ...^luann de lesseps apologizes arrest saying palm beach brought long buried emotions^see complete winners list cmaawards^ellen page accuses brett ratner homophobic abusive behavior x men the last stand^how to get away with murder karla souza gives birth first child 'welcome baby girl gianna^idina menzel marries rent costar aaron lohr^'jesus christ superstar nbc next live musical^'jesus christ superstar nbc next live musical^jeopardy host alex trebek recovering surgery remove blood clots brain^oprah winfrey visits grave recy taylor golden globes tribute^watch adam driver surprise military family scholarship^ariana grande named first honorary citizen manchester i know say words suffice^bachelor paradise demario jackson says spending valentine day corinne olympios^dancing with stars pros emma slater sasha farber married^ariana grande cancels vietnam concert due health problems^anne hathaway reveals gaining weight role preemptively shuts body shamers^ryan reynolds responds blake lively marriage rumors 'i could use little time^hugh hefner cause death revealed^drake stages epic degrassi reunion 'i 'm upset video^meghan markle officially leaving suits season^meghan markle officially leaving suits season^meghan markle dad wo n't attend royal wedding revealed staged photos^new york film critics circle winners announced see full list^ed westwick accused sexual assault third woman^pink reveals christina aguilera tried punch 'she swung club^did chris evans jenny slate break^american horror story emma roberts might return cult^former mtv vj jesse camp reported missing police say^americanhorrorstory season title finally revealed ahs^american horror story season title revealed soon^simon cowell rushed hospital cary accident london home^cw fall premiere dates revealed sarah michelle gellar returns tv ringer^the cw fall premiere dates revealed^here full schedule freeform nights halloween^tessa thompson clarifies lena dunham time up comment^kendra wilkinson files divorce hank baskett nearly years marriage^big bang theory star kaley cuoco marries equestrian karl cook^michael fassbender alicia vikander married^does photo prove amelia earhart survived final flight^eric dane responds rebecca gayheart divorce filing^jennifer lawrence director darren aronofsky split year dating^jennifer lawrence darren aronofsky split year together^kaley cuoco engaged boyfriend karl cook watch emotional reaction proposal^just in lauren cohan says returning thewalkingdead season twd^billy bush wife sydney davis files divorce months separation report^chris hemsworth says contractually done thor 'avengers^chris hemsworth says 'contractually done thor avengers^how get away murder star karla souza alleges raped director mexico^rebecca gayheart files divorce from eric dane years marriage^th heaven actor jeremy london arrested alleged domestic violence^th heaven actor jeremy london arrested alleged domestic violence^billboard music awards see complete winners list^lady gaga announces las vegas residency show details^bachelor paradise taylor nolan derek peth get engaged^ben affleck matt damon production company adopt inclusion riders^sophia bush leaving chicagopd seasons^this is us everything need know season^fox next live musical rent^katharine mcphee david foster engaged^after seasons theoriginals officially coming end^tom daley dustin lance black eecting first child^everything know reasons why season^billboard music awards see complete winners list^here exclusive first look ryan murphy new horror comedy^pose your first look transgender cast ryan murphy groundbreaking new series^your exclusive first look ryan murphy addictive series starring amp jessica lange^first look ryan murphy creepy 'american horror story video^kate winslet leonardo dicaprio still quote titanic lines^usher wife grace miguel separate two years marriage^kevin can wait kill erinn hayes character fall^gwyneth paltrow denies amber rose claim beyonc becky good hair^reasonswhy officially renewed season^black panther tweeted movie time^it official 'avengers infinitywar exceeded eectations deliver biggest box office opening all^rod stewart mocks elton john retirement tour 'it stinks selling tickets dishonest^bridget jones diary ocean eleven high school musical among titles leaving netflix may^meghan markle kate middleton step first ever solo outing together wimbledon^the bachelor bekah m. elains mom reported 'missing^richard simmons hospitalized severe indigestion says manager^kelly clarkson host billboard music awards^jamie lee curtis return laurie strode new halloween film^harvey weinstein georgina chapman reach divorce settlement^sarah hyland boyfriend dominic sherwood break^judge declares mistrial bill cosby sexual assault case^gotham awards see complete winners list^batesmotel come end our series finale recap^freddie highmore batesmotel series finale that end^chris pratt files divorce anna faris^chris pratt files divorce anna faris^morningjoe co hosts joe scarborough mika brzezinski engaged^pauley perrette leaving ncis seasons,46,117,71,163,0.2822085889570552,0.4355828220858896,0
14353891,OKMagazine,4172,476905,2616,120009,0,0,130,28,ig alwaystrending snapchat okmagazine,gigi hadid amp boyfriend zayn malik on the rocks^kim kardashian west begs tristan thompson unblock instagram^kanye west seemed miserable party kim kardashian^are angelina jolie brad pitt getting married this year^are angelina jolie brad pitt getting married this year^are angelina jolie brad pitt getting married this year get scoop^are angelina jolie brad pitt getting married this year^are angelina jolie brad pitt getting married this year get scoop^beyonc is afraid jay z will cheat again^it official gwen stefani amp blake shelton are married^it official gwen stefani amp blake shelton are married^it official gwen stefani amp blake shelton are married^it official gwen stefani amp blake shelton are married^caitlyn jenner plays surrogate mom to struggling kanye west^celeb baby news naked baby bump gorgeous baby girl amp more^it over chris pratt files for divorce from anna faris^it over chris pratt files for divorce from anna faris^it over chris pratt files for divorce from anna faris^revenge body taylor swift desperate to have the 'perfect figure following tom hiddleston split^ok chatted malin akerman last night wanderlust co stars jen aniston justin theroux falling love set stay tuned^the plan get jennifer lopez ben affleck back together^cover story the plan get jennifer lopez ben affleck back together^are jennifer aniston and brad pitt having a baby together^heading for a split gwen stefani trust issues with blake shelton eed^find real reason justin bieber selena gomez taking break^did kourtney awkward run sofia richie^does pay talk show host you betcha find michael strahan net worth here^michael strahan by the numbers and you wo n't believe his net worth^robert pattinson is really crushing on margot robbie^robert pattinson is really crushing on margot robbie^robert pattinson is really crushing on margot robbie^divorce hold julia roberts amp danny moder reunite seen together months^angelina jolie livid ca n't travel six kids amid messy custody war brad pitt^whitney ex bobby brown cheats death loses of his blood in harrowing medical crisis^it over liam hemsworth cancels wedding to miley cyrus did they break off their engagement again^watch kourtney kardashian another emotional breakdown kuwtk^mackenzie foy says robert pattinson amp kristen stewart sweetest people curse kstew^gigi hadid amp boyfriend zayn malik on the rocks^relationship pick me up jt wants jessica biel get breast lift^ok exclusive tristan sex ban khloe kardashian is 'furious thompson refuses to be intimate in the bedroom^bachelorette pad julia roberts buys 6.84 million home amid rumors of divorce from danny moder^divorce hold julia roberts amp danny moder reunite seen together months^miley cyrus and liam hemsworth are shopping for cribs^miley cyrus and liam hemsworth are shopping for cribs^miley cyrus and liam hemsworth are shopping for cribs^miley cyrus and liam hemsworth are shopping for cribs^how brad pitt amp angelina jolie 'cut down on the fighting in divorce^meghan markle dad is 'extremely hurt by prince harry claim that she never had a real family^meghan markle dad is 'extremely hurt by prince harry claim that she never had a real family^travis scott thrilled his baby mama kylie jenner is nearly a billionaire^david foster speaks first time since proposing katharine mcphee^did kourtney awkward run sofia richie^latest developments inside beyonce secret delivery room drama twins^did kylie jenner already give birth reasons why fans think she had her baby^did kylie jenner already give birth reasons why fans think she had her baby^did kylie jenner already give birth reasons why fans think she had her baby^did kylie jenner already give birth reasons why fans think she had her baby^catfight continues jealous kim kardashian attempts steal beyonce twin thunder^gwen stefani happy blake shelton wrote revenge song cameheretoforget divorce miranda lambert^second thoughts inside miley cyrus amp liam hemsworth horrid honeymoon drama^their first fight meghan markle 'insulted prince harry wants her to sign prenup^their first fight meghan markle 'insulted prince harry wants her to sign prenup^their first fight meghan markle 'insulted prince harry wants her to sign prenup^lamar odom begged khloe kardashian film phone calls kuwtk why betrayed ex^finally a mom photos prove year old jennifer aniston pregnant justin theroux baby^finally a mom photos that prove year old jennifer aniston is pregnant with justin theroux baby^taylor swift accused kim kardashian bully^where dad braless angelina jolie takes kids disneyland amid divorce drama^celeb baby news naked baby bump gorgeous baby girl amp more^insider claims gwen stefani calls off wedding to blake shelton^see photos brody jenner bali wedding weekend^brody jenner says sisters kylie and kendall never even rsvp'ed to his wedding^kourtney kardashian luka sabbat attended party together amid breakup rumors^for today edition mystery date katie holmes steps nyc unidentified man and smiley^double date suri cruise gets special outing katie holmes and mystery man^shots fired kanye west nicki minaj amp tekashi ix9ine music video shoot^latest developments inside beyonce secret delivery room drama twins^kate hudson by numbers get scoop her massive net worth^kate hudson by numbers get scoop her massive net worth^katie holmes stops beau jamie foxx hotel new york^first look photos nicole kidman aquaman mom^too close for comfort jennifer lopez might take a break from alex rodriguez^too close for comfort jennifer lopez might take a break from alex rodriguez^inside maksim chmerkovskiy amp peta murgatroyd 'marital issues^ok exclusive kendall and kylie jenner getting their own spinoff show and kim kardashian is jealous as hell^bradley cooper amp irina shayk relationship on the rocks^chelsea handler most naked moments eed why her scandalous photos are causing a feud with jennifer aniston^'bachelor paradise star kristina schulman teases return dating show^kylie jenner left heartbroken after travis scott bails on her baby shower^kylie jenner left heartbroken after travis scott bails on her baby shower^kylie jenner left heartbroken after travis scott bails on her baby shower^depressed justin bieber hailey baldwin selena gomez looked sad nyc^depressed justin bieber amp hailey baldwin selena gomez looks sad nyc^katie holmes stops beau jamie foxx hotel new york^kate middleton speaks we know 're freaking^meghan markle drops major hint that she moving to the uk to be with prince harry^meghan markle drops major hint that she moving to the uk to be with prince harry^meghan markle drops major hint that she moving to the uk to be with prince harry^jennifer lopez alex rodriguez slay brunch like one else^teresa giudice broke^caitlyn jenner big book reveal i had the final surgery bye bye penis^insider claims gwen stefani calls off wedding to blake shelton^how brad pitt handling things amid custody battle ex angelina jolie^tristan thompson shut khloe kardashian demand watch kuwtk cheating episodes^heartbroken khloe kardashian laid emotions bare live tweeting kuwtk^enough is enough kris jenner orders scott to return home after boozy miami bender^jessica simpson heartbroken her family destroyed inside her father prison nightmare more^jessica simpson heartbroken her family destroyed inside her father prison nightmare more^jessica simpson heartbroken her family destroyed inside her father prison nightmare more^jessica simpson heartbroken her family destroyed inside her father prison nightmare more^khloe kardashian spent 3 million sexy body transformation believe^khloe kardashian has spent over 3 million for her sexy body transformation^jennifer aniston dating divorce justin theroux^meghan markle mom doria ragland plans make big movie u.k.^keeping distance prince william amp kate middleton struggle hide marriage tension pippa wedding^did kourtney awkward run sofia richie^did kourtney awkward run sofia richie^ok exclusive balding bieb justin bieber is losing his hair thanks to peroxide obsession^angelina jolie recalls emotional breakdown shower brad pitt found crying angelinajolie bradpitt^angelina jolie recalls emotional breakdown shower brad pitt found crying^hot or not see heidi klum bikini body without airbrushing^getting hitched sandra bullock wedding plans to boyfriend bryan randall eed^wedding bells sandra bullock shows off suspicious ring amid engagement rumors^getting hitched sandra bullock wedding plans to boyfriend bryan randall eed^nude hack attack brad pitt rumored new fling sienna miller 'devastated photo leak^kate hudson by numbers get scoop her massive net worth^kate hudson by numbers get scoop her massive net worth^say ai n't brad pitt going quit acting three years noooo^ungrateful b*tch kim kardashian war kylie jenner stolen style threatening sue^kim kardashian war kylie jenner stolen style^anna kournikova and enrique iglesias welcome twins^michelle williams secretly married how found love heath ledger death^mark salling real cause death revealed^met gala red carpet arrivals see what the stars are wearing^kylie jenner shows off foot pink christmas tree in honor of baby girl^kylie jenner shows off foot pink christmas tree in honor of baby girl^pregnant i 'm not having twins jessicasimpson fashionstar^pregnant i 'm not having twins jessicasimpson fashionstar^pregnant i 'm not having twins jessicasimpson fashionstar^prince charles will walk meghan markle down the aisle at royal wedding^kaley cuoco marries her professional equestrian boyfriend karl cook^nick jonas priyanka chopra engaged^john david duggar abbie burnett engaged^david foster katharine mcphee engaged^mama june daughter lauryn 'pumpkin shannon gives birth to a healthy baby girl^mama june daughter lauryn 'pumpkin shannon gives birth to a healthy baby girl^mama june daughter lauryn 'pumpkin shannon gives birth to a healthy baby girl^serena williams withdraws from australian open after admitting she not where she wants be after giving birth^serena williams withdraws from australian open after admitting she not where she wants be after giving birth^serena williams withdraws from australian open after admitting she not where she wants be after giving birth^josiah duggar has a girlfriend meet the counting on star new lady lauren swanson^josiah duggar has a girlfriend meet the counting on star new lady lauren swanson^josiah duggar has a girlfriend meet the counting on star new lady lauren swanson^luann de lesseps sued by her own kids amp ex husband days after family reunion^it over chris pratt files for divorce from anna faris^it over chris pratt files for divorce from anna faris^it over chris pratt files for divorce from anna faris^april giraffe pregnant,130,28,-102,158,0.8227848101265823,-0.6455696202531646,1
22650211,GMA,2440,3674437,17026,221592,0,5,123,25,put good morning watch around clock watch pm et/12pm c/p weekdays,"now on memory lapse trump seeks distance 'advisor past ties mafia^now on memory lapse trump seeks distance 'advisor past ties mafia^'the best person ever really beloved doctor tamara o'neal one four shooting victims gunned chi^watch it time senate job nominating adam szubin undersecretary terrorism^u.s trade war china escalates pres trump puts tariffs 34 billion worth chinese goods^tomorrow hello dolly goes one one legendary^coming up prince harry meghan markle still making royal rounds touching tonga^prince harry meghan markle still making royal rounds touching tonga brings^coming up prince harry meghan markle still making royal rounds beautiful tonga^it 's time gmaday doubledare^channeling 'the a team i pity fool n't like tv halloweenongma^coming up on gmaday sitting tune^end week high note join us lunch gmaday starts right now .^red team members jennifer jacob delfosse shutting doubledare gmaday^full gmaday doubledare obstacle course^doubledare time on gmaday doubledare^alllll revealed coming gmaday amp starting pet a big surprise^tomorrow on gmaday with times square tune^yassss giving shoutout halloweenongma^it lunch time america gmaday starts right now tune^werk that runway holidaysweaters holidays gmaday^coming up on gmaday abc amp^this afternoon on gmaday making tv debut announced first ever sexiestchef alive doin^military veterans retired athletes come la unbreakable performance center support ot^let lunch america gmaday starts right now amp get to a tv^do n't put toes ears talk annoying movie theater habits wha^next tune gmaday^gmadayhalloween ahead abc check defying laws of^coming up on gmaday performing times square starting pet^ahead on gmaday gmaday amp lunch he named^gmaday starts right now amp abc get to a tv^coming up on gmaday amp pet abc hennyyyy we scream^tag your wheel barrel buddy doubledare^coming up on gmaday talks walkingdead new dad and^this afternoon gmaday amp^this friday first gmaday amp superstars^ooooh going down times square get to a tv coming up on gmaday doubledare^year old recovering shark attack caused get ,000 stitches tells defin^tomorrow gmaday talking things starz tune^tomorrow on gmaday amp lunch tune starting^this ... happen gmaday amp starting pet abc do not miss^next times square tune gmaday^have great gmaday everyone doubledare^thursday on gmaday amp amp perform dreamer times square^next dropping times square chat tune now gmaday^you guys ... with his mom times square gmaday amp^gmaday starts right now amp abc get to a tv^coming up starz joins times square tune gmaday^this afternoon on gmaday amp catch amp chadlovesmichelle^have spooktacular lunch us america gmaday starts right now tune in^let lunch america gmaday starts right now tune^next amp talking amp tune in cmas^oh shoot roommate talking dating deal breakers what one deal bre^coming up talking things tune in^tomorrow on gmaday do n't miss chat tune p et/ p^america top young scientist next science fair showdown and^it lunch time america gmaday starts right now tune^gmadayhalloween sneak peek it coming abc kid inspired costumes^whelp what said have gmaday everyone^tomorrow gmaday amp lunch th grader he named^the finished product looks tasty gmaday ketoguito keto^next on gmaday showing side hustle tune^as says women make best sharks she taking '^somethings right here gmadayhalloween gmaday^coming up sitting tune gmaday^wait there 's more catch even gmaday amp startin^this afternoon on gmaday joining times square tune at^make me rich pitch tries convince invest rubber hand^meet finalists first ever sexiestchef the winner joins us this afternoon first tv ap^tomorrow on gmaday amp amp perform dreamer times square^it s official according kiltdaddy kiltdaddy2 gmaday^pro football hall famers join game draw^omg carefully writing qualifications future husband^it lunch time america gmaday starts right now tune^tomorrow catch first live times square starting amet then gmaday with^she coming up gmaday amp^here he is louis maldonado people magazine first ever sexiestchef alive he making tv debut right her^coming up on gmaday talking upcoming tour tune p e^spoiler alert get little ... messy ... gmaday coming times square doubledare^coming up john slattery sitting tune^tubular oops ... zee halloweenongma happyhalloween^comes bearing gifts a sweater^tomorrow catch amp live times square starting amet then gmaday with^check holiday sweater stocking thanks holidaysweaters holidays^gmaday coming up abc amp an incredibly inspiring performance by^dictionary time traveler you see words merriam webster added dictionary year were^coming up on gmaday amp starting pet^tommorrow on gmaday do n't miss chat amp pet^our spooky stunt defying laws nature gmadayhalloween gmaday^yesssssssssss gmaday doubledare^let lunch america gmaday starts right now tune^happyhalloween america zee^next do n't miss sit gmaday^tomorrow on gmday amp^coming up one sitting tune gmaday^coming up on gmaday amp doubledare^next sitting gmaday^let lunch america gmaday starts right now tune^hey america joins us gmaday amp this friday have questions f^coming up on gmaday making tv debut announced first ever sexiestchef alive lun^literally wrote husband list ... crying^tune in to gmaday lunch^coming gmaday first tv appearance the newly crowned sexiestchef alive he joins^it lunch time america gmaday starts right now tune^demi lovato transported los angeles area hospital stable condition suspected overdo^top story demi lovato transported los angeles area hospital stable condition suspe^more george clooney amal clooney welcome twins^was kelly osbourne 250k emmy manicure offensive^kelly osbourne sued ozzy former mistress michelle pugh^kelly osbourne wants loved^kelly osbourne headed back work health scare^would hoola hoop lose weight kelly osbourne lost inches week hoola hooping^kelly osbourne headed back work health scare^kelly osbourne speaks indiscriminate nature addiction wake demi lovato apparent overdo^kelly osbourne speaks indiscriminate nature addiction wake demi lovato apparent overdo^kelly osbourne reveals plans 'one day surgery angelina jolie^kelly osbourne says mom put padded cell get drugs^kelly osbourne says mom put padded cell get drugs^would hoola hoop lose weight kelly osbourne lost inches week hoola hooping^meghan markle captured world attention wedding gown secrets behind making^coming up duchess meghan markle takes us behind scenes wedding day reveals secrets inside gown^coming up on west coast more details divorce angelina jolie pitt brad pitt^coming up on more details divorce angelina jolie pitt brad pitt^coming up on west coast more details divorce angelina jolie pitt brad pitt^coming up on more details divorce angelina jolie pitt brad pitt^brad pitt fires back divorce battle angelina jolie angelina reps saying asking brad pay^ciara russell wilson welcome first child together sienna princess wilson^how brad pitt angelina jolie coached daughter vivienne young princess aurora^deadpool star reveals saved nephew life taking cpr course^jada pinkett smith calls tupac shakur biopic 'deeply hurtful^former dance moms star abby lee miller sentenced one year day federal prison^dance moms star abby lee miller sentenced year day federal prison bankruptcy fraud amo^james franco denies sexual misconduct allegations says things i heard twitter accu^top story james franco denies sexual misconduct allegations says things i heard twitter a^magical harry potter river cruise set sail summer^soooo magical harry potter river cruise set sail summer ...^finally april giraffe finally gives birth baby born million watch live online^joins forces working together weight watchers named s^billy bush wife sydney davis separate years marriage 'to evaluate life together'^first look 'wonder woman reveals steve trevor still alive wonderwoman ww84^first look 'wonder woman reveals steve trevor still alive wonderwoman ww84^roger ailes founder former chairman ceo fox news resigned dead age^'big bang theory star kaley cuoco marries karl cook see reception jumpsuit^clarkson perform together first time open amas sunday /7c on^prince harry says wanted british royal family^after big oscars night allison janney went right back day job showing oscar statue scrip^twitter officially doubling character count across world^everything need know princess eugenie jack brooksbank royal wedding weekend^apologizes alleged groping incident she right speak amp demand an^nina simone bon jovi moody blues among rock amp roll hall fame inductees^miss missouri sophia dominguez heithoff crowned miss teen usa^richard simmons better hospitalized severe indigestion rep exclusively tells news^all details prince harry meghan markle wedding rings",123,30,-93,153,0.8039215686274509,-0.6078431372549019,1
19074134,marieclaire,1819,2257067,11812,131337,0,0,113,35,if matters women marie claire,kim kardashian seems miserable following kanye west hospitalization^the kardashians successfully blocked blac chyna request trademark angela kardashian^brad pitt man arguably created soul crushing hotness here proof^kate upton makes jab kardashian plastic surgery rumors recent snapchat selfie more news^kate middleton photographed first time since leaving hospital with prince louis^kate middleton photographed first time since leaving hospital with prince louis^things get body^things get body^the full downward spiral justin bieber selena gomez relationship^the full downward spiral justin bieber selena gomez relationship^the full downward spiral justin bieber selena gomez relationship^the full downward spiral justin bieber selena gomez relationship^the full downward spiral justin bieber selena gomez relationship^the full downward spiral justin bieber selena gomez relationship^the full downward spiral justin bieber selena gomez relationship^the full downward spiral justin bieber selena gomez relationship^the full downward spiral justin bieber selena gomez relationship^the full downward spiral justin bieber selena gomez relationship^the full downward spiral justin bieber selena gomez relationship^the full downward spiral justin bieber selena gomez relationship^the full downward spiral justin bieber selena gomez relationship^the full downward spiral justin bieber selena gomez relationship^the full downward spiral justin bieber selena gomez relationship^the full downward spiral justin bieber selena gomez relationship^a important timeline relationship^a important timeline relationship^a important timeline relationship^a important timeline relationship^a important timeline relationship^a definitive timeline miley cyrus liam hemsworth relationship^a important timeline relationship^a important timeline relationship^a important timeline relationship^a important timeline relationship^a important timeline relationship^a important timeline relationship^a important timeline relationship^a definitive timeline relationship^a important timeline relationship^an obsessive timeline prince harry meghan markle relationship^anna faris admits she was jealous ex chris pratt costar jennifer lawrence^sarah jessica parker confirms 'sex city movie could still happen^kim cattrall responds sarah jessica parker latest 'sex city comments^here fergie josh duhamel split^royal family drama alert did pippa middleton ban meghan markle wedding^did pippa middleton ban meghan markle her wedding^katie couric breaks her silence on matt lauer firing from the 'today show^the crown cast prince charles queen mother upcoming season^justin bieber selena gomez were caught making out after church^lady gaga reveals heartbreaking reason she split taylor kinney^khlo kardashian reveals what fast food she eats when she trying stay shape^the most embarrassing clips 'keeping up kardashians kris jenner probably wishes she could wipe from^a complete timeline brad pitt jennifer aniston relationship^ryan reynolds responds rumors his marriage blake lively is in trouble^justin bieber deliberately hides left hand amid rumors that he hailey baldwin are already married^kendall jenner faux baby bump kinda cute weird^the most embarrassing clips 'keeping up kardashians kris jenner probably wishes she could wipe from^trump idea civil war happened twitter field day^you wo n't believe what ben affleck is doing his single life^selena gomez may have sent secret message justin bieber her latest instagram^could imagine friends without lisa kudrow jennifer aniston see celebs turned rol^could imagine friends without lisa kudrow jennifer aniston see celebs turned rol^could imagine friends without lisa kudrow jennifer aniston see celebs turned rol^could imagine friends without lisa kudrow jennifer aniston see celebs turned rol^could imagine friends without lisa kudrow jennifer aniston see celebs turned rol^could imagine friends without lisa kudrow jennifer aniston see celebs turned rol^could imagine friends without lisa kudrow jennifer aniston see celebs turned rol^could imagine friends without lisa kudrow jennifer aniston see celebs turned rol^meghan markle prince harry reportedly told royal family their baby news princess eugenie wedding^jennifer aniston justin theroux much sexual jen brad pitt^could imagine friends without lisa kudrow jennifer aniston see celebs turned rol^could imagine friends without lisa kudrow jennifer aniston see celebs turned rol^could imagine friends without lisa kudrow jennifer aniston see celebs turned rol^someone confirmed katie holmes jamie foxx *are* dating^does this photo finally confirm katie holmes jamie foxx are dating^david beckham hotness evolution in photos^david beckham hotness evolution in photos^kanye west has reportedly had elosive fights kris jenner^angelina jolie breaks her silence divorce^a new report details fight that led brad pitt angelina jolie divorce^kendall jenner faux baby bump kinda cute weird^kylie jenner reportedly misses her old life pre pregnancy^travis scott reportedly pleads guilty disorderly conduct^while freaking bey kate middleton recall emotional stages beyonc fan^prince harry meghan markle rumored be moving countryside^meghan markle might have dropped biggest hint she moving u.k. prince harry^prince harry meghan markle are officially moving new cottage windsor kensington palace confirms^this 'keeping up kardashians clip might elain why kendall jenner is skipping fashion week^a new report details fight that led brad pitt angelina jolie divorce^ryan seacrest texted kris jenner ask about kylie pregnancy live tv here what she wrote back^meghan markle excited priyanka chopra engagement nick jonas^meghan markle excited priyanka chopra engagement nick jonas^meghan markle excited priyanka chopra engagement nick jonas^meghan markle excited priyanka chopra engagement nick jonas^kylie jenner could not look more bored ryan reynolds met gala if she tried^kanye west is reportedly talks judge 'american idol reboot^justin theroux talks about divorce jennifer aniston first time^justin theroux talks about divorce jennifer aniston first time^kanye west has reportedly had elosive fights kris jenner^meghan markle prince harry reportedly told royal family their baby news princess eugenie wedding^how princess eugenie royal wedding meghan markle prince harry compare^how princess eugenie royal wedding meghan markle prince harry compare^selena gomez reveals she had kidney transplant over summer^angelina jolie brad pitt divorce will be finalized very soon^prince harry may be missing meghan markle according this sweet sign^prince harry may be missing meghan markle according this sweet sign^prince harry may be missing meghan markle according this sweet sign^prince harry may be missing meghan markle according this sweet sign^prince harry may be missing meghan markle according this sweet sign^prince harry may be missing meghan markle according this sweet sign^prince harry may be missing meghan markle according this sweet sign^everyone thinks jennifer aniston brad pitt are getting back together^scott disick kourtney kardashian are officially back together^courtney love warned young women about harvey weinstein^ed sheeran says beyonc changes her email address every week^ed sheeran is engaged his girlfriend cherry seaborn^things know about pippa middleton fianc james matthews^ashton kutcher pays tribute mila kunis their kids emotional heartwarming speech^everything you need know about designer behind pippa middleton wedding dress^rachel mcadams is reportedly pregnant her first child^ryan reynolds responds rumors his marriage blake lively is in trouble^jennifer lawrence is proud middle school dropout^meghan markle dad will reportedly no longer attend royal wedding^kit harington rose leslie wedding date has been revealed^kit harington rose leslie wedding date has been revealed got^outlander renewed seasons^'outlander renewed seasons^everything we know so far about pippa middleton wedding^gwen stefani says blake shelton ex girlfriend was obsessed her^this iconic actress might play princess diana 'feud season^taylor swift music video director says beyonc copied bad blood which ... yikes^khlo kardashian reveals her biggest parenting fear^priyanka chopra nick jonas are reportedly engaged after just two months dating^priyanka chopra nick jonas are reportedly engaged after just two months dating^priyanka chopra nick jonas are reportedly engaged after just two months dating^priyanka chopra nick jonas are reportedly engaged after just two months dating^surprise ariana grande pete davidson are reportedly engaged^why meghan markle prince harry did n't sit together pippa middleton wedding^the best labor day sales furnish your entire home^the best labor day sales furnish your entire home^bradley cooper irina shayk welcome their first child^michelle williams is reportedly engaged andrew youmans^lena dunham apologizes defending girls writer accused sexual assault rape^'rent is officially fox next live musical^katy perry addresses those plastic surgery rumors reveals what procedures she has done^ryan murphy finally shared first look jessica lange return american horror story^ryan murphy finally shared first look jessica lange return american horror story^ryan murphy finally shared first look jessica lange return american horror story,113,35,-78,148,0.7635135135135135,-0.527027027027027,1
15856435,MSN,757,236606,1589,173980,1,3,74,67,the official twitter page us,undergoes kidney surgery walter reed medical center^criminal inquiry sought hillary clinton use email^full transcript the stormy daniels minutes interview^key moments trump interview fox friends with fact checks^vanessa lachey maks chmerkovskiy hug it out amid dancing with stars feud^katherine heigl mom causing marriage problems after moving in to help with baby^lindsay lohan unusual dance moves mykonos go viral^shows off growing baby bump^shows baby bump nyc pregnancy reveal^pregnant cradles baby bump form fitting maxi dress^pregnant jessica simpson glows first baby bump pic^even kate middleton luxury hospital stay costs less typical birth america^prince harry girlfriend meghan markle finally meets queen elizabeth^national enquirer apologizes to judge judy for false alzheimer story^embarrasses gwen stefani onstage talks about when they first started 'mess around together^how church scientology seemingly protected danny masterson amid rape allegations^matt lauer inching 'his way back society 'today ousting^jenna dewan split nearly years marriage^fergie josh duhamel differences were 'a factor split 'this has been long time coming says source^fergie josh duhamel were 'leading separate lives long time before announcing split says insider^meghan markle mom doria ragland is looking forward becoming grandmother i 'm 'very happy^trevor noah death hoax uses christina grimmie death details^kim kardashian embarrassed kanye visit trump source^celebrities react superstar glen campbell death^see julia roberts birthday message richard gere^amy poehler dating^what katie couric would say matt lauer saw today^when did ben affleck lindsay shookus start dating the complicated timeline their romance^kathy griffin releases harvey levin phone number claims andy cohen asked her to do cocaine^shannen doherty charmed reboot 'terrible offensive description^meghan markle 'lost sleep relatives wedding nears source^lorde sets record straight taylor swift friendship fiery letter^beyonce did not reject kim kardashian baby gifts despite report^golden globes the complete list nominees updating live^'not despite new wife source^andy cohen calls kathy griffin accusations drug use '100 false^the dirt young brad pitt jason priestly says notorious showering hear story^miranda lambert revenge squad rallies around blake shelton moves on with gwen stefani^why meghan markle kate middleton are friendly not bffs^from sources say jennifer garner confronted lindsay shookus ben affleck relationship^justin theroux steps out year old model erika cardenas^see julia roberts birthday message richard gere^every political moment emmy awards^hoda kotb al roker amp craig melvin open megyn kelly today hour first show since cancellation^jenna dewan split nearly years marriage^shows off growing baby bump^shows baby bump nyc pregnancy reveal^pregnant cradles baby bump form fitting maxi dress^pregnant jessica simpson glows first baby bump pic^angelina jolie reveals 'i n't enjoy single amid new buzz brad pitt reconciling^why katie holmes jamie foxx never leave dinner date together^report kendall jenner rips caitlyn 'turning back family^dakota johnson chris martin 'definitely dating^musicians react mel tillis death^spied visiting katie holmes n.y.c amid romantic summer^angelina jolie 'relieved investigation brad pitt child abuse claims ended^travis scott pleads guilty disorderly conduct after allegedly inciting riot during concert^see julia roberts birthday message richard gere^spied visiting katie holmes n.y.c amid romantic summer^why is everyone freaking out over kate middleton fingers^teri hatcher denies 'broke homeless living van^matt damon hiding comments backlash what really going^brad pitt angelina jolie get trial date their custody battle^brad pitt angelina jolie ugly custody battle latest^brad pitt angelina jolie could messy custody battle get worse^angelina beams grocery run kids amid battle brad pitt^brad pitt ickened angelina jolie public custody battle source^teri hatcher denies 'broke homeless living van^katie holmes hiding baby bump what really going^are amy schumer john mayer dating^ashton kutcher don publish photos of my kids^anti defamation league rips larry david snl monologue for being insensitive^ariel winter slams media body shamers in twitter rant^this was prince harry meghan markle favorite moment their royal wedding^georgina chapman life harvey weinstein^letterman talks oprah public feuds sex scandal^shows off her insane bikini body while jumping into ocean next rainbow watch^john legend chrissy teigen 'on verge splitting despite report^mraz opens 'two spirit sexuality^today smartlist jacket causes stir house rejects hard right immigration bill koko gorilla^'vehemently denies rape sexual misconduct allegations new statement^princess eugenie is engaged jack brooksbank will marry same church prince harry^troy gentry helicopter crash caused engine failure new report details final moments fatal flight^jada pinkett recalls heated call will smith ex 'it house^friendly exes ryan seacrest congratulates 'stunning julianne hough her wedding brooks laich^glee star charice pempengco changes name jake zyrus after revealing 'my soul is male^kelly clarkson 'when i really skinny i wanted kill^clarkson 'when i really skinny i wanted kill^blake lively injured set 'the rhythm section production temporarily suspended^'love island star sophie gradon dead^naya rivera refiles divorce ryan dorsey arrest^harvey weinstein faces new rape allegation class action lawsuit^scott hutchison frightened rabbit frontman found dead police^summer phoenix reportedly files divorce casey affleck^tamar braxton files divorce from husband vincent herbert source^'dancing with stars pros emma slater sasha farber are married^'brady bunch house sale 1.85 million^mark salling autopsy reveals alcohol system^sag awards the complete winners list^'shot love tila tequila star ashley mcneely found dead report^'teen mom star jenelle evans david eason are married see pics^mtv movie amp tv awards the complete winners list^mtv movie amp tv awards the complete winners list^house cards producers consider killing off frank underwood exclusive^here 'house cards wrote kevin spacey frank underwood^frank avruch star bozo clown dies^chip welcome baby no^who is princess eugenie fianc things know about jack brooksbank^cmt music awards the complete winners list^amid photo scandal meghan markle dad wo n't attend royal wedding^will ferrell reveals his least favorite saturday night live sketch all time^former mtv vj jesse camp reported missing sister^victoria secret adriana lima 'i will not take off my clothes anymore for empty cause'^simon cowell rushed hospital after 'scary accident his london home^jennifer lawrence boyfriend darren aronofsky arrive italy venice film festival see pics^blac chyna assistant dies after being taken off of life support report^first aquaman trailer makes splash comic con^paris jackson cleans graffiti off dad michael jackson star hollywood walk fame^kendra wilkinson files divorce hank baskett^singer aldean wife brittany welcome first child together^does photo prove amelia earhart survived final flight^taylor swift music video director claims beyonce lemonade copied bad blood ... yes really^billy bush wife sydney davis files divorce^comes pansexual cover story^portia de rossi elains wife ellen degeneres quit acting^how get away murder star karla souza alleges she was raped by director mexico^rebecca gayheart files divorce from eric dane after years marriage^billboard music awards check out complete list winners^'buffy vampire slayer star nicholas brendon arrested alleged domestic violence against girlfriend^michelle williams engaged andrew youmans report^brooke burke breaks silence divorce david charvet^billboard latin music awards the complete winner list^john david duggar engaged abbie grace burnett^billboard music awards check out complete list winners^jeffrey dean morgan hilarie burton welcome baby no^big little lies meryl streep joins season cast of hbo series^rod stewart mocks elton john retirement tour 'it stinks selling tickets dishonest^mama june daughter lauryn 'pumpkin shannon pregnant^meghan markle kate middleton step out their first ever solo outing together wimbledon^josh duhamel defends national anthem performance^luann de lesseps sued kids ex husband^carrie underwood husband mike fisher celebrate year wedding anniversary^leslie jones accuses ritz carlton racism they don like black people^jennifer lawrence says wants take break acting milk goats farm^morning joe co hosts joe scarborough mika brzezinski are engaged,75,70,-5,145,0.5172413793103449,-0.03448275862068965,1
138751909,Metro_Ents,6458,58160,574,176539,0,0,99,42,metro ents brings latest news tv film music showbiz gaming worlds like us facebook,jennifer aniston apparently n't upset justin theroux split^jennifer aniston justin theroux split 'over home^jennifer aniston apparently n't upset justin theroux split^jennifer aniston justin theroux split 'over home^jennifer aniston justin theroux reach agreement custody dogs^kris jenner made kylie jenner dump tyga blac chyna joined family^kris jenner made kylie jenner dump tyga blac chyna joined family^kris jenner made kylie jenner dump tyga blac chyna joined family^jennifer lawrence caused split darren aronofsky^jennifer aniston justin theroux lovingly split two years marriage^jennifer aniston justin theroux lovingly split two years marriage^kristen stewart threw shade the huntsman winter war^kristen stewart threw shade the huntsman winter war^kristen stewart threw shade the huntsman winter war^shock report claims emma stone ryan gosling used body doubles la la land^shock report claims emma stone ryan gosling used body doubles la la land^jennifer aniston justin theroux lovingly split two years marriage^jennifer aniston justin theroux lovingly split two years marriage^fergie josh duhamel getting sick asked romantic questions came clean split^fergie josh duhamel split longer thought^fergie opens 'mummy shaming split josh duhamel^fergie josh duhamel split eight years marriage^liam payne given look painful split cheryl new ep first time^liam payne gets candid split cheryl^jermaine pennant concerned cheryl split liam payne^cheryl liam payne split earlier year^kim kardashian 'embarrassed husband kanye west recent pro trump rant^did taylor swift shade kim kardashian anniversary taylorswiftisoverparty^miley cyrus reportedly called wedding liam hemsworth^the crown recreates infamous prince charles camilla polo meeting season three^kristen stewart robert pattinson go secret date camden^kendall jenner jealous kylie popular^kylie jenner fell pregnant travis scott baby shortly split tyga^kourtney kardashian fierce af shrugs 'jealous comments younes bendjima^marilyn manson reveals justin bieber apologetic texts settle bizarre feud^marilyn manson reveals justin bieber apologetic texts settle bizarre feud^marilyn manson reveals justin bieber apologetic texts settle bizarre feud^justin bieber hailey baldwin apparently already married^matthew mcconaughey says hollywood choice embrace president donald trump^kris jenner made kylie jenner dump tyga blac chyna joined family^kris jenner made kylie jenner dump tyga blac chyna joined family^kris jenner made kylie jenner dump tyga blac chyna joined family^jennifer aniston justin theroux lovingly split two years marriage^jennifer aniston justin theroux lovingly split two years marriage^hailee steinfeld dismisses crazy justin bieber dating rumours^hailee steinfeld dismisses crazy justin bieber dating rumours^hailee steinfeld dismisses crazy justin bieber dating rumours^hailee steinfeld dismisses crazy justin bieber dating rumours^dakota johnson appeared red carpet venice film festival^dakota johnson describes fifty shades darker co star jamie dornan dream partner^dakota johnson describes fifty shades darker co star jamie dornan dream partner^dakota johnson describes fifty shades darker co star jamie dornan dream partner^dakota johnson describes fifty shades darker co star jamie dornan dream partner^caitlyn jenner skipped son brody wedding^brody jenner says dad caitlyn jenner knew wedding 'a year ceremony took place^emilia clarke spills brad pitt date never graham norton tonight^selena gomez timoth e chalamet totally make set new woody allen film^selena gomez timoth e chalamet make first day woody allen film^angelina jolie gives thumbs enjoys hike children custody agreement^tyga left heartbroken kylie jenner first child travis scott^tyga left heartbroken kylie jenner first child travis scott^tyga left heartbroken kylie jenner first child travis scott^tyga left heartbroken kylie jenner first child travis scott^tyga left heartbroken kylie jenner first child travis scott^tyga left heartbroken kylie jenner first child travis scott^blac chyna suing entire kardashian family damaging brand nude picture scandal^rob kardashian suing blac chyna alleged assault elosive lawsuit^blac chyna suing entire kardashian family damaging brand nude picture scandal^is jennifer aniston ready mingle justin theroux starts 'dating^looks like john mayer wants katy perry back^looks like john mayer wants katy perry back^looks like john mayer wants katy perry back^brad pitt eeing kids every day amid custody battle angelina jolie^angelina jolie splits top celebrity lawyer brad pitt custody battle^move simon kanye west could taking spot american idol judging panel^move simon kanye west could taking spot american idol judging panel^our morning ruined kanye west wo n't joining american idol^prepare terrified rest day thanks jennifer lawrence first trailer horror film mother^prepare terrified thanks jennifer lawrence first trailer horror film mothermovie^billy connolly wife pamela hit back michael parkinson claims ca n't recognise old friends^georgina chapman spoken life harvey weinstein^dakota johnson describes fifty shades darker co star jamie dornan dream partner^dakota johnson describes fifty shades darker co star jamie dornan dream partner^dakota johnson describes fifty shades darker co star jamie dornan dream partner^dakota johnson describes fifty shades darker co star jamie dornan dream partner^matt smith huge transformation ahead charles manson role^jennifer aniston justin theroux dealing custody battle canine variety^kylie jenner steals spotlight north west birthday bash help baby stormi^why kylie jenner confirming 'pregnancy proves ready retire spotlight^why kylie jenner confirming 'pregnancy proves ready retire spotlight^jealous angelina jolie left marion cotillard devastated ignoring brad pitt film set^brad pitt left devastated sudden deaths chris cornell brad grey^jealous angelina jolie left marion cotillard devastated ignoring brad pitt film set^jealous angelina jolie left marion cotillard devastated ignoring brad pitt film set^brad pitt left devastated sudden deaths good friends chris cornell brad grey^brad pitt highly unlikely prosecuted child abuse allegations leave crying devastated^brad pitt highly unlikely prosecuted child abuse allegations leave crying devastated^brad pitt left devastated sudden deaths good friends chris cornell brad grey^brad pitt highly unlikely prosecuted child abuse allegations leave crying devastated^courtney love warned women harvey weinstein interview i get libelled i say^courtney love warned women harvey weinstein interview i get libelled i say^courtney love warned women harvey weinstein interview i get libelled i say^stranger things officially renewed season netflix^stranger things officially renewed season netflix^stranger things officially renewed season netflix^stranger things officially renewed season netflix^jada pinkett smith calls tupac biopic alleyezonme deeply hurtful depiction relationship^jada pinkett smith calls tupac biopic alleyezonme deeply hurtful depiction relationship^jada pinkett smith calls tupac biopic alleyezonme deeply hurtful depiction relationship^jada pinkett smith calls tupac biopic alleyezonme deeply hurtful depiction relationship^jada pinkett smith calls will 'ride die chick^dance moms abby lee miller sentenced year day prison^dance moms abby lee miller sentenced year day prison^rob kardashian claims blac chyna threesome ti tiny^louis ck accused sexual misconduct five women show bosses amp confirmed incid^louis ck accused sexual misconduct five women^louis ck accused sexual misconduct five women^everything need know return twin peaks^twin peaks everything need know original series return^everything need know return twin peaks^bill cosby retrial sexual assault delayed march^bill cosby retrial sexual assault delayed march^bill cosby retrial sexual assault delayed march^bradley cooper irina shayk 'welcome first child^bradley cooper irina shayk 'welcome first child^rosie huntington whiteley jason statham welcome first baby our little man arrived^rosie huntington whiteley jason statham welcome first baby our little man arrived^rosie huntington whiteley jason statham welcome first baby our little man arrived^taylor swift announces two shows celebrating new album reputation^taylor swift announces two shows celebrating new album reputation^taylor swift announces new album reputation^taylor swift announces new album reputation first single coming tomorrow^taylor swift announces new album reputation first single coming tomorrow^taylor swift announces two shows celebrating new album reputation^justin theroux spoken first time since split jennifer aniston^jennifer aniston looks downcast since announcing justin theroux split^caitlyn jenner says rob kardashian stupid blac chyna social media rant^caitlyn jenner says rob kardashian stupid blac chyna social media rant^caitlyn jenner says rob kardashian stupid blac chyna social media rant^caitlyn jenner says rob kardashian stupid blac chyna social media rant^ed westwick investigated lapd rape allegations made kristina cohen,99,42,-57,141,0.7021276595744681,-0.40425531914893614,1
182107650,PageSix,5581,246896,2564,113995,0,0,103,38,if want page six,leslie jones stop holding comedians standard^sorry kim kourtney khlo successfully barred chyna attempt trademark angela renee kardashian^jennifer lawrence darren aronofsky still close split^jennifer lawrence darren aronofsky reunited split^jennifer lawrence darren aronofsky still close split^jennifer lawrence darren aronofsky reunited following split^icymi miranda lambert blake shelton affair ex claims^jessica simpson shows baby bump day nyc^kylie jenner joined kendall kanye adidas ambassador^angelina jolie longer saint hoped^kanye could kardashian still likes caitlyn jenner^jennifer lopez jokes pressure alex rodriguez propose^matt lauer complains easy mark first interview since today sex scandal^ben affleck jennifer garner divorce may dismissed^exclusive the real reason jennifer aniston justin theroux split^exclusive the real reason jennifer aniston justin theroux split^exclusive the real reason jennifer aniston justin theroux split^idris elba defends casting controversies james bond rejection^icymi miranda lambert blake shelton affair ex claims^liam payne jokes fragile times cheryl cole split^sofia richie kourtney kardashian get competitive thirst traps 're complaining^sofia richie kourtney kardashian post competing thirst traps^sofia richie kourtney kardashian get competitive thirst traps^gives raunchy performance star snaps^exclusive kelly ripa demands ryan seacrest cancel gma appearance^angelina jolie livid travel kids amid custody battle^angelina jolie livid travel kids amid custody battle^angelina jolie livid travel kids amid custody battle^angelina jolie livid travel kids amid custody battle^angelina jolie livid travel kids amid custody battle^did lindsay lohan convert islam^katie couric breaks silence matt lauer today exit^katie couric breaks silence matt lauer today exit^katie couric breaks silence matt lauer today exit^the crown casts josh o connor play prince charles^ben affleck jennifer garner got tense conversation neighborhood block party^justin theroux hangs maniac star rami malek^brad pitt bid 120k watch game thrones emilia clarke^angelina jolie longer saint hoped^princess eugenie ring double price meghan markle^brad pitt fighting angelina jolie shared custody six kids^mila kunis addresses upsetting divorce pregnancy rumors stress family^mila kunis addresses upsetting divorce pregnancy rumors^the crown star vanessa kirby shoots tom cruise marriage rumors^vanessa kirby shoots tom cruise marriage rumors^the crown star vanessa kirby shoots tom cruise marriage rumors^sofia richie kourtney kardashian get competitive thirst traps 're complaining^sofia richie kourtney kardashian post competing thirst traps^sofia richie kourtney kardashian get competitive thirst traps^alex rodriguez responds jennifer lopez proposal hints^alex rodriguez responds jennifer lopez proposal hints^angelina jolie risk losing primary custody kids^meghan markle criticized inappropriate shoulder dress queen birthday parade^kanye west ego still control vmas^kanye west ego still control vmas^reps matt damon insist moving australia permanently donald trump^angelina jolie longer saint hoped^jessica simpson shows baby bump day nyc^angelina jolie i n't enjoy single^jennifer aniston 'tearful meeting justin theroux ex^shots fired near tekashi ix9ine amp kanye west video shoot^shots fired near tekashi ix9ine kanye west video shoot^the crown star vanessa kirby shoots tom cruise marriage rumors^vanessa kirby shoots tom cruise marriage rumors^the crown star vanessa kirby shoots tom cruise marriage rumors^angelina jolie longer saint hoped^icymi miranda lambert blake shelton affair ex claims^janet jackson family still mad justin timberlake^janet jackson family still mad justin timberlake^scandal scarred matt lauer dumped manhattan pad 7 million^people warned kanye west date kim kardashian sex tape^people warned kanye west date kim kardashian infamous sex tape^people warned kanye date kim kardashian sex tape^the movie stars timoth e chalamet selena gomez^angelina jolie longer saint hoped^mila kunis addresses upsetting divorce pregnancy rumors stress family^mila kunis addresses upsetting divorce pregnancy rumors^broke teresa giudice suing lawyer month prison sentence^icymi miranda lambert blake shelton affair ex claims^exclusive dancing stars courting caitlyn jenner^sofia richie kourtney kardashian post competing thirst traps^justin theroux hangs maniac star rami malek^flip flop stars year old son hospitalized croup^flip flop star christina el moussa stuck hawaii ahead hurricane lane^brad pitt sienna miller romance rumors heat^icymi miranda lambert blake shelton affair ex claims^sofia richie kourtney kardashian post competing thirst traps^sofia richie kourtney kardashian get competitive thirst traps^sofia richie kourtney kardashian post competing thirst traps^sofia richie kourtney kardashian get competitive thirst traps^did lindsay lohan convert islam^at years old regis philbin still life party^at years old regis philbin life party^at regis philbin still life party^jennifer aniston knows truth justin theroux^sofia richie kourtney kardashian get competitive thirst traps^sofia richie kourtney kardashian get competitive thirst traps 're complaining^sofia richie kourtney kardashian get competitive thirst traps^why selena gomez fired mom took clothes^once upon time hollywood found charles manson^kylie jenner joined kendall kanye adidas ambassador^modern family star julie bowen privately settles divorce^modern family star julie bowen privately settled divorce^surprise enrique iglesias anna kournikova welcome twins^kristin cavallari jay cutler selling 7.9 million nashville home^stanley tucci felicity blunt welcome daughter emilia giovanna^congrats laura prepon ben foster married^laura prepon ben foster married^jamie foxx host bet awards^frightened rabbit frontman scott hutchison found dead^frightened rabbit frontman scott hutchison found dead^life imitates art donald trump almost played president sharknado^life imitates art donald trump almost played president sharknado^bristol palin joins cast teen mom og^jim carrey wrongful death lawsuit dismissed^ouch howie mandel remember meghan markle deal no deal^howie mandel remember meghan markle deal no deal^ariana grande mac miller break^kermit frog getting new voice years^jazz jennings great gender confirmation surgery^chip joanna gaines welcome baby no^sarah silverman michael sheen break^blac chyna granted temporary restraining order rob kardashian^scarlett johansson exits trans film rub tug amid backlash^kylie jenner birthday bike shorts ensemble featured k crystals^jennifer lawrence darren aronofsky still close split^jennifer lawrence darren aronofsky reunited split^jennifer lawrence darren aronofsky still close split^jennifer lawrence darren aronofsky reunited following split^just days hospitalized emergency spinal surgery abby lee miller diagnosed cancer^shailene woodley ate calories day adrift^jeremy london arrested domestic violence^the london wonder woman premiere canceled concert bombing manchester^john david duggar abbie burnett get engaged^david foster katharine mcphee engaged^actor tab hunter star damn yankees movie dead^congrats dustin lance black tom daley eecting first child^congrats dustin lance black tom daley eecting first child^stranger things star david harbour reveals committed mental asylum^a michael jackson musical coming broadway^ray j princess love welcome baby girl,103,38,-65,141,0.7304964539007093,-0.4609929078014184,1
759251,CNN,1106,42942867,139562,264353,12,82,21,23,it job gothere tell difficult stories join us for breaking news updates follow download app,"the russian government sent message pessimism relations us democrats seized cont^the us house representatives set vote week bill give money security schools t^we 're white house president trump speaking day democrats captured house representat^republican rep. david valadao conceded democrat tj cox race california st district giving de^read the forecast harry enten cnn senior writer analyst it daily prediction^the us house representatives set vote week bill give money security schools t^the us house representatives vote today bill fund security schools exactly one month after^trump failed protect nation the man accused blowing homemade elosive pedestrian nyc s^former president george h.w bush funeral train go texas a amp m university college station texas where^following former president george h.w bush death us flags remain lowered longest period time si^he said know 'let talk i 'm sure come agreement things and obligation to^fbi releases carter page surveillance warrant documents^director national intelligence dan coats says believed needed correct record president trum^sen. chuck schumer us senators american people eect affirmative statement support the^the league conservation voters organization spent last two years fighting trump environmental^a multi state outbreak listeria traced houston manufacturer vietnamese ready eat pork product^as cases confirmed us centers disease control prevention says evidence suggests viral asso^an additional people become ill eating lettuce contaminated e. coli us centers disease c^homicides suicides involving guns increasing according new data us centers disease c^there confirmed cases polio like illness known afm us year friday accordi^the centers disease control prevention handling polio like illness criticized advisers^the centers disease control prevention handling polio like illness criticized advisers^an additional people become ill eating lettuce contaminated e. coli us centers disease c^a multi state outbreak listeria traced houston manufacturer vietnamese ready eat pork product^the us centers disease control prevention escalated response polio like illness struc^there cases possible confirmed acute flaccid myelitis united states year according^abortion rates united states dropped lowest level years according report us^alabama high stakes senate election perfectly encapsulates age donald trump turned political logic^president trump stopped us capitol join republican senators weekly policy lunch attendees^former vice president joe biden offer contrast president trump foreign policy speech london^rudy giuliani says thinks president trump accepted ca n't wide ranging interview special co^rudy giuliani says special counsel robert mueller agreed narrow scope potential interview pres^rudy giuliani said president trump new lawyers held lengthy prep session president pote^bernie sanders says president trump lived promises made presidential campaign^sen. bernie sanders said president donald trump going war working people suggested presiden^bernie sanders says president trump lived promises made presidential campaign^sen. bernie sanders campaign democratic candidates across country month planned e^at republican national committee summer meeting austin one sweating trump putin summit^president donald trump longtime personal attorney michael cohen stepped role republican^ronna mcdaniel chair republican national committee accepted offer president trump stay in^the republican national committee announces hold convention late august charlotte north ca^republican national committee chairwoman ronna mcdaniel declines address incendiary immigration video pr^last interview sen. john mccain how want american people remember^president trump defended response death sen. john mccain interview bloomberg news asked^the us department education announced federal investigation university southern california^hackers targeting schools us department education warns^a spokeswoman us department education confirmed department longer investigating civil rig^hackers targeting schools us department education warns^french president emmanuel macron address joint session congress april part state visit a^watch key moments president trump first address joint session congress^a multi state outbreak listeria traced houston manufacturer vietnamese ready eat pork product^as cases confirmed us centers disease control prevention says evidence suggests viral asso^homicides suicides involving guns increasing according new data us centers disease c^there confirmed cases polio like illness known afm us year friday accordi^the centers disease control prevention handling polio like illness criticized advisers^the centers disease control prevention handling polio like illness criticized advisers^a multi state outbreak listeria traced houston manufacturer vietnamese ready eat pork product^the us centers disease control prevention escalated response polio like illness struc^there cases possible confirmed acute flaccid myelitis united states year according^abortion rates united states dropped lowest level years according report us^a doctor pharmacy resident police officer these victims chicago hospital shooting^a police officer doctor pharmaceutical assistant dead shooting chicago mercy hospital ma^while montenegro history n't perfect country n't aggressive president trump stated need^sen. lindsey graham said investigate fbi handled investigations russian interference th^sen. lindsey graham said investigate fbi handled investigations russian interference th^last interview sen. john mccain how want american people remember^tune exit interview attorney general loretta lynch sen. john mccain^president trump defended response death sen. john mccain interview bloomberg news asked^donald trump speaking campaign rally las vegas^mark zuckerberg sister randi weighed brother controversial comments holocaust deniers exclus^a far right pundit appointed post department health human services listed resume past wor^trump declared nationalist rally monday night cnn global affairs analyst max boot joins ander^a far right pundit appointed post department health human services listed resume past wor^trump declared nationalist rally monday night cnn global affairs analyst max boot joins ander^rt watch john king interview former presidents george w. bush bill clinton today a.m et^the life character john mccain words^last interview sen. john mccain how want american people remember^president trump defended response death sen. john mccain interview bloomberg news asked^we allowed disagree able freely without fear harm white house press secreta^the disappearing white house press briefing analysis^white house press secretary sarah sanders holds press briefing watch cnn^the disappearing white house press briefing analysis^we white house today press briefing sarah sanders protests continue immigration practi^the white house corrected transcript briefing call national economic council director larry kudlow mo^sarah sanders holds first white house press briefing two weeks watch cnn^former first lady michelle obama poised make first major speech since leaving office today^from heart american people stay vice president mike pence addresse^cargill meat solutions issued recall ,606 pounds ground meat due deadly e. coli outbreak us de^a watchdog group filed lawsuit week seeking documents us department agriculture eeriment^recall alert the us department agriculture food safety inspection service recalled turkey products li^what food stamp fraud roughly cents every dollar lost fraud according us departm^recall alert more ,000 pounds hormel spam canned meat products recalled the^a watchdog group filed lawsuit week seeking documents us department agriculture eeriment^the us china tariffs gone effect ,300 goods suddenly eensive yesterday c^comedian leslie jones says america way trump^comedian leslie jones advice victims cyberbullying^comedian leslie jones tells cnn simple piece advice anyone bullied^two joneses better one comedian leslie jones joins cnn tonight p.m et on^the secret donald trump rudy giuliani know russia probe analysis chris cillizza^the secret donald trump rudy giuliani know russia probe analysis^elle faces backlash false kim kardashian kanye west breakup tweet^elle faces backlash false kim kardashian kanye west breakup tweet^elle faces backlash false kim kardashian kanye west breakup tweet^hoda kotb replace matt lauer co host nbc today gop sen. orrin hatch retire end hi^prince william catherine duchess cambridge appear outside london hospital gave birth their^prince william catherine duchess cambridge appear outside london hospital gave birth their^retired english teacher marked letter received president trump filled grammar mista^retired english teacher marked letter received president trump filled grammar mista^retired english teacher marked letter received president trump filled grammar mista^retired english teacher marked letter received president trump filled grammar mista^elle faces backlash false kim kardashian kanye west breakup tweet^elle faces backlash false kim kardashian kanye west breakup tweet^elle faces backlash false kim kardashian kanye west breakup tweet^caitlyn jenner latest celebrity float run political office age president trump^caitlyn jenner latest celebrity float run political office age president trump^kelly ripa year long search co host live ryan seacrest join new york^houston texans defensive end jj watt offered pay funerals santa fe high school shooting victi^clueless actress stacey dash running congress california^clueless actress stacey dash running congress california^do i need british accent former president barack obama jokes prince harry interviews radio sh^do i need british accent former president barack obama jokes prince harry interviews radio sh^do i need british accent former president barack obama jokes prince harry interviews radio sh^game thrones stars kit harington rose leslie married^the billboard music awards celebrated music biggest names sunday night here complete list^jamie lynn spears pregnant second child^jamie lynn spears pregnant second child^evan spiegel must weigh whether push forward controversial app redesign could either reinvigorate sn^after days dropping slithering clues taylor swift announces 'll release new album called reputation^after days dropping slithering clues taylor swift announces 'll release new album called reputation^the billboard music awards celebrated music biggest names sunday night here complete list^black panther tweeted movie time twitter says^black panther tweeted movie time twitter says^black panther tweeted movie time twitter says^black panther tweeted movie time twitter says^black panther tweeted movie time twitter says^black panther tweeted movie time according twitter^black panther tweeted movie time according twitter^singer demi lovato hospitalized suffering apparent drug overdose source tells cnn",33,105,72,138,0.2391304347826087,0.5217391304347826,0
22216725,ENewsVideo,40,479278,3523,26290,0,0,20,110,e news video online hookup things hollywood video form,it official gwen stefani confirms upcoming collaboration blake shelton^matt lauer says become easy mark first interview since today exit^gwen stefani found love blake shelton split see celeb breakup stories^are brad pitt amp sienna miller secretly dating^congratulations kevin hart wife eniko parrish welcome baby boy^brad pitt gets serious fighting kids^video jason priestley dishes dirt brad pitt^sharon osbourne amp ozzy osbourne split years marriage^brody jenner officially market details indonesia wedding attended ... n't attend^kourtney kardashian post breakup game strong^shots fired kanye west amp nicki minaj music video shoot^marion cotillard breaks silence brad pitt angelina jolie divorce^ryan seacrest reflects year live with kelly^taylor swift shows gorgeous anniversary present calvin harris^video on e news tonight jessica simpson gives birth^is meghan markle moving closer prince harry^brad pitt angelina jolie divorce battle finally cools^jennifer aniston justin theroux stun the leftovers premiere^ryan seacrest reflects year live with kelly^is brad pitt ready quit hollywood^colton haynes speaks homophobia hollywood^victoria secret fashion show models vs. real life^kanye west new yeezy campaign stars naked kim kardashian lookalikes^anna kournikova enrique iglesias secretly welcome twins^project runway wendy pepper dead age^justin bieber seen mystery woman selena gomez break^tom brady criticized kissing year old son jack lips^how michelle williams found love heath ledger tragic death^khloe kardashian pregnant new kardashian calvin klein campaign^amy schumer hospitalized horrible kidney infection^jada pinkett smith calls tupac biopic deeply hurtful^leah remini calls b.s jada pinkett smith claims^this is us star justin hartley marries chrishell stause^nick cannon reveals diva thing seen mariah carey^taylor swift amp selena gomez friendship stronger ever^ed sheeran says perfect duet partner beyonce changes email address every single week^did demi lovato write ruin friendship nick jonas^prince harry plays coy honeymoon meghan markle^kylie jenner plumps lips ... lipstick^chester bennington cause death revealed^why ncis star pauley perrette leaving hit series^chris pratt amp zoe saldana break silence james gunn firing guardians galaxy vol^stars rally around julia louis dreyfus breast cancer diagnosis^jordan peele chelsea peretti welcome first child^pregnant serena williams poses nude august cover vanity fair^lea michele engaged zandy reich^scott disick happy kourtney kardashian seeing younes bendjima^youtube star austin jones arrested child pornography charges get latest^robert pattinson nearly fired twilight^tim mcgraw collapses onstage ireland faith hill steps^blac chyna involved fight six flags easter^heather locklear arrested attacking cop emt^summer phoenix files divorce casey affleck^justin bieber cancels remaining purpose world tour dates^khloe kardashian laughs post baby bikini video posted kendall jenner^jim carrey wrongful death lawsuit has been dismissed^scarlett johansson amp romain dauriac reunite amid divorce^john stamos caitlin mchugh married congrats^rhoa star kenya moore eecting first child marc daly^rachel mcadams low key pregnant first child^colin firth wife admits past affair alleged stalker^prince philip retires royal duties queen elizabeth ii full support^congrats melrose place star josie bissett married^inside kylie jenner travis scott first easter baby stormi^aaron carter enters facility improve health^ayesha steph curry are eecting baby no.3^vanderpump rules stars brittany cartwright jax taylor engaged^ewan mcgregor daughter calls girlfriend mary elizabeth winstead trash^elizabeth smart pregnant baby no^miley cyrus recalls feeling sexualized youth^cardi b wants lit baby shower^jada pinkett smith responds leah remini scientology claims^cops called tori spelling house twice within hours^simone biles claims sexually abused larry nassar^things might missed critics choice awards^michelle williams responds mark wahlberg 1.5 million donation time up fund^meghan markle calls prince harry best husband ever^shailene woodley reveals nearly quit acting hbo big little lies^take look inside kim kardashian west star studded shower baby no^kylie jenner holds baby stormi 820 gucci carrier^tristan thompson throws khloe kardashian sweet surprise birthday party^lindsay lohan launches lifestyle website share secrets^stranger things star shannon purser comes bisexual^amal clooney maternity leave coming end^kim kardashian west shares adorable first photo baby chicago^anna wintour daughter bee shaffer weds francesco carrozzini^rapper craig mack dead^kate gosselin gets emotional celebrating sextuplets th birthday without collin it bittersweet moment.^everything know pippa middleton wedding far^tori kelly engaged basketball player andre murillo^former fox news ceo roger ailes dead age^kylie jenner gives birth first child travis scott^michael fassbender alicia vikander married^storm chasers star joel taylor dead^john stamos eecting first child fianc e caitlin mchugh^kim kardashian thanks donald trump granting alice johnson clemency^jennifer lawrence darren aronofsky split^brooke burke files divorce david charvet^nina dobrev glen powell dating^kendall jenner admits weird sister kylie jenner baby^taylor swift jennifer hudson james corden cast movie version cats^selena gomez amp the weeknd keep hands coachella^be amazed the internet predicted kylie jenner stormi baby name long born^bradley cooper irina shayk welcome first child^scarlett johansson hooking snl colin jost^brace impact katy perry set host mtv video music awards^why cameron diaz disappeared from hollywood^meghan markle approves nick jonas priyanka chopra engagement^kate hudson shaves head mystery project sia^meghan markle parents incredibly happy engagement prince harry^sophia bush leaving chicago pd seasons^kim kardashian attends year high school reunion^paris jackson shares rare photo younger brother blanket^brigitte nielsen gives birth baby age^congratulations eva longoria gives birth baby boy^their story n't selena gomez confirms reasons why renewed season^brandy norwood hospitalized losing consciousness plane lax^evelyn lozada carl crawford split call engagement^amber heard vito schnabel pack pda wimbledon^chrissy teigen celebrates surprise baby shower besties^meghan markle admits misses suits^rosario dawson finds year old cousin dead l.a. home^how emma stone gained pounds battle sexes^rhony star luann de lesseps sued kids ex husband^kate middleton announces due date baby^congratulations carrie underwood mike fisher celebrate year wedding anniversary^bella thorne reveals dates men women^tommy lee is engaged vine star brittany furlan^ben affleck jennifer garner officially file divorce^drake hints past romance bella hadid scorpion,20,110,90,130,0.15384615384615385,0.6923076923076923,0
34649924,TheSunShowbiz,458,54665,487,118560,0,0,99,28,the latest showbiz news juiciest insider gossip give us like facebook,jennifer aniston confronts selena gomez growing bond ex justin theroux^this picture justin theroux cuddling close friend naomi watts upset wife jennifer aniston^jennifer lawrence holds hands boyfriend cooke maroney seven months split darren aronofsky^jennifer lawrence darren aronofsky split due huge age gap^how old roseanne barr children net worth ex husbands^katie price boyfriend kris boyson jokes wedding rehearsal rumours set become husband numb^emma stone ryan gosling used body doubles complex dance routines la la land^justin theroux selena gomez totally falling jennifer aniston happy^harry styles secretly dating naked chef blogger model tess ward^brad pitt angelina jolie split huge 200million fortune ever divorce signing pre nup^katy perry orlando bloom back together months split claim friends^the queen warned prince harry meghan markle difficult behaviour attitude row bride tiara^brad pitt apologises jennifer aniston leaving angelina jolie^ed sheeran cherry seaborn go double date courteney cox johnny mcdaid cherry isn t wearing a^jennifer aniston justin theroux furious fights new york neighbour odd bologna incident re^sarah jessica parker insists didn t fight kim cattrall sex and the city despite actress slamming he^sarah jessica parker insists didn t fight kim cattrall sex and the city despite actress slamming he^sarah jessica parker hints samantha could replaced sex and the city feud kim cattrall^liam payne leaves vma afterparty tattooed girl partied london weeks cheryl split^how old cheryl liam payne split give birth son bear^liam payne says closer family split cheryl thanks fans supporting^liam payne says getting dumped story life split cheryl^katy perry puts raunchy performance incredible eye popping costumes tour los angeles^katy perry flashes toned thighs pair pvc chaps puts raunchy performance^mariah carey boyfriend bryan tanaka keep hands feels thighs date night^when cheryl liam payne son bear born name mean^justin bieber hides face friends confirm split selena gomez again^who josh o connor lawrence actor the durrells play prince charles the crown series three^the durrells josh o connor play prince charles the crown series three despite six years older than^ed sheeran cherry seaborn go double date courteney cox johnny mcdaid cherry isn t wearing a^selena gomez fears battle depression anxiety rest life reveals prioritisin^kris jenner reveals rarely seen son rob kardashian returning keeping up with the kardashians next series^keeping up with kardashians spoilers dramatic moment kendall jenner calls kris middle anxiety att^keeping up with the kardashians spoilers khloe calls mum kris jenner w***e finding cheated fi^kanye west concerts hold indefinitely recovers nervous breakdown brought stress grief^when jennifer aniston married brad pitt children split reunion^pregnant kylie jenner shows baby bump pictured first time boyfriend travis scott since pre^how justin bieber marriage hailey baldwin left heartbroken selena gomez rehab urging fans forg^brad pitt apologises jennifer aniston leaving angelina jolie^angelina jolie pays stranger wedding cambodia buying houses cows landmine victims ch^justin bieber hailey baldwin look strained claims ex selena gomez^kris jenner reveals rarely seen son rob kardashian returning keeping up with the kardashians next series^keeping up with kardashians spoilers dramatic moment kendall jenner calls kris middle anxiety att^keeping up with the kardashians spoilers khloe calls mum kris jenner w***e finding cheated fi^tormented brad pitt allowed spend four hours children christmas day^drake secretly hooking walsall singer jorja smith even popped local co op buy sweets^kim kardashian left reeling kanye west tries control puts instagram huge row^this picture justin theroux cuddling close friend naomi watts upset wife jennifer aniston^justin bieber sparks rumours dating hailee steinfeld spotted together new york hotel^miley cyrus regrets swinging naked wrecking ball video admits like kill song^brad pitt apologises jennifer aniston leaving angelina jolie^george clooney snubbed brad pitt role best man we n't get invite either^what kanye west net worth name mean hit songs meet kim kardashian^victoria beckham overjoyed spice girls reunion band tv deal snub david beckham move miami^chris martin dakota johnson definitely dating spotted holiday israel^katy perry throws shade taylor swift american idol auditions spotted wearing bum bag^wonder wheel manages one worst woody allen films date around bad drama^justin bieber selena gomez look loved dad wedding jamaica revealed another bieber^kim kardashian steps pink demi lovato looks happy refreshed rehab stint mariah carey wears al^kylie jenner misses american music awards dog bambi goes labour^kylie jenner baby daddy travis scott pleads guilty disorderly conduct concert crush ordered pay 5^how old sarah paulson ocean star net worth partner holland taylor her^kar dashing aisle secretly planning wedding kanye west..^when cheryl liam payne son bear born name mean^the kardashian christmas card back kanye west refusing^who meghan markle prince harry girlfriend star suits rumoured moving royal^david victoria beckham moving 5m country barn celeb hotspot favoured prince harry meghan markle and^meghan markle moving pet dogs uk another sign wants live prince harry^keeping up with kardashians spoilers dramatic moment kendall jenner calls kris middle anxiety att^keeping up with the kardashians spoilers kendall jenner reveals terrified stalker wants bu^kanye west fears elosive leaked videos could destroy marriage kim kardashian hurt career acco^angelina jolie brad pitt headed court battle six kids row divorce^brad pitt angelina jolie agree interim custody arrangement divorce battle continues^kanye west president us would like brain surgeon says love song singer sara bareilles^jennifer aniston pictured smiling following split justin theroux leaves friends co star courteney cox s^mtv vma viewers slam kylie jenner disrespectful looks bored jennifer lopez performance^david beckham splashes 3m buy london pub mate guy ritchie^chris pratt leaves la mystery blonde private jet making first public appearance since split fr^kim kardashian admits begging sisters kourtney khloe surrogate mother says gi^james van der beek shares year old dawson creek throwback featuring katie holmes joshua jackson^jennifer aniston spotted alone la first time since divorce announcement justin theroux moves bags out^justin theroux breaks social media silence following jennifer aniston divorce announcement^jennifer aniston ex justin theroux looks miserable meet friends new york two weeks divorce announc^al pacino stepdaughter camila morrone sizzles barely bikini snap catching leonardo dicaprio eye^the queen warned prince harry meghan markle difficult behaviour attitude row bride tiara^selena gomez reveals kidney transplant battle lupus shares picture hosp^pride of britain viewers swoon david beckham surprises inspirational ella chadwick raised thousand^david beckham abseils cliff australia insensitive marriage comments left wife victoria tears^intimate details angelina jolie brad pitt elosive marriage breakdown revealed big budget movie^kim kardashian terrified husband kanye west receives help following psychiatric emergency^scott disick desperate kardashian family accept girlfriend sofia richie banned kris jen^how old matt smith long the crown star dating lily james playing charles manson^brad pitt not dating princess charlotte monaco false report claimed quietly dating for^katy perry throws shade taylor swift american idol auditions spotted wearing bum bag^heidi klum sizzles shows stunning body black bikini enjoying kiss boyfriend^heidi klum shows incredible supermodel body multi coloured bikini wades sea late^kim kardashian leaves nothing imagination skin tight silver jumpsuit date night kanye west^who corey gamble net worth kris jenner rumoured fiance works justin bieber^are miley cyrus liam hemsworth married get engaged wedding plans^james franco sister law alison brie addresses sexual misconduct allegations sag awards^celine dion mariah carey susanna reid lead celebrity tributes victims las vegas shooting country sin^the weeknd deletes ex girlfriend selena gomez social media despite amicable break^happy days star erin moran dead aged found unresponsive home^grieving brother reveals tragic life happy days star erin moran dead battling throat cancer^who meghan markle dad thomas old attend royal wedding^who meghan markle dad thomas attend royal wedding^mtv reality star clay adler dead taking life^ashley graham almost falls flat face takes tumble red carpet time gala new yo^russell brand reflects wonderful marriage katy perry^michael fassbender alicia vikander married tying knot ibiza weekend^jennifer lawrence darren aronofsky split due huge age gap^are nick jonas priyanka chopra engaged wedding plans else dated^meghan markle join prince harry pippa middleton wedding us reality show i wan na marry harry fil^donna air says meghan markle nice meeting pippa middleton wedding^michelle williams engaged marry secret boyfriend andrew youmans claim us reports^michael fassbender alicia vikander spotted honeymoon italy secret ibiza wedding^kit harington fiance rose leslie flashes engagement ring spotted first time since th^rose leslie flashes engagement ring heads airport without fiance kit harington^elton john celebrates andrew lloyd webber birthday rod stewart slammed retirement tour saying stink^paris hilton says sex tape leak like raped wanted die^khloe kardashian poses knickers sexy mag cover admits ready marry tristan thompson^heidi montag spencer pratt reveal eecting baby boy share hopes even children fo^heidi montag spencer pratt reveal eecting baby boy share hopes even children fo^ed sheeran fiancee cherry seaborn flashes huge engagement ring skip showbiz parties head for^ed sheeran fiancee cherry seaborn flashes new engagement ring day london^kylie jenner ex boyfriend tyga says kid amid reports pregnant star due february^kylie jenner girl boyfriend travis scott five months pregnant claim us reports,99,28,-71,127,0.7795275590551181,-0.5590551181102362,1
22180037,Wild949,4090,110894,750,109603,0,1,80,44,the bay hit music station 33.9490 snapchat iheartwild949 instagram/facebook,internet trolls saying statement trying^robert pattinson on movie roles 'people are trying to put you in a box^did jennifer aniston confront selena gomez over justin theroux^did jennifer aniston confront selena gomez over justin theroux^teen choice awards nominations first wave of nominees full list^reese witherspoon spills first details about 'legally blonde^john mayer has been hospitalized emergency appendectomy^sag awards nominations see full list of screen actors guild nominees^karrueche tran granted five year restraining order against chris brown^is ben affleck cheating his wife jennifer garner caught flirting co star new movie^american music awards nominations amas nominees full list^selenators gets matching tattoos with friends see the pics^it official gwen stefani amp blake shelton dating get scoop^your daily pics rachel bilson baby bump jessica simpson honeymoon^chris pratt files divorce from anna faris^sharon osbourne apologizes to justin bieber 'i was wrong to 'attack you^celebrities react nelsan ellis dead at^ed sheeran did not 'break friendship code with taylor swift^did jennifer aniston confront selena gomez over justin theroux^did jennifer aniston confront selena gomez over justin theroux^may person family n't beef jenner^jamie foxx katie holmes finally out public as couple^celebrities react trump withdraws steph curry white house invitation^celebrity reaction monologue on las vegas shooting and guns^beyonce not demanding silent delivery room despite report^beyonce not demanding silent delivery room despite report^beyonce not demanding silent delivery room despite report^beyonce not demanding silent delivery room despite report^celebrity reactions donald trump phoenix rally speech^jimmy kimmel talks donald trump harvey weinstein on 'gma^stars celebrate rosh hashanah see celebrity tweets about jewish new year^brad pitt gq divorce interview highlights on angelina jolie kids and drinking^from working charities raising three kids public eye duchess cambridge wears many hats^oh did call wedding read^oh did call wedding^jennifer garner ben affleck file for divorce amid false reconciliation rumor^kendall jenner jealous ex^celebrities react to hurricane irma^chris brown slammed by judge for skipping karrueche tran court hearing^chris soules had no alcohol in system after crash negative for drugs^drake sets record straight about fake media story saying disrespected muslims^no drake is n't 'lusting after rihanna despite new rumors^no drake is n't 'lusting after rihanna despite new rumors^taylor swift wins countersuit against dj david mueller in groping trial^the back to you songstress talked candidly elle magazine everything lovato overdose s^katie holmes not pregnant and planning wedding with jamie foxx^sorry drake amp bella hadid are not 'secretly dating^celebrity reactions prince harry meghan markle engaged^mariah carey amp french montana did not flirt in recording studio^watch kim kardashian first interview since robbery on 'ellen degeneres show videos^hailee steinfeld responds to justin bieber dating rumors^justin bieber new boo singer dating hailee steinfeld^nope justin bieber is not dating hailee steinfeld^are justin bieber amp hailee steinfeld dating photo^justin bieber dating hailee steinfeld photo^does justin bieber new boo he rumored dating hailee steinfeld^beyonce birth twins still hospital 'minor issue^your daily pics rachel bilson baby bump jessica simpson honeymoon^karrueche tran granted five year restraining order against chris brown^justin bieber fan arrested trespassing at singer beverly hills home^tony awards nominations see full tonys nominees list^may person family n't beef jenner^a source says shots fired shooters ran away glad hear tekashi^helped hubby announcing release date next album yahndi^joe jonas sophie turner 'already thinking of having kids is made up story^pics dayum chris brown new girl looks good thigh high boots booty shorts legs^ryan seacrest texted kris jenner about kylie pregnancy live on tv^iggy azalea blasts nick young after accidental dinner reunion^avril lavigne 'mildly amused by death conspiracy^kim kardashian slams 'invasive surrogacy reports^meghan markle wrong rumors about prince harry new fiancee^fans react u2 cancels st. louis concert amid police protests^justin bieber amp hailey baldwin a timeline their relationship^no zayn is not 'desperate to defend girlfriend gigi hadid^selena gomez reveals she had kidney transplant this summer^selena gomez reveals she had a kidney transplant amp her friend was her donor^robert pattinson amp charlie hunnam talk 'lost city of z on 'gma video^chris soules 'devastated after killing kenny mosher in fatal accident^obamas celebrate th anniversary after false split stories^mariah carey not dating both nick cannon and bryan tanaka despite report^michael strahan 'looking forward to working with alex rodriguez at abc^here how help victims las vegas mass shooting^feel better amy schumer hospitalized for 'horrible kidney infection read the update^harry styles announces intimate world tour see the dates^'dance moms abby lee miller sentenced to one year in prison^khlo kardashian makes her first public appearance since pregnancy news^meet playboy first transgender playmate ines rau^the bachelor bekah m was on missing persons list until fan recognized her^the bachelor bekah m was on missing persons list until fan recognized her^taylor swift teases new song 'gorgeous on instagram listen to a snippet^heather locklear arrested for battery after attacking a cop and an emt^heather locklear hospitalized with minor injuries after car crash^prince charles will walk meghan markle down the aisle at royal wedding^rachel mcadams is reportedly pregnant with her first child^rachel mcadams is reportedly pregnant with her first child^demi lovato reveals that she contemplated suicide at age^'happy days star erin moran dead at^hugh hefner cause death has been revealed^hugh hefner cause death revealed^kim kardashian says north west like brother saint^taylor swift teases new song 'gorgeous on instagram listen to a snippet^tracee ellis ross reveals met gala really like video^justin timberlake announces 'the man of the woods tour see the dates^bachelor paradise taylor nolan and derek peth break up^star jones ex husband al reynolds comes out as bisexual in candid blog^tori kelly is engaged to german basketball player andre murillo^tori kelly is engaged to german basketball player andre murillo^watch harry styles kiss james corden in christmas themed 'carpool karaoke^'storm chasers star joel taylor dead at^jennifer lawrence darren aronofsky split^shailene woodley ate only calories day adrift role^kelly clarkson reveals secret behind her pound weight loss^andy spade breaks silence wife kate spade death^meghan markle approves of priyanka chopra nick jonas engagement^meghan markle approves of priyanka chopra nick jonas engagement^see emily ratajkowski massive engagement ring first time^billboard music awards nominations see full list of bbmas nominees^billboard music awards nominations see full list of bbmas nominees^camila cabello announces her 'never be the same tour see the dates^gigi hadid slams body shamers for calling her 'too skinny at nyfw^miley cyrus defends selena gomez after stefano gabbana calls her 'ugly^miley cyrus defends selena gomez after stefano gabbana calls her 'ugly^demi lovato announces tour with dj khaled see the dates^russell wilson sends ciara sweetest birthday message^chris pratt files divorce from anna faris,80,45,-35,125,0.64,-0.28,1
116547240,TooFab,8061,40250,456,77745,0,0,89,34,pop culture news need know follow us instagram,still sore jennifer aniston amp justin theroux relive relationship split^do n't let headlines fool jennifer aniston not 'heartbroken justin theroux amp brad pitt^still sore jennifer aniston amp justin theroux relive relationship split^still sore jennifer aniston amp justin theroux relive relationship split^ivanka trump sat dad g20 meeting twitter is not having it^gwen stefani amp blake shelton make official^jessica simpson rocks baby bump curve hugging gown^our first look growing baby bump^take first look growing baby bump^jessica simpson rocking much larger baby bump eected^jessica simpson showed baby bump curve hugging gown^jessica simpson rocking much larger baby bump eected^jessica simpson shows growing baby bump curve hugging gown^jessica simpson rocking much bigger baby bump eected^david amp celebrate years marriage shut divorce rumors^facial eressions asked meghan markle royalwedding bridezilla speak volumes^khloe kardashian shut rumors this procedure admits still wants done^the nba star amp baby daddy even reveals 'not done kids yet^'stroll girls captioned photo amp puppy posse^busy philipps teases kim kardashian ecstasy/sex tape connection calls brand loyalty^it channing tatum jenna dewan split nearly years marriage read statement^americanidol crowns season winner^'stroll girls captioned photo amp puppy posse^model flaunts bikini bod th birthday^model wants know longer teenager^'i teen choice captioned sexy bikini shot th birthday today^speaks ex girlfriend claims every one accuser allegations false^speaks ex girlfriend claims every one accuser allegations false^now this bromance get hit streets justin theroux amp dog kuma^now this bromance get behind hit streets justin theroux amp dog kuma^'divas amp pay r e s p e c t legendary areth^'98 'divas amp pay r e s p e c t legendary aretha^'98 'divas amp pay r e s p e c t legendary aret^kylie jenner pregnant travis scott baby see savage twitter reactions^kylie jenner pregnant travis scott baby see savage twitter reactions^watch weighs kanye west amp beef kim kardashian^watch weighs kanye west putting blast kim kardashian comments^wait alec baldwin says justin bieber hailey baldwin already married^model flaunts bikini bod th birthday^model wants know longer teenager^'i teen choice captioned sexy bikini shot th birthday today^there hiding bump^see hiding baby bump^tilda swinton amp dakota johnson ride venice film festival style see fashion photos^dakota johnson rocked perfect look premiere suspiria^it channing tatum jenna dewan split nearly years marriage read statement^jessica simpson rocks baby bump curve hugging gown^our first look growing baby bump^take first look growing baby bump^jessica simpson rocking much larger baby bump eected^jessica simpson showed baby bump curve hugging gown^jessica simpson rocking much larger baby bump eected^jessica simpson shows growing baby bump curve hugging gown^jessica simpson rocking much bigger baby bump eected^who confirmed katie holmes jamie foxx dating^billy bush describes sort choice kiss ass infamous conversation tru^billy bush describes sort choice kiss ass infamous conversation tru^billy bush describes sort choice kiss ass infamous conversation tru^the face makes americanidol contestant name drops priceless^see reacted contestant singing song americanidol^nicole kidman kicks serious ass trident extended trailer aquaman^nicole kidman kicks ass trident extended trailer aquaman^watch nicole kidman kick serious ass extended trailer aquaman^mariah carey taking break from social media wake nye disaster 'they foiled me audio^mariah carey taking break from social media wake nye disaster 'they foiled me audio^'revenge body star eressed women must 'what best baby^emma stone truly angel earth^see say auntie amp kuwtk pregnancies^blake shelton gwen stefani saved life divorce miranda lambert^alessandra ambrosio kids models making^alessandra ambrosio kids totally models making^'pain joy elation panic anxiety temporary tweeted ahead tonight kuwtk^handles cheating scandal childbirth like boss kuwtk awe^watch weighs kanye west amp beef kim kardashian^watch weighs kanye west putting blast kim kardashian comments^now this bromance get hit streets justin theroux amp dog kuma^now this bromance get behind hit streets justin theroux amp dog kuma^finally admitting already know selfie obsession ridiculous^model flaunts bikini bod th birthday^model wants know longer teenager^'i teen choice captioned sexy bikini shot th birthday today^report jessica simpson pregnant again^model flaunts bikini bod th birthday^model wants know longer teenager^'i teen choice captioned sexy bikini shot th birthday today^prince harry amp meghan markle looked oh stylish eugenie royalwedding^we certainly tell putting work laborday here stars weekend^the face makes americanidol contestant name drops priceless^see reacted contestant singing song americanidol^after nearly two decades gabrielle union calls 'feud jada pinkett smith '^the rapper also calls reese witherspoon jada pinkett smith christina might aguilera^will smith chops son hair movie role tries^will smith chops son hair movie role tries^glee star engaged zandy reich wait see massive ring^rhoa star announced season reunion eecting first child husband marc d^kim kardashian returns paris first time since shocking robbery^kim kardashian west returns paris first time since shocking robbery^george clooney dad amal clooney gives birth twins ella alexander^'i want lit baby shower told every hilarious takeaway interview with^engaged see gorgeous ring^engaged see gorgeous ring^ryan murphy revealed title americanhorrorstory season^ryan murphy revealed title americanhorrorstory season^julia louis dreyfus says diagnosed breast cancer^julia louis dreyfus says diagnosed breast cancer^truly puts goldenglobes host ringer 'award show boot camp^star eecting first child fiance caitlin mchugh^jennifer hudson joins coach season alongside^jennifer hudson joins coach season alongside^james corden enlists help fab make band guitarist^james corden enlists help fab make band shaggy looking guitarist^fab rescue enlists help cast make band shaggy looking guitar^bradley cooper irina shayk welcome first child^theoriginals set end season^theoriginals set end season^reasonswhy officially renewed season^justin theroux shared first selfie puppies since split jennifer aniston^a very hunky justin theroux made first public appearance since split jennifer aniston^a very hunky justin theroux made first public appearance since split jennifer aniston^thanksgiving may still time left binge watch holiday themed films^joe co hosts engaged^joe co hosts engaged^pauley perrette leaving cbs seasons ncis,89,34,-55,123,0.7235772357723578,-0.4471544715447153,1
14957318,nbcchicago,1488,439282,4239,189281,0,9,9,102,thank stopping place go exclusive local stories latest breaking news weather updates,"chicago police department releases statement video officer involved shooting made public^bishop arther brazier former leader chicago apostolic church god longtime civil rights activist died^police officer doctor pharmacist identified victims shooting chicago mercy hospital^influx shooting victims causes headaches stroger hospital what need know multiple overnight^flags lowered chicago nd district police station honor victims mercy hospital shooting^chicago police report drop homicides shooting victims^chicago police report drop homicides shooting victims^vigil held sunday chicago honor victims saturday synagogue shooting pittsburgh^watch live donald trump speak campaign rally las vegas nevada^watch kanye west auditions 'american idol kim kardashian side^trump defends 'beautiful confederate statues rips critics^david cassidy fighting memory loss wants 'enjoy life^katie couric breaks silence matt lauer ouster today^kanye west yeezus tour postponed indefinitely props destroyed accident^brad pitt quitting drinking divorcing angelina jolie fighting kids^angelina jolie brad pitt headed court custody battle^kourtney kardashian scott disick back together year half apart sources^'tonight julie bowen interesting rule sons^mario batali includes cinnamon roll recipe sexual misconduct apology^colton haynes speaks homophobia hollywood^'pretty little liars star janel parrish engaged longtime boyfriend chris long^fear factor revived mtv ludacris host^all fashion details meghan markle christmas debut^jennifer morrison leaving 'once upon time season six^c line dion cancels las vegas concerts undergo surgery^comedian kevin hart wife eniko parrish eecting first child together^'game thrones season trailer promises great war^chrissy teigen kristen bell offer pay mckayla maroney 100k fine breaking nda^'happy days stars reunite honor erin moran^tiffany haddish claims drugged actress 'bit beyonc face^john legend starring 'jesus christ superstar live concert nbc^former u.s. rep. anthony weiner sentenced months prison sexting minor^justin timberlake makes super bowl selfie kid cry another surprise^breaking actor comedian jerry lewis dies age^elisabeth moss 'blacked award emmys^alicia silverstone husband christopher jarecki split^jennifer hudson confirmed star aretha franklin biopic^'america got talent season adds guest judge^veronica mars'brad bufanda dies suicide age^the truth days leading demi lovato overdose^alison brie addresses james franco allegations sag awards^thank live tweeting 'jesus christ superstar live^kristen bell charlize theron stars gush rescue dogs^avicii family implies died apparent suicide said could go longer^miley cyrus retracts apology nude vanity fair portrait^heather locklear arrested attacking cop emt^nd suspect arrested murder rapper xxxtentacion^julia louis dreyfus completes second round chemotherapy amid breast cancer battle^barbra streisand reveals exactly decided clone dog^barbra streisand reveals exactly decided clone dog^sedated sean penn chain smokes bizarre late show appearance^ashley judd lawyer finds harvey weinstein attempt dismiss lawsuit 'offensive^heather locklear hospitalized minor injuries car crash^kourtney kardashian meets congressional leaders cosmetics reform^howie mandel n't remember meghan markle deal no deal^hillary clinton says 'honored 'snl pete davidson tattoo^karrueche tran granted permanent restraining order chris brown^portia de rossi says steven seagal 'unzipped pants audition^'scandal series finale ends happily thought possible^kim kardashian returns paris first time since robbery^dj khaled named weight watchers social media ambassador^meghan markle half sister fires back prince harry family remarks^ivanka trump discusses struggles postpartum depression 'it challenging emotional time me'^anthony bourdain narcotics body time death^chrissy teigen gives birth baby john legend^amber heard slammed 'racist tweet ice checkpoint^ariana grande pete davidson make relationship instagram official^give peace chance after years feuding brandi glanville shares selfie leann rimes^miranda lambert helps rescue dogs pets hurricane harvey^mtv star clay adler dead^jennifer hudson accuses david otunga 'aggressive behavior taunting gun^'the office revival reportedly works nbc^caitlyn jenner says n't talked kim kardashian 'in year^'stranger things star shannon purser comes bisexual^queen latifah announces mom death emotional tribute^demi lovato sings breaking sobriety new song 'sober^colin farrell checks rehab 'preemptive measure^gal gadot shuts wonder woman body shaming^this is us cast shares hopefully fake spoilers season red nose day^reese witherspoon jokes three legs vanity fair hollywood issue cover^chris brown recalls night assaulted rihanna new doc 'i felt like f king monster^'storm chasers star joel taylor dead^kate upton marries justin verlander lavish italian wedding^george amal clooney donate 1 million fight hate groups^quentin tarantino breaks silence uma thurman shares 'kill bill crash footage^meghan markle deletes facebook instagram twitter^james corden pays tribute manchester heartfelt monologue^victoria mahoney 'star wars movies first black female director^luann de lesseps check alcohol treatment center arrest^sharon stone laughs seconds sexual harassment question^teamjhud jennifer hudson joins 'the voice next season mentor^terry crews reports alleged sexual assault police sources^matthew morrison outraged alleged dog abuse video filmed movie^matthew morrison outraged alleged dog abuse video filmed movie^bradley cooper irina shayk welcome first child^jaime king attacked man smashes car window son inside^riverdale star lili reinhart says show aved 'worst depression^billboard music awards things know big event^kevin federline wants increase 20,000 monthly child support britney spears^katharine mcphee david foster engaged report^kim kardashian west talks jared kushner pardon imprisoned grandmother^kylie jenner youngest forbes list america richest self made women earning spot cover^eva longoria gives birth baby boy^'will amp grace star sean hayes reveals health scare recent hospitalization^elon musk speaks breakup amber heard^taylor swift 'reputation album leaks hours early^magic how cardi b stylist hid baby bump months^how cardi b stylist hid baby bump months^met gala cliffsnotes how actually pronounce comme des gar ons^michael phelps nicole johnson welcome baby^kelly clarkson opens billboard music awards 'moment action santa fe school shooting vict^adam levine delivers emotional tribute christina grimmie 'the voice^cmt music awards nominations announced see complete list^brigitte nielsen reveals pregnant baby no age^leslie jones accuses ritz carlton racism 'they n't like black people^the biggest scandals olympic figure skating history^multiple reports say kylie jenner pregnant^joe jackson laid rest private funeral^'you alone terry crews comes forward sexual assault allegations unnamed hollywood executive^'morning joe co hosts joe scarborough mika brzezinski engaged",9,111,102,120,0.075,0.85,0
21906715,radar_online,3253,125013,1663,63444,0,0,116,3,we bring latest celebrity news doorstep we follow stars,jennifer aniston offer justin theroux cash keep quiet dark secrets^jennifer aniston justin theroux barking gets keep prized pooches^justin theroux crawling jennifer aniston social circle since split^exclusive details a witness george clooney crash tells^kim kardashian amp kanye west arrive in nyc looking miserable ahead of met gala kimkardashian^blake shelton pushed aside rabid meghan markle fanatics^protecting kylie kim kardashian west asks kanye west give tyga advice dating jenner^jessica simpson cradled baby bump nyc pregnancy reveal^jessica simpson pregnant see first baby bump photos^jessica simpson pregnant see first baby bump photos^caitlyn jenner promised girlfriend sophia cut 100 million fortune^kanye west wants caitlyn jenner girlfriend model yeezy^matt lauer caught cheating today co star livid first wife^matt lauer plans comeback thrown today show crisis mode^married matt lauer romancing much younger blonde today scandal^kanye west wife kim kardashian freaking right source claims^see sofia richie hottest bikini fashion looks^divorce hold julia roberts amp danny moder reunite seen together months^jennifer aniston caught holding hands adam sandler justin theroux split^jennifer aniston caught holding hands adam sandler justin theroux split^kris jenner caught getting flirty with grimy scott disick krisjenner scottdisick^angelina jolie barely eating sleeping judge granted brad pitt time kids^whitney ex bobby brown cheats death loses of his blood in harrowing medical crisis^miley cyrus liam hemsworth called wedding shocking split^it over liam hemsworth cancels wedding to miley cyrus did they break off their engagement again^angelina jolie begs tom ford for help resurrecting her career angelinajolie tomford^see inside meghan markle wild teenage years family past^julia roberts taking time save crumbling marriage^ryan seacrest takes megyn kelly i will destroy you^jennifer aniston caught holding hands adam sandler justin theroux split^jennifer aniston caught holding hands adam sandler split justin theroux^jennifer aniston caught holding hands adam sandler justin theroux split^jennifer aniston caught holding hands adam sandler justin theroux split^today poll do think ellen degeneres portia de rossi save marriage^ellen degeneres amp portia de rossi to save marriage with a baby ellendegeneres^jennifer garner ben affleck eloded blowout fight son game^tom cruise desperate take suri back livid katie holmes vows fight^divorce hold julia roberts amp danny moder reunite seen together months^rob kardashian caught slapping his ex in the face^blake shelton desperate gwen stefani return thevoice^kim kardashian flipped kanye west pda bff candace^exclusive ben affleck could face brain damage scary motorcycle crash^exclusive teresa giudice scored 500k joe deportation spinoff special^see sofia richie hottest bikini fashion looks^latest developments inside beyonce secret delivery room drama twins^exclusive nicole kidman amp keith urban fight frozen faces^marriage meltdown cheryl hines 'in over head with sex freak rfk jr^jennifer aniston offer justin theroux cash keep quiet dark secrets^catfight continues jealous kim kardashian attempts steal beyonce twin thunder^khloe kardashian betrayed husband lamar odom shocking night with strippers^khloe kardashian betrayed husband lamar odom shocking night with strippers^justin theroux caught flirting storm erika cardenas^where dad braless angelina jolie takes kids disneyland amid divorce drama^jessica simpson cradled baby bump nyc pregnancy reveal^jessica simpson pregnant see first baby bump photos^jessica simpson pregnant see first baby bump photos^brad pitt caught at intimate dinner with sienna miller bradpitt siennamiller^brody jenner mom shades ex caitlyn ditching son wedding due scheduling conflicts^caitlyn jenner lover banned attending son brody wedding^exclusive kourtney kardashian partying non stop amid younes breakup drama^kylie jenner betrayed why tyga response ex engagement destroyed jenner^jennifer aniston revenge mode emma stone justin theroux romance^conjugal visits gay hookups amp porn joe prison sex secrets eed^exclusive details multiple shots fired kanye west beverly hills video shoot^david schwimmer trapped in nasty custody battle with british ex davidschwimmer custodybattle^latest developments inside beyonce secret delivery room drama twins^kate hudson numbers get scoop massive net worth^brad pitt absolutely love neri oxman^jealous kendall jenner livid kylie jenner vogue spread^kim kardashian feud kanye west eloded fragile marriage crumbles^go inside dangerous diet^detox tea miniscule portions desperate measures inside kendall jenner dangerous diet^inside dangerous diet^kanye west 'furious kim kardashian treatment chicago^kanye west 'furious kim kardashian treatment chicago^today poll do think ellen degeneres portia de rossi save marriage^ellen degeneres amp portia de rossi to save marriage with a baby ellendegeneres^jennifer aniston revenge mode emma stone justin theroux romance^robert pattinson spotted sneaking sienna miller nyc pad^nicole kidman proud pal angelina jolie refused let brad pitt get away anything^shocking celebrity weight changes^shocking celebrity weight changes^photos shocking celebrity weight changes == gt^photos shocking celebrity weight changes radar online^marriage meltdown kim kardashian west secretly enlists top divorce lawyer behind kanye west back^miley cyrus liam hemsworth split second time^caitlyn jenner nasty fight with reality co star caught on camera caitlynjenner^caitlyn jenner big book reveal i had the final surgery bye bye penis^angelina jolie approved new lawyers divorce battle brad pitt^brad pitt staying sober kids amid nasty custody battle ex angelina jolie^tragic gwen stefani loses hearing after rupturing eardrum gwenstefani^khloe kardashian live twitted kuwtk told tristan cheating drama^kim kardashian flipped kanye west pda bff candace^exclusive megyn kelly struggling fill studio audience failing show^angelina jolie begs tom ford for help resurrecting her career angelinajolie tomford^enough is enough kris jenner orders scott to return home after boozy miami bender^exclusive hits the town and the bottle on boozy girls night out post split from bruce^kanye west kim kardashian touchy feely at nyc restaurant opening^spotted touchy feely nyc restaurant opening // cc^tom cruise planning secret meets suri reconnecting heartbreaking calls^jennifer aniston caught holding hands adam sandler justin theroux split^jennifer aniston caught holding hands adam sandler split justin theroux^jennifer aniston caught holding hands adam sandler justin theroux split^jennifer aniston caught holding hands adam sandler justin theroux split^keeping distance prince william amp kate middleton struggle hide marriage tension pippa wedding^see sofia richie hottest bikini fashion looks^see sofia richie hottest bikini fashion looks^exclusive kimkardashian terrified relive nightmare fashion week^sofia richie growing desperate kourtney kardashian scott disick enjoy whirlwind nyc getaway^hot or not see heidi klum bikini body without airbrushing^lady gaga shocking plastic surgery makeover eed^reese witherspoon 'furious at nicole kidman after public arguments^nude hack attack brad pitt rumored new fling sienna miller 'devastated photo leak^kate hudson numbers get scoop massive net worth^sisters at war kim kardashian west battles kylie jenner sexy photos^ungrateful b*tch kim kardashian war kylie jenner stolen style threatening sue^meghan markle reclusive father walk aisle royal wedding^uh oh ... teen mom star chelsea houska troubled baby daddy adam lind released jail^justin theroux crawling jennifer aniston social circle since split,116,3,-113,119,0.9747899159663864,-0.9495798319327732,1
14722676,theinquisitr,729,51161,1257,180482,2,4,105,7,your source news need know world politics sports entertainment trending,"snapchat is shutting down its snapcash payment feature the feature removed august technews tech^health professionals weigh in on whether or not it is possible to die of a broken heart in wake former pres^uptick in diseases from tick and mosquito bites tripled reports centers for disease control and prevention illnes^rudy giuliani wants limits for trump interview with robert mueller robertmueller uspolitics^ground meat recalled over ,000 pounds contaminated with deadly e. coli us department agriculture ordered a^cdc report shows less than one in four americans get enough exercise research health^jennifer aniston and justin theroux are not fighting over custody of their dogs debunked jennifer aniston isn't^jennifer aniston and justin theroux jen not upset over justin and naomi watts pair truth stated debunked .^jennifer aniston has not confronted over justin theroux debunked aniston gomez c^brad pitt jennifer aniston relationship is not finally out of hiding claims gossip cop bradpitt^robert pattinson kristen stewart wanting to do twilight reboot is fake news claims gossip cop fakenews^and justin theroux are not 'falling for each other debunked selenagomez justintheroux^supporting khloe decision not to involve caitlyn in her child life is fake news debunked .^rumored to have been dumped by report untrue stefani rep tells gossip cop .^betty white puts together bucket list as th birthday approaches^are gwen stefani and blake shelton heading for a split or a wedding^are gwen stefani and blake shelton heading for a split or a wedding^are gwen stefani and blake shelton heading for a split or a wedding^brad pitt is not dating neri oxman nor receiving 'sobriety support from her debunked brad pitt paired^did n't get banned from cleveland cavaliers games debunked khloekardashian^heidi klum wo n't be taking place for 'sex and the city debunked sarah jessica parker made^angelina jolie not demanding brad pitt to dump jennifer aniston reports gossip cop the truth behind angelina^kim kardashian reportedly 'embarrassed and hates how kanye west appears 'crazy after 'snl rant per 'hl'.^kim kardashian reportedly embarrassed and hates how kanye west appears crazy after snl rant per hl^are miley cyrus and liam hemsworth calling off their wedding she steps out without^miley cyrus liam hemsworth wedding off because of her pot habit rumors^miley cyrus liam hemsworth wedding off because of her pot habit rumors^miley cyrus liam hemsworth wedding off because of her pot habit rumors^are miley cyrus and liam hemsworth calling off their wedding she steps out without^did katie couric departure today sexual harassment matt lauer^is over matt lauer tired of being asked about his scandal the former 'today co anchor ready to^justin theroux and sienna miller have not been dating since his split from jennifer aniston debunked theroux and^prince charles shares that he hates selfies in a new documentary the future king took part new look behind th^rumored to have been dumped by report untrue stefani rep tells gossip cop .^rumored to have been dumped by report untrue stefani rep tells gossip cop .^justin theroux was not 'devastated by jennifer aniston 'instyle interview despite tabloid report.^joe jonas sophie turner wedding is coming nick dishes on bachelor party already plans ba^charlie sheen accuser says she was coerced into signing nda after he eed her to hiv the woman listed court^'property brothers drew and jonathan scott are not 'feuding despite tabloid article 'gossip cop reports.^is not jealous because has moved on despite tabloid report gossip cop says ru^hailey baldwin wishes she and fiance justin bieber 'could get married tomorrow as selena gomez fears linger.^did n't get banned from cleveland cavaliers games debunked khloekardashian^justin theroux does n't have a new girlfriend despite link to aubrey plaza justin theroux new girlf^brad pitt mom is not begging him to get back with jennifer aniston gossip cop reports bradpitt^justin bieber mom said this about son marriage to hailey baldwin she also said thing former^brad pitt reportedly fighting for more visits with kids^brad pitt reportedly fighting for more visits with kids^reports that kate middleton and meghan markle 'ca n't stand each other untrue claims 'gossip cop meghanmarkle^how committed seeing kids christmas brad pitt anyway^justin bieber and hailey baldwin are reportedly already married according to 'people the couple could n't wai^is not going bald despite tabloid report debunked kimkardashian factchecking^kelly ripa teases new role as mark consuelos mistress on 'riverdale the 'live with kelly ryan star pla^kelly ripa shows off her insane abs in belly baring 'i dream of jeannie costume the 'live with kelly ryan st^never said she and kanye west barely made it this year despite report kimkardashian^angelina jolie did not adopt more kids debunked the oscar winning actress still mother six beautiful c^miranda lambert gets revenge on blake shelton and gwen stefani with new album^miranda lambert gets revenge on blake shelton and gwen stefani with new album^miranda lambert gets revenge on blake shelton and gwen stefani with new album^does not have 'escape plan to leave kanye west debunked kim kardashian 'escape^katie holmes to return 5 million to tom cruise before marrying jamie foxx^katie holmes to return 5 million to tom cruise before marrying jamie foxx^katie holmes to return 5 million to tom cruise before marrying jamie foxx^josh duhamel and jennifer garner actor not hiding relationship with affleck ex no relationship to hide.^dakota johnson releases her personal phone number for sexual assault victims to call 'tell story voi^family is not upset about meeting with despite contrary reports kim kardashian^brad pitt snubbed angelina kiss^'' did not force to reconcile with debunked the olive branch perry o^bradpitt begging allegedly jealous angelinajolie let see kids dating rumors^brad pitt mom is not begging him to get back with jennifer aniston gossip cop reports bradpitt^jamie foxx spotted at katie holmes apartment in new york city as relationship quietly continues katieholmes^jennifer aniston is n't dating jake gyllenhaal despite report that reese witherspoon set them up debunked jennif^is not jealous because has moved on despite tabloid report gossip cop says ru^has not threatened to take kids away from kanye west despite tabloid report debunked .^brad pitt and angelina jolie divorce many reasons for split not because of kids education debunked .^kanye west recovery struggling to cope without kim kardashian^kim kardashian kanye west struggling to get through tense time^kanye west recovery struggling to cope without kim kardashian^kim kardashian kanye west struggling to get through tense time^kim kardashian kanye west struggling to get through tense time^kanye west recovery struggling to cope without kim kardashian^matt lauer not dumped by friends like billy joel after sexual misconduct scandal reports gossip cop lauer has^kanye west was warned not to date kim kardashian because of her sex tape 'this going ruin career w^brad pitt and jennifer aniston did not get married in secret debunked the two friends seriously just^meghan markle is n't 'starving herself to lose weight ahead of the royal wedding debunked meghanmarkle^bishop michael bruce curry initially believed royal wedding sermon invite was a prank the u.s. preacher made headl^justin theroux is not leaning on olivia munn after jennifer aniston breakup despite report debunked munn has^jamie foxx spotted at katie holmes apartment in new york city as relationship quietly continues katieholmes^jennifer lawrence and rob kardashian are not dating despite tabloid report debunked factchecking^kate middleton is not freaking out over pregnancy despite tabloid report debunked katemiddleton factchecking^brad pitt and angelina jolie divorce many reasons for split not because of kids education debunked .^khloe kardashian reaction to tristan thompson cheating scandal revealed on 'kuwtk khloekardashian^is over matt lauer tired of being asked about his scandal the former 'today co anchor ready to^justin theroux was not 'devastated by jennifer aniston 'instyle interview despite tabloid report.^katie holmes and jamie foxx update is he adopting her daughter suri cruise^katie holmes and jamie foxx update is he adopting her daughter suri cruise^katie holmes and jamie foxx update is he adopting her daughter suri cruise^jennifer aniston and justin theroux jen not upset over justin and naomi watts pair truth stated debunked .^brad pitt vowing to stay celibate amid angelina jolie divorce is not true reports gossip cop the truth behind^charles manson pen pal says will is authentic news^bradpitt reportedly planning to have a child with princess charlotte casiraghi^jennifer aniston and justin theroux are not fighting over custody of their dogs debunked jennifer aniston isn't^'' did not force to reconcile with debunked the olive branch perry o^family 'afraid she 'll have second meltdown over kevin federline drama legal battle ex husban^brad pitt is not devastated that angelina jolie has a new boyfriend despite tabloid report debunked bradpitt^kristen stewart is not adopting a baby with stella maxwell gossip cop reports kristenstewart factchecking^kendall jenner rocks barely there green thonged bikini at beach in malibu over labor day weekend kendalljenner^jennifer aniston is not moving on with jake gyllenhaal despite tabloid report debunked jenniferaniston^kourtney kardashian and scott disick are back together not quite debunked^kourtney kardashian and scott disick are back together not quite debunked^kourtney kardashian and scott disick are back together not quite debunked^after hospitalization selena gomez seeks 'dialectical behavior therapy so what is that dialectical behavior^xxxtentacion murder case sees second suspect arrested breaking michael boatwright arrested july on^pro golfer bill haas and actor luke wilson involved in fatal car crash in los angeles the two stars involved^xxxtentacion murder case sees second suspect arrested breaking michael boatwright arrested july on^karlie kloss joshua kushner engaged supermodel set to tie the knot with brother supermodel karli^john david duggar proposes to abbie burnett engaged couple soaring to a new life together there yet another du^justin theroux and sienna miller have not been dating since his split from jennifer aniston debunked theroux and^the weinstein company to file for bankruptcy as disgraced harvey recovers in rehab embattled hollywood mogul",107,11,-96,118,0.9067796610169492,-0.8135593220338984,1
14293310,TIME,493,16283207,102369,328775,3,24,46,44,breaking news current events around globe hosted time staff,"george h.w bush died less months wife years doctors elain common^george h.w bush died less months wife years doctors elain common^george h.w bush died less months wife years doctors elain common^john mccain slams half baked spurious nationalism liberty medal acceptance speech^the page obama sunday talk potus interview cbs face nation sunday^read full transcript third presidential debate donald trump hillary clinton^read full transcript first presidential debate hillary clinton donald trump^read full transcript second presidential debate hillary clinton donald trump^read transcript second presidential debate^read transcript first presidential debate hillary clinton donald trump^read transcript final presidential debate^read full transcript th democratic debate charleston^read running transcript second democratic debate^read full transcript th democratic debate charleston^read full transcript th democratic debate charleston^read full text hillary clinton campaign launch speech^see surprisingly popular baby names every u.s. state^the surprisingly popular baby names every state^the surprisingly popular baby names every state^see surprisingly popular baby names every u.s. state^these victims chicago mercy hospital shooting^seth meyers inserted white house press briefing comical results^seth meyers inserted white house press briefing comical results^seth meyers inserted white house press briefing comical results^michelle obama tells students forever first lady college speech^michelle obama tells students 'forever first lady college speech^michelle obama tells students forever first lady college speech^john mayer hospitalized emergency appendectomy^kim kardashian returned white house discuss prison reform^comedian hannibal buress arrested disorderly intoxication miami^comedian hannibal buress arrested disorderly intoxication miami^john krasinski would fly ,000 miles emily blunt^john krasinski would fly ,000 miles emily blunt^john krasinski would fly ,000 miles emily blunt^i angry taylor swift powered sexual assault testimony timepoy^all members british royal family ranked net worth^all members british royal family ranked net worth^all members british royal family ranked net worth^all members british royal family ranked net worth^all members british royal family ranked net worth^all members british royal family ranked net worth^all members british royal family ranked net worth^all members british royal family ranked net worth^all members british royal family ranked net worth^all members british royal family ranked net worth^all members british royal family ranked net worth^all members british royal family ranked net worth^all members british royal family ranked net worth^all members british royal family ranked net worth^all members british royal family ranked net worth^all members british royal family ranked net worth^here kristen stewart felt coming 'saturday night live^here kristen stewart felt coming 'saturday night live^every political moment emmy awards^every political moment emmy awards^gwyneth paltrow says brad pitt threatened kill harvey weinstein alleged sexual harassment^gwyneth paltrow says brad pitt threatened kill harvey weinstein alleged sexual harassment^here katy perry responded taylor swift superfan 'american idol^here katy perry responded taylor swift superfan 'american idol^here katy perry responded taylor swift superfan 'american idol^why hoda kotb revolutionary pick replace matt lauer^why hoda kotb revolutionary pick replace matt lauer^lindsay lohan i racially profiled airport wearing headscarf^oprah intrigued idea running president best friend gayle king says^no one excited meghan markle prince harry animal^kim kardashian 'terrified kids grow social media^kim kardashian 'terrified kids grow social media^kate middleton massive fortune duchess here know royal net worth^kate middleton massive fortune duchess here know royal net worth^kate middleton massive fortune duchess here know royal net worth^here katy perry responded taylor swift superfan 'american idol^here katy perry responded taylor swift superfan 'american idol^here katy perry responded taylor swift superfan 'american idol^james franco denies sexual misconduct allegations interview stephen colbert^james franco denies allegations sexual misconduct^i idea i james franco denies sexual misconduct allegations colbert interview^james franco denies allegations sexual misconduct^i idea i james franco denies sexual misconduct allegations colbert interview^these best tv shows^pregnant serena williams poses nude vanity fair cover^pregnant serena williams poses nude vanity fair cover^former team usa gymnastics doctor larry nassar sentenced years prison sexual abuse^'jeopardy host alex trebek recovering surgery remove blood clots brain^country music star tim mcgraw collapses onstage middle performance ireland^country music star tim mcgraw collapses onstage middle performance ireland^'i pray peace chef eric ripert speaks finding 'best friend anthony bourdain dead^here everything know far 'stranger things season^here everything know far 'stranger things season^here everything know far 'stranger things season^here everything know far 'stranger things season^here everything know far 'stranger things season^yes dad steve coming back 'stranger things season here everything know far^nasa says astronauts see 'star wars the last jedi space^blac chyna granted temporary restraining order rob kardashian^blac chyna granted temporary restraining order rob kardashian^the title 'american horror story season revealed^the title 'american horror story season revealed^mirai nagasu makes history first american woman land triple axel olympics^watch taylor swift new music video end game ed sheeran future^watch taylor swift new music video end game ed sheeran future^watch taylor swift new music video end game ed sheeran future^everything know return 'twin peaks^everything know return 'twin peaks^taylor swift music video director joseph kahn hits back criticism beyonc copied 'bad blood^taylor swift music video director joseph kahn says beyonc copied 'bad blood^melania trump trapped hotel room g20 protesters^melania trump trapped hotel room g20 protesters^'gossip girl star ed westwick denies raping actor kristina cohen^'gossip girl star ed westwick denies raping actor kristina cohen^lady gaga announces year las vegas residency starting^nina simone bon jovi among rock roll hall fame inductees^we know delightful details meghan markle prince harry wedding cake^we know delightful details meghan markle prince harry wedding cake^richard simmons hospitalized evere indigestion^ben affleck jennifer garner officially file divorce^'morning joe co hosts joe scarborough mika brzezinski engaged^'morning joe co hosts joe scarborough mika brzezinski engaged",49,68,19,117,0.4188034188034188,0.1623931623931624,0
15012486,CBSNews,456,6940305,50429,227927,3,77,8,27,your source original reporting trusted news,prosecutors say man arrested nyc subway bombing blamed president trump botched suicide mission posting^george w. bush times father george h.w bush nearly died youth those brushes death made^we need yet we touch yet feel her. president george h.w bush wrote h^i think know i 'm honest person works extremely hard provide accurate information al^nationally u.s. infrastructure earns d+ american society civil engineers least 2 trillion ne^just in michael bennet wins colorado u.s. senate race cbs news projects cbselection election2016^for children u.s. rate deaths increased recently multitude injury dea^a rare potentially paralyzing illness called acute flaccid myelitis afm parents alert the center^the fact matter i believe north koreans prepared serious kim jong susan^donald trump american public office refused acknowledge elicitly attack^susan rice said u.s finds dangerous moment president trump appears further^some may think save party lincoln destroy party trump that may true mark salter^it shows fear something i n't know why picking point time major issue^what good faith leave fly host canadian prime minister starts^former u.s ambassador mexico roberta jacobson described presidential candidate fiery rhetoric south of^i want vote restore congress constitutional responsibility final say imp^they kicked invading part ukraine annexing crimea larry kudlow so it.^the president permitted appoint justice decide whether complies subpo^this president understands importance conservative judges coalition helped get el^we well aware north koreans done past ambassador john bolton talks post summit strate^new interviews president trump scotland ahead monday summit russian president vladimir puti^the real problem bad behavior china pennsylvania sen. pat toomey says president punish^iranian foreign minister tells u.s. enables atrocities saudi arabia continuously an^susan rice challenges president trump notions swift summit saying must amount photo op o^disgraceful john kerry pulls punches week face nation trump putin summit it wasn'^abolishing ice accomplish nothing unless change trump policies sen. richard blumenthal on^watch president trump tells going helsinki summit low eecta^we would able dismantle overwhelming bulk programs within year ambassador john bolton said^he finds appalling families separated mark salter long time friend speech writer sen. john m^plenty republican votes democratic votes that big social changes effected mark salter r^transcript sen. bernie sanders alexandria ocasio cortez face nation july^the important thing stake whether continue cooperate work mexico partners f^sen. bernie sanders says president trump sold american people putin summit^sen. bernie sanders said president trump sold american people summit russian president pu^what could conservative stacked supreme court mean health care reform labor rights i sure th^right russia blanket bombing southern syria that violates last agreement vladimir putin made pres^so far trade war seems heading way modest scale it n't d^it gives opportunity size vladimir putin ambassador john bolton told president trum^could next supreme court justice problem given president selecting someone could po^children nation drug crisis face long term health effects^being ambassador mexico dream job former u.s ambassador roberta jacobson leaving post ad^i found one disgraceful remarkable moments kowtowing foreign leader american pr^citing democrats exclusion summit preparations sen. ed markey said would wise president trump c^watch sen. warren delivers speech foreign policy^rudy giuliani lays conditions trump interview mueller^rudy giuliani lays conditions trump interview mueller^rudy giuliani says pres trump talk special counsel robert mueller next month summit nort^rudy giuliani hopes decision president trump interview special counsel robert mueller north kore^no decision special counsel interview summit north korea new trump lawyer rudy giuliani says^despite saying eected decision july whether president trump would sit intervie^rudy giuliani says president refuse interview special counsel robert mueller unless condition^in six decade history sen. john mccain frequent guest total appearanc^react devastating news orlando mass shooting^the democratic party already discussing series presidential primary debates^the democratic party already discussing series presidential primary debates^hard numbers the u.n. high commission refugees wants 46 million help venezuelan refugees spoke^the photo honduran girl crying mom detained texas grabbed worldwide attention co^a rare potentially paralyzing illness called acute flaccid myelitis afm parents alert the center^officer samuel jimenez identified one four people dead including gunman shooting a^reporter will recognize crimea part russia meet president trump that barack obama^obama campaign woos hispanics tv radio ads^former u.s. president jimmy carter says john mccain admirable naval officer human me^in six decade history sen. john mccain frequent guest total appearanc^watch live holds campaign rally las vegas^happening now president trump greets supporters campaign style rally las vegas^full transcript president donald trump interview face nation^full transcript president donald trump interview face nation^president trump sat anchor ahead meeting pres putin putin no^full transcript president donald trump interview face nation^sanders removing former cia director john brennan security clearance not president looking ta^watch president trump first lady melania trump touch cincinnati president set give a^former u.s. president jimmy carter says john mccain admirable naval officer human me^in six decade history sen. john mccain frequent guest total appearanc^watch now white house press secretary sarah sanders holds briefing says secretary state mike pompeo leave^watch white house press secretary sarah sanders gives briefing hours president trump said n't believe^graham says white house promised cia briefing khashoggi soon^soon white house press secretary sarah sanders give briefing president trump walked back comments russ^one family houston four reasons celebrate fourth july brought home newborn quadrupl^the u.s. trade deficit surged highest level decade even president trump levied new tariffs goods^the cheese industry caught crossfire u.s. trade disputes countries as u.s. imposes tar^leslie jones says targeting comedians inappropriate comments dumb^prince harry reveals considered leaving royal family favor ordinary life^chrissy teigen opens battling postpartum depression^chrissy teigen opens fertility struggles postpartum depression^beyonc reunited destiny child headlining performance coachella return festiva^watch live kabc radio host leeann tweeden holds press conference accused sen. al franken kissing an^they rocked wedding prince harry meghan markle worldwide television audience now kingdom^the u.k. still buzzing couple also wedding much celebration love wa^bill paxton family files wrongful death lawsuit hospital surgeon alleging surgeon lacked eeri^it beautiful day neighborhood tom hanks set play mr. rogers upcoming biopic you are my^prince charles walk meghan markle aisle royalwedding ending days speculation was^pippa middleton marries james matthews almost royal wedding^craig turner tina turner son dead apparent suicide^the hollywood reporter says kermit frog getting new voice years^prince charles walk meghan markle aisle royalwedding ending days speculation was^headlines dominating british tabloids say meghan markle dad attend saturday royal wedding thomas mark^meghan markle confirms father attend royal wedding i always cared father hope he^jesse camp best known vj mtv late reported missing sister stopped^craig mack flava ya ear rapper dead^emmy winning actress julia louis dreyfus announced diagnosed breast cancer^model karlie kloss engaged venture capitalist joshua kushner jared kushner brother^joel taylor storm chasers star dead co star says^danica patrick ricky stenhouse jr. break years^priyanka chopra nick jonas reportedly engaged^actress priyanka chopra seemed confirm news singer nick jonas engaged showing mass^priyanka chopra nick jonas reportedly engaged^priyanka chopra nick jonas reportedly engaged^do i need british accent former president barack obama jokes prince harry interview bbc^tab hunter gay icon star damn yankees dead^lena dunham joins american horror story season^here details prince harry meghan markle wedding cake^american idol winner maddie poppe reveals dating finalist caleb lee hutchinson^american idol winner maddie poppe reveals dating finalist caleb lee hutchinson^prince harry asked elder brother prince william best man wedding next month britain royal offic^pauley perrette announces leaving ncis seasons,11,104,93,115,0.09565217391304348,0.8086956521739129,0
15391102,wusa9,5436,110948,2908,294495,0,5,29,76,your stop breaking news weather traffic dc maryland virginia story ideas email newstips.com,interview with sen. john mccain mccain talked choice sarah palin runningmate c..^read transcript former president obama speech blasting president trump^read transcript former president obama speech blasting president trump^read transcript former president obama speech blasting president trump^read transcript former president obama speech blasting president trump^george clooney hosts star studded dinner la while amal tends their twins exclusive^brad pitt accused child abuse investigation^'american idol crowns season winner^'american idol crowns season winner^jennifer aniston is 'casually dating after split from justin theroux^shannen doherty reveals what she really thinks controversial 'charmed reboot^shannen doherty reveals what she really thinks controversial 'charmed reboot exclusive^shannen doherty reveals what she really thinks controversial 'charmed reboot^ben affleck lindsay shookus split after year dating^channing tatum jenna dewan announce separation^channing tatum jenna dewan announce separation^channing tatum jenna dewan announce separation^brigitte nielsen is pregnant with fifth child see her baby bump^brigitte nielsen is pregnant with fifth child see her baby bump^brigitte nielsen is pregnant with fifth child see her baby bump^brad pitt rumored love interest neri oxman addresses romance reports first time^julia roberts shares sweet pda filled pic herself husband danny moder^prince harry meghan markle fairy tale wedding will include horse carriage pics^angelina jolie 'ramping up battle when it comes brad pitt custody fight source says exclusive^jennifer aniston divorce justin theroux turning dog fight^jennifer aniston divorce justin theroux turning dog fight^jennifer aniston divorce justin theroux turning dog fight^prince harry praises prince charles walking meghan markle down aisle royal wedding^jennifer aniston is 'casually dating after split from justin theroux^joel madden talks turning why he avoiding botox^joel madden talks turning why he avoiding botox^joel madden talks turning why he avoiding botox^teen choice awards the complete winners list^teen choice awards the complete winners list^koko gorilla knew sign language dies^teen choice awards the complete winners list^teen choice awards the complete winners list^walmart remove 'cosmopolitan magazine checkout lines amid me too movement^scott baio wife renee reveals microvascular brain disease diagnosis^scott baio wife renee reveals microvascular brain disease diagnosis^scott baio wife renee reveals microvascular brain disease diagnosis^miss north dakota cara mund crowned miss america^miss north dakota cara mund crowned miss america^ariana grande ex mac miller opens up about their breakup moving on 'i am happy her'^chip joanna gaines welcome baby no see first pics^chip joanna gaines welcome baby no see first pics^chip joanna gaines welcome baby no see first pics^cmt music awards the complete winners list^cmt music awards the complete winners list^cmt music awards the complete winners list^report meghan markle dad longer attend royal wedding^independent spirit awards the complete winners list^bet awards the complete winners list^bet awards the complete winners list^bet awards the complete winners list^ashley judd sues harvey weinstein sexual harassment defamation 'retaliatory conduct^dwayne johnson says he wants marry celebrity crush frances mcdormand sweetest reason^brooke burke files divorce husband david charvet after years marriage^brooke burke files divorce husband david charvet after years marriage^brooke burke files divorce husband david charvet after years marriage^how prince william earned street cred with son prince george^how prince william earned street cred with son prince george^'nypd blue creator steven bochco dead^steven bochco tv creator of 'hill street blues 'nypd blue dead^steven bochco tv creator of 'hill street blues 'nypd blue dead^'nypd blue creator steven bochco dead^steven bochco tv creator of 'hill street blues 'nypd blue dead^'nypd blue creator steven bochco dead^reports priyanka chopra nick jonas engaged two months dating^reports priyanka chopra nick jonas engaged two months dating^billboard music awards the complete winners list^billboard music awards the complete winners list^billboard music awards the complete winners list^lady gaga announces las vegas residency dates^lady gaga announces las vegas residency dates^lady gaga announces las vegas residency dates^brooke burke breaks her silence divorce from david charvet^brooke burke breaks her silence divorce from david charvet^brooke burke breaks her silence divorce from david charvet^cardi b confirms secretly married offset september 'engaged^cardi b confirms secretly married offset september 'engaged^cardi b confirms secretly married offset september 'engaged^wwe star vader dead age^wwe star vader dead age^wwe star vader dead age^john david duggar is engaged abbie burnett^john david duggar is engaged abbie burnett^david foster katharine mcphee are engaged^david foster katharine mcphee are engaged^david foster katharine mcphee are engaged^ashley iaconetti jared haibon get engaged 'bachelor paradise in front her ex^billboard music awards the complete winners list^billboard music awards the complete winners list^billboard music awards the complete winners list^radio disney music awards the complete winners list^radio disney music awards the complete winners list^radio disney music awards the complete winners list^jennifer aniston biggest revelations from her first major interview since justin theroux split^jennifer aniston biggest revelations from her first major interview since justin theroux split^will smith addresses jada pinkett divorce rumors new song^channing tatum spotted without wedding ring first time since jenna dewan split see pic^prince william prince harry best man royal wedding^prince william prince harry best man royal wedding^prince william prince harry best man royal wedding^kaley cuoco says ex husband ryan sweeting 'ruined word marriage^kaley cuoco says ex husband ryan sweeting 'ruined word marriage^kaley cuoco says ex husband ryan sweeting 'ruined word marriage^april giraffe pregnant^april giraffe pregnant^april giraffe pregnant due next year,29,81,52,110,0.2636363636363636,0.4727272727272727,0
163058272,MSNSouthAfrica,446,9967,58,127745,0,0,91,19,get quick access email accounts social networks microsoft apps msn homepage,kim kardashian kanye west look miserable date night 'drop 1.2million security surrogate^robin wright 'nightmare house of cards set^kim kardashian 'hurt awkward exchange beyonce^wrong selena gomez pregnancy rumors^kanye west shares texts with caitlyn jenner one year after falling out with kim kardashian^kim kardashian west working free another convicted drug felon details^oprah winfrey elains why she keeps her relationship stedman graham so private^victoria beckham david beckham splitting over bella hadid^fergie josh duhamel split^angelina jolie wearing ring brad pitt get back^katie holmes jamie foxx plit call wedding five years secret romance^does rihanna drake 'unfinished business^katie holmes jamie foxx battling prenup^the many hats fascinators meghan duchess sussex^meghan duchess sussex style file^rihanna hurt over drake nicki minaj dating rumors is made up story^katie holmes jamie foxx plit call wedding five years secret romance^jennifer aniston didn attack justin theroux^brad pitt thinks leaving jennifer aniston angelina jolie biggest mistake life^lady gaga reveals heartbreaking reason she split taylor kinney^lady gaga reveals heartbreaking reason split taylor kinney^lorde sets record straight taylor swift friendship fiery letter^kourtney kardashian furious scott disick introduces kids gf sofia kuwtk^a hong kong woman was tricked into marrying stranger china during job offer scam^amal george clooney welcome twins^kim kardashian details fights husband kanye west instagram hangout time band aids^miley cyrus liam hemsworth calling engagement^calling engagement^angelina jolie 'is happy current custody deal brad pitt report^jennifer lopez hired private investigator tail alex rodriguez^kylie jenner travis scott spending 30 million on wedding^ben affleck lindsay shookus split after year dating^kim kardashian going bald^jennifer aniston asks courteney cox set new man^drake heartbroken rihanna blew off his birthday party^selena gomez betrayed by the weeknd^the many hats fascinators meghan duchess sussex^meghan duchess sussex style file^kim kardashian not 'catfight beyonce despite report^jennifer lopez confirms relationship new boyfriend drake cutest way new year^the real reason mel b ended turbulent marriage stephen belafonte revealed^miley cyrus really regrets 'wrecking ball video^i enjoy single hard angelina jolie^dakota johnson chris martin are dating^angelina jolie i 'm relieved brad pitt cleared child abuse i take action^brad pitt rumored love interest neri oxman addresses romance reports first time^jennifer aniston looking to destroy justin theroux^jennifer aniston trying to destroy justin theroux career^royal tensions queen puts strain meghan markle prince harry prenuptial agreement^george clooney shows off pics his twins jokes they 're like models^style sisters catherine duchess cambridge meghan markle^style sisters catherine duchess cambridge meghan markle^angelina jolie not pouring her heart out about brad pitt to kate middleton despite reports^katie holmes furious jamie foxx charlize theron flirting^celebrity mother day wishes melt heart^kim kardashian kanye west secretly separated^why kylie jenner stopped showing stormi face she 'shocked 'nasty comments source says^kanye west launches 'mind control rant twitter^kristen stewart drew barrymore not lesbian lovers despite claim^how brad pitt angelina jolie divorce eloded^how brad pitt angelina jolie divorce eloded^angelina jolie 'focused healing her family splits lawyer brad pitt divorce^brad pitt not having baby with charlotte casiraghi despite report^barack obama michelle obama 'marriage problems fake news^angelina jolie can see past her anger toward brad pitt amid custody battle^brad pitt was done being mr. nice guy custody battle with angelina jolie^what angelina jolie collapsed due stress caused custody battle brad pitt^prince harry asking meghan markle father hand marriage made story^are amy schumer john mayer dating^victoria david beckham trying to buy a happy marriage^tom cruise 'envious katie holmes 'romance jamie foxx fake news^kim kardashian details fights husband kanye west instagram hangout time band aids^miley cyrus liam hemsworth fighting over where to live^jada pinkett smith gabrielle union feuding again after reconciling^justin theroux jennifer aniston heartbreaking divorce^is kate hudson brad pitt twins^mila kunis jealous demi moore body^ariel winter slams media body shamers in twitter rant^ryan gosling dumped eva mendes^celebrity feuds december^kim kardashian details fights husband kanye west instagram hangout time band aids^angelina jolie 'dangerous diet^selena gomez justin bieber not 'reconnecting despite reports^is kim kardashian kanye west marriage trouble^is kim kardashian kanye west marriage trouble^prince harry did not go missing before wedding to meghan markle despite claim^kim kardashian kylie jenner not at war over makeup lines despite report^katie holmes not wearing engagement ring jamie foxx despite report^meghan markle already pregnant one month after royal wedding^fyi kourtney kardashian scott disick finally back together^new romance rumors hit caitlyn jenner sophie hutchins plus news jenner^enrique iglesias anna kournikova secretly welcome twins^tom petty is dead^'this is us star justin hartley marries chrishell stause plus romance updates^tisha campbell files divorce husband duane martin^prince harry meets us first lady melania trump ahead invictus games^unusual celebrity fashion trends that will make you scratch your head^'superman star margot kidder dead^tina turner eldest son dead craig raymond dies apparent suicide^hugh hefner cause death revealed^meghan markle will walk aisle father thomas royal wedding ... 'll meet queen^victoria secret adriana lima 'i take clothes anymore empty cause'^beyonc family pics among never seen photos 'how make lemonade box set book^jennifer lawrence darren aronofsky split^jennifer lawrence darren aronofsky reportedly split^pippa middleton 'snubbed prince harry meghan mysteriously left wedding reception invite list^meghan markle committed ultimate outfit pippa middleton wedding^how get away murder star karla souza alleges she was raped by director mexico^meghan markle admits she misses 'suits ahead show season premiere^mobb deep rapper prodigy cause death revealed,91,19,-72,110,0.8272727272727273,-0.6545454545454545,1
136361303,voguemagazine,520,13732668,23660,137324,0,0,76,33,the official twitter page vogue magazine,in first magazine cover interview amal clooney gives us exclusive glimpse life get know in^in first magazine cover interview amal clooney gives us exclusive glimpse life get know in^in first magazine cover interview amal clooney gives us exclusive glimpse life get know in^in first magazine cover interview amal clooney gives us exclusive glimpse life get know in^in first magazine cover interview amal clooney gives us exclusive glimpse life get know in^in first magazine cover interview amal clooney gives us exclusive glimpse life get know in^in first magazine cover interview amal clooney gives us exclusive glimpse life get know in^in first magazine cover interview amal clooney gives us exclusive glimpse life get know in^the voluptuous lips time angelina jolie pitt marilyn monroe^the voluptuous lips time angelina jolie pitt marilyn monroe^on may world spotlight shone brightly prince harry meghan duchess sussex wed winds^go inside windsor royal county berkshire polo club prince harry played meghan duchess sus^with next official engagement set september prince harry meghan duchess sussex retre^go inside windsor royal county berkshire polo club prince harry played meghan duchess sus^leave queen elizabeth give prince harry meghan duchess sussex best wedding present couple c^leave queen elizabeth give prince harry meghan duchess sussex best wedding present couple c^leave queen elizabeth give prince harry meghan duchess sussex best wedding present couple c^leave queen elizabeth give prince harry meghan duchess sussex best wedding present couple c^nextflix released updates the crown season casting including play teenage prince charles^nextflix released updates the crown season casting including play teenage prince charles^the voluptuous lips time angelina jolie pitt marilyn monroe^the voluptuous lips time angelina jolie pitt marilyn monroe^this group supermodels do outdoor style^this group supermodels do outdoor style^this group supermodels do outdoor style^this group supermodels do outdoor style^years video still red hot song wise stylistically^on may world spotlight shone brightly prince harry meghan duchess sussex wed winds^go inside windsor royal county berkshire polo club prince harry played meghan duchess sus^with next official engagement set september prince harry meghan duchess sussex retre^go inside windsor royal county berkshire polo club prince harry played meghan duchess sus^leave queen elizabeth give prince harry meghan duchess sussex best wedding present couple c^leave queen elizabeth give prince harry meghan duchess sussex best wedding present couple c^leave queen elizabeth give prince harry meghan duchess sussex best wedding present couple c^leave queen elizabeth give prince harry meghan duchess sussex best wedding present couple c^dakota johnson errands running outfit relatable^here get dakota johnson sculpted abs^dakota johnson elevates unlikeliest pieces glam status^reading lines selena gomez new single aptly titled back you^reading lines selena gomez new single aptly titled back you^reading lines selena gomez new single aptly titled back you^the voluptuous lips time angelina jolie pitt marilyn monroe^the voluptuous lips time angelina jolie pitt marilyn monroe^dakota johnson chris martin reportedly dating^dakota johnson chris martin reportedly dating^dakota johnson chris martin reportedly dating^dakota johnson chris martin reportedly dating^dakota johnson chris martin reportedly dating^katie holmes stepped perfect weekend casual outfit^katie holmes stepped perfect weekend casual outfit^katie holmes stepped perfect weekend casual outfit^the voluptuous lips time angelina jolie pitt marilyn monroe^the voluptuous lips time angelina jolie pitt marilyn monroe^gorgeous private islands vacationing like taylor swift calvin harris^gorgeous private islands vacationing like taylor swift calvin harris^gorgeous private islands vacationing like taylor swift calvin harris^the voluptuous lips time angelina jolie pitt marilyn monroe^the voluptuous lips time angelina jolie pitt marilyn monroe^the voluptuous lips time angelina jolie pitt marilyn monroe^the voluptuous lips time angelina jolie pitt marilyn monroe^queen elizabeth ii alongside husband prince philip attended wedding prince harry meghan markle st.^katie holmes stepped perfect weekend casual outfit^katie holmes stepped perfect weekend casual outfit^katie holmes stepped perfect weekend casual outfit^prince harry meghan markle released three official wedding portraits two days fairy tale wedd^prince harry meghan markle released three official wedding portraits two days fairy tale wedd^this summer family taking ultimate all american vacation road trip^this summer family taking ultimate all american vacation road trip^this summer family taking ultimate all american vacation road trip^years video still red hot song wise stylistically^selena gomez made instagram official justin bieber^selena gomez justin bieber attended hot yoga session retro inspired athleisure looks^selena gomez justin bieber attended hot yoga session retro inspired athleisure looks^selena gomez justin bieber attended hot yoga session retro inspired athleisure looks^selena gomez justin bieber attended hot yoga session retro inspired athleisure looks^selena gomez justin bieber attended hot yoga session retro inspired athleisure looks^the announcement last week prince harry engaged meghan markle divorc e something revelation^the announcement last week prince harry engaged meghan markle divorc e something revelation^the announcement last week prince harry engaged meghan markle divorc e something revelation^reportedly pregnant first child^reportedly pregnant first child^reportedly pregnant first child^everything know far pippa middleton upcoming wedding^everything know far pippa middleton upcoming wedding^everything know far pippa middleton upcoming wedding^everything know far pippa middleton upcoming wedding^everything know far pippa middleton upcoming wedding^alicia vikander michael fassbender reportedly married^in end meghan markle attended reception pippa middleton wedding^prince harry meghan markle reportedly seated separate tables pippa middleton wedding^in end meghan markle attended reception pippa middleton wedding^in end meghan markle attended reception pippa middleton wedding^prince harry meghan markle reportedly seated separate tables pippa middleton wedding^the first trailer 'the assassination gianni versace american crime story give chills^the first trailer 'the assassination gianni versace american crime story give chills^the first trailer 'the assassination gianni versace american crime story give chills^the first trailer 'the assassination gianni versace american crime story give chills^the first trailer 'the assassination gianni versace american crime story give chills^a look back saoirse ronan best red carpet moments year^a look back saoirse ronan best red carpet moments year^things probably n't know liu yifei set play disney mulan^things probably n't know liu yifei set play disney mulan^things probably n't know liu yifei set play disney mulan^things probably n't know liu yifei set play disney mulan^things probably n't know liu yifei set play disney mulan^things probably n't know liu yifei set play disney mulan^things probably n't know liu yifei set play disney mulan^things probably n't know liu yifei set play disney mulan^things probably n't know liu yifei set play disney mulan,76,33,-43,109,0.6972477064220184,-0.3944954128440367,1
18334825,BazaarUK,805,527702,3392,102495,0,0,46,61,fashion beauty culture art travel need stylish life,reese witherspoon 'legally blonde progress this going good^reese witherspoon 'legally blonde progress this going good^reese witherspoon 'legally blonde progress this going good^jennifer lawrence darren aronofsky spending time together following split^jennifer lawrence reveals brutal way amy schumer comforted darren aronofsky split^jennifer lawrence ex darren aronofsky reunite split^jennifer lawrence darren aronofsky reportedly seeing happens split^jennifer lawrence reveals brutal way amy schumer comforted darren aronofsky split^things selena gomez get amazing body^the complete timeline meghan markle amp prince harry relationship^the complete timeline meghan markle amp prince harry relationship^judge dismisses former dj david mueller case taylor swift groping trial^the complete list winners golden globes^the complete list winners golden globes^the trick defining eyes like meghan duchess sussex^here duchess cambridge actually eats day^the duchess cambridge beats duchess sussex top royal style influencer^the duchess cambridge adopts clever technique stop shoes slipping^here duchess cambridge maternity leave prince louis different george cha^the crown season casts prince charles queen mother^this reportedly playing prince charles season three 'the crown^the crown season casts prince charles queen mother^this reportedly playing prince charles season three 'the crown^lady gaga reveals heartbreaking reason split taylor kinney^rachel weisz daniel craig interesting love story^the trick defining eyes like meghan duchess sussex^bazaar met the phantom opera diva carlotta otherwise known fashionmoment howbazaar^i n't enjoy single says angelina jolie^i n't enjoy single says angelina jolie^i n't enjoy single says angelina jolie^i n't enjoy single says angelina jolie^dakota johnson chris martin definitely dating^dakota johnson chris martin definitely dating^did see angelina jolie breaks silence divorce^angelina jolie breaks silence divorce^angelina jolie breaks silence divorce saying relieved statement^angelina jolie breaks silence divorce official statement^are prince harry meghan markle moving cotswolds^are prince harry meghan markle moving countryside^prince harry meghan markle reportedly moving countryside^is meghan markle moving kensington palace prince harry^are prince harry meghan markle moving cotswolds^in today surprising news reportedly line judge 'american idol remake^selena gomez reveals kidney transplant summer^selena gomez reveals kidney transplant summer^exclusive inside 'the lost city z premiere party sienna miller charlie hunnam robert pattinson amp co^was empty seat royal wedding meant princess diana^rose byrne pregnant second child^rose byrne pregnant second child^jessica biel shares secret happy marriage justin timberlake^jessica biel shares secret happy marriage justin timberlake^see first arrivals met gala including alicia vikander^jennifer lawrence calls harvey weinstein horrible ass boil^jennifer lawrence calls harvey weinstein horrible ass boil^mindy kaling reportedly pregnant first child^mindy kaling reportedly pregnant first child^adriana lima hints hanging victoria secret wings good i take clothes anymore for^stranger things star shannon purser comes bisexual^stranger things star shannon purser comes bisexual^kim kardashian shares first photo baby chicago west^kim kardashian shares first photo baby chicago west^kim kardashian shares first photo baby chicago west^everything know far pippa middleton wedding^everything know far pippa middleton wedding^as prepares marry month everything know pippa middleton wedding far^everything know far pippa middleton wedding^everything know far pippa middleton wedding^everything know far pippa middleton wedding^everything know far pippa middleton wedding^everything know far pippa middleton wedding^everything know far pippa middleton wedding^rosie huntington whiteley one bazaar best dressed stars week^julia louis dreyfus reveals diagnosed breast cancer^julia louis dreyfus reveals diagnosed breast cancer^kaley cuoco wears beautiful bridal jumpsuit marries karl cook^kaley cuoco wears beautiful bridal jumpsuit marries karl cook^kaley cuoco wears beautiful bridal jumpsuit marries karl cook^alicia vikander michael fassbender reportedly married^alicia vikander michael fassbender reportedly married^jennifer lawrence darren aronofsky spending time together following split^jennifer lawrence darren aronofsky split one year dating^jennifer lawrence ex darren aronofsky reunite split^jennifer lawrence darren aronofsky reportedly seeing happens split^jennifer lawrence darren aronofsky split one year dating^priyanka chopra nick jonas reportedly engaged^meghan markle prince harry n't sit together pippa middleton wedding^meghan markle prince harry n't sit together pippa middleton wedding^is meghan markle n't pippa middleton wedding prince harry^icymi prince harry made mile round trip collect meghan markle pippa middleton wedding reception^meghan markle prince harry n't sit together pippa middleton wedding reception^andrew garfield i gay man right without physical act^andrew garfield i gay man right without physical act^andrew garfield i gay man right without physical act^andrew garfield i gay man right without physical act^andrew garfield i gay man right without physical act^andrew garfield i gay man right without physical act^bradley cooper irina shayk welcome first child^michelle williams reportedly engaged andrew youmans^michelle williams reportedly engaged andrew youmans^alicia vikander michael fassbender 'honeymoon italy secret wedding^alicia vikander michael fassbender 'honeymoon italy secret wedding^alicia vikander michael fassbender 'honeymoon italy secret wedding^colin firth vows never work woody allen^colin firth vows never work woody allen^reese witherspoon confirms legally blonde happening^daniel craig finally confirms play james bond^ben affleck jennifer garner officially file divorce,46,61,15,107,0.4299065420560748,0.14018691588785046,0
17446621,THR,2757,3091894,22081,388742,0,11,55,40,the hollywood reporter premier destination widely trusted resource entertainment news reviews videos,trump acts political violence place u.s. bipartisan statement i tell fro^michael avenatti said statement via social media make decision lightly it^in interview 'the ingraham angle fox news tuesday night suzanne somers said morgan freeman big fli^fox news remained atop cable news ratings october interview president trump monday 'ingra^brita mccollough amp brenda ryan contend result speaking blacklisted wiretapped and^sunday edition 'this week with george stephanopoulos make lighthearted viewing^mark zuckerberg ad follows revelation data analytics firm ties donald trump presidential cam^on friday morning singer used eletive describe joy behar interview 'fox amp friends^the 'apocalypse title appear callback antichrist baby season one 'murder house tate langdon^ryan murphy push tv directing equality making big strides first year^john brennan says speaking due continued failure part donald trump.^cheered snowboarder chloe kim women halfpipe competition though comedian wasn't^john mayer hospitalized emergency appendectomy representatives say^george clooney opens parenting twins denies using fertility drugs^shia labeouf director david ayer worked together wwii drama 'fury teaming crime thril^marvel fun fact thor star n't make director kenneth branagh original shortlist th^cover jennifer aniston reveals struggles with dyslexia anger shrugs off oscar snub^jenniferaniston reveals struggles with dyslexia anger shrugs off oscar snub^cover jennifer aniston reveals struggles with dyslexia anger shrugs off oscar snub^oscars in memoriam garry shandling robert vaughn among snubs^when steven spielberg steven bochco worked tv show sean penn dad noam chomsky cousin^icymi when steven spielberg steven bochco worked tv show sean penn dad noam chomsky^steven spielberg amp meryl streep trump news oscars best picture nom 'the post made eve^exclusive thecrown casts its prince charles queen mother season^thecrown found new actors josh o'connor marion bailey take central roles prince cha^thecrown producer teases new characters season three the arrival new generation characters pr^hollywood stars slam house vote obamacare replacement^which kardashian jenner americans jealous say say^mark hamill asks starwars fans lobby carrie fisher star^'live duo kelly ripa ryan seacrest inspire abc scripted comedy 'work wife^alexis bledel lends hope third 'sisterhood traveling pants movie^venice film review mel gibson vince vaughn 'dragged across concrete^venice vince vaughn recruiting mel gibson 'dragged across concrete^report george clooney looking sell italian villa because paparazzi^'live duo kelly ripa ryan seacrest inspire abc scripted comedy 'work wife^jennifer lopez stylists secrets behind dressing fashionable diva video^read thr review destroyer nicole kidman dives deep end troublesome crime drama the film will^telluride2018 nicole kidman 'destroyer tour de force could return oscar contention^nicole kidman goes dark tiff18 crime drama destroyer the oscar winner admits went deep charac^michael strahan sara haines host new 'good morning america hour^taylor swift stage reputationtour opening night if someone using name calling bully social me^kicks reputationtour calling bullies^cannes film festival announces dates^guardians they putting movie it hold indefinitely to honest i^takes shot nbc kanye west snl pro trump rant live show^due return screens later year season three thecrown focus era prime minister harold^still cast role princess diana producers confirmed would introduced toward end of^kicking big move she officially replace matt lauer co anchor amp^the film split three parts first part 'chorus cosmos narrated millie bobby brown and^cannes chloe grace moretz joins animated 'red shoes seven dwarfs exclusive^toronto matthias schoenaerts join nazi revenge thriller 'ruin^in addition jason momoa aquaman also stars nicole kidman^nicole kidman willem dafoe aquaman character posters revealed^'live duo kelly ripa ryan seacrest inspire abc scripted comedy 'work wife^report madonna considering move rome^says oprah winfrey joking running president^jennifer lawrence terrified 'mother teaser trailer mothermovie^jennifer lawrence terrified 'mother teaser trailer mothermovie^'live duo kelly ripa ryan seacrest inspire abc scripted comedy 'work wife^alec baldwin stepping away twitter following criticism weinstein payoff comments^reveals kidney transplant amp shared picture donor she gave ultimate gift^exclusive betty gilpin joins dennis quaid josh gad 'a dog purpose follow^exclusive joins dennis quaid 'a dog purpose follow^abc sets june premiere dates rachel bilson eddie cibrian drama taketwo creators castle unscripte^tv review rachel bilson eddie cibrian 'take two^with actress father missing royalwedding saturday prince charles father groom prince harry w^nypd harvey weinstein arrested processed charged rape criminal sex act sex abuse sexual misco^thegooddoctor first drama renewed abc television season joining comedies thegoldbergs^'fear walking dead promotes colman domingo series regular season^rt 'walking dead promotes three series regular season^with returning second year host shortage jokes jabs sunday night^keri russell going cold war starwars the actress coming series finale of^blake lively injured set 'the rhythm section^youtube star austin jones arrested child pornography charges^youtube star austin jones arrested child pornography charges^cast title role nbc next live musical 'jesus christ superstar'^donald trump almost played president sharknado the donald said yes he thrilled asked^flavor flav sues chuck d public enemy team unpaid royalties releasing music without consent^jennifer lawrence drinks rum calls harvey weinstein horrible ass boil^mtv movie amp tv awards big sean noah cyrus set perform^former mtv vj jesse camp found family reported missing days ago police say^sues harvey weinstein sexual harassment defamation^americanhorrorstory season title revealed^announces 'man woods north american tour dates^outlander renewed seasons starz^watch queereye cast react tom jackson abby parr wedding^daytime creative arts emmy awards the complete winners list^watch puts awards show boot camp^'once upon time renewed season abc ouat^fullerhouse renewed season netflix^exclusive joins thevoice coach season return^matt damon ben affleck production company next adopt inclusion riders frances mcdormand oscars^rent set fox next live musical^channing dungey president abc entertainment thanks glenn weiss eerienced talked about^icymi cher announces broadway musical based life coming^cher announces broadway musical based life coming^rock roll hall fame among inductees^ryan murphy shares first look jessica lange ahs return upcoming ahsapocalypse episode directed sarah^the first look ahscult politically charged season reveals polarizing plot ryan murphy horror spin^'13 reasons why officially renewed season netflix^year old loretta lynn admitted nashville hospital thursday night suffering stroke home^clarkson host billboard music awards^manuel joins voice cast ducktales reboot^they say 'put hands ving rhames says police held gunpoint home^i open door red dot pointed face ving rhames says police held gunpoint own^ving rhames says police held gunpoint home,55,51,-4,106,0.5188679245283019,-0.03773584905660377,1
6509832,CNNnews18,487,4261259,6327,716893,1,88,6,7,lightning fast alerts breakingnews india world,an indian american announced run us house representatives florida district^live i demand statement ed status investigation rajeshwar singh bjp mp on^exclusive i feel cheated statement given home minister in spite writing c^breaking pnb scam accused mehul choksi issues statement says i lawful citizen antigua i visited us in^breaking janardhana reddy arrested basis questioning available evidence statement witn^exclusive we need convert islam taking money we condemn statement made bjp radhika vemu^yoginizamjibe when made statement part political campaign said t^breaking taken custody booked section a ipc statement peo^burarideathmystery civil lines sdm bk jha recorded statement relatives eleven people a^statement union minister hurts sentiments poor dalits we forget radhika vemula s^breaking the party seeks represent heritage mahatma gandhi jawaharlal nehru indra^breaking we congress completely reject statement saifuddin soz attempt sell hi^burarideathmystery civil lines sdm bk jha recorded statement relatives eleven people a^breaking big statement army chief gen rawat dismisses un report kashmir says need concerned^sabarimalaforall this question gender equality wrong statement put forward^exclusive both onair beneficiaries accused case their statement holds n^muftiwarnsbjp statement proved i saying she always soft is^breaking actor dileep shared post facebook saying returning organisation until^it good enough congress distance statement saifuddin soz^breaking we congress completely reject statement saifuddin soz attempt sell hi^rammandirpolitics which side debate tweet using hashtag join on^roadto2019 which side debate electionswithnews18 join therightstand^congvsrss which side debate tweet using hashtag watch therightstand^ayodhyadelay which side debate tweet using hashtag join viewpoint^antimodibloc which side debate join therightstand^hajamendment side debate tweet using hashtag join navjyot settingtheagenda^hindutvavsnationalism which side debate tweet using hashtag join on^kejrimirchiattack which side debate tweet us using hashtag join navjyot on^rafalepolitics which side debate fire views using hashtag join^omarseparatistcall which side debate tweet using hashtag join on^yearsofdemo which side debate tweet using hashtag join viewpoint^righttobreathe which side debate join therightstand^antimodibloc which side debate roadto2019 join viewpoint^demographicjibe which side debate join therightstand^electionswithnews18 which side debate battleforstates neechpolitics join^sabarimalaforall which side debate tweet using hashtag join on^cbivscbi which side debate join viewpoint^omarseparatistcall which side debate join therightstand^rssformandirlaw which side debate tweet using hashtag tell us think join^antimodibloc which side debate roadto2019 join viewpoint^demographicjibe which side debate join therightstand^indiashining which side debate roadto2019 join viewpoint^rssformandirlaw which side debate tweet using hashtag tell us think join^cbivscbi which side debate join viewpoint^sabarimalaforall which side debate tweet using hashtag join on^yearsofdemo which side debate tweet using hashtag join viewpoint^rafalepolitics which side debate tweet using hashtag join viewpoint^rafalepolitics which side debate tweet using hashtag join viewpoint^electionswithnews18 which side debate battleforstates watch poll polls viewpoint wi^sabarimalaforall the debate heats panellists studio entry women sabarima^rammandirpolitics which side debate tweet views using hashtag join^michelextradited will christian michel spill secrets will political masterminds agusta deal revealed^statueofunity which side debate tweet using hashtag join therightstand^pmdarescongress which side debate tweet using hashtag join on^punjabtrainmishap which side debate join viewpoint tweet using the^michelextradited will christian michel spill secrets will political masterminds agusta deal revealed^rammandirpolitics which side debate join viewpoint^rammandirbill which side debate join viewpoint^rafalepolitics is rafale controversy opposition sponsored political stunt supreme court refuses go^rammandirpolitics which side debate tweet using hashtag join on^electionswithnews18 which side debate battleforstates watch poll polls viewpoint wi^sabarimalaforall which side debate tweet using hashtag join on^rafalepolitics which side debate tweet using hashtag join viewpoint^rammandirbill which side debate watch viewpoint^rssformandirlaw which side debate tweet using hashtag join viewpoint^roadto2019 which side debate tweet using hashtag electionswithnews18 join^rammandirpolitics which side debate tweet using hashtag^hafizkhalistanlink the debate heats s.s. ahluwalia dal .^electionswithnews18 which side debate tweet using hashtag battleforstates |^antimodibloc which side debate roadto2019 join viewpoint^rafalepolitics which side debate join viewpoint^cbivscbi which side debate tweet using hashtag join viewpoint^roadto2019 which side debate tweet using hashtag electionswithnews18 join^sidhukhalistanphoto which side debate tweet using hashtag watch settingtheagenda with^the debate heats syed afzal abbas settingtheagenda navjyot^cbivscbi which side debate tweet using hashtag join viewpoint^righttobreathe which side debate tweet using hashtag join viewpoint^rammandirbill which side debate join therightstand^cbivscbi which side debate tweet using hashtag join viewpoint^hindutvavsnationalism which side debate tweet using hashtag join on^battleforstates which side debate join viewpoint^rammandirpolitics which side debate tweet using hashtag join on^rafalepolitics is rafale controversy opposition sponsored political stunt supreme court refuses go^indiashining which side debate tweet using hashtag watch viewpoint with^rammandirbill which side debate tweet views using hashtag join on^modiinus pm modi president trump issue joint statement rose garden white house shortly.^breaking cec speaks cnn news18 ex vp hamid ansari objection onenationonepoll says 'we comm^ban remain place satisfactory corrective actions taken us department agriculture said^encounter delhi chhattarpur area four criminals including rajesh bharti killed one seriously injured s^channing tatum jenna dewan announce loving separation social media ask fans press privacy |^photos catherine duchess cambridge gave birth healthy baby boy third child kate prince will^photos catherine duchess cambridge gave birth healthy baby boy third child kate prince will^actors jennifer aniston justin theroux reportedly trying fix broken marriage^angelina jolie reportedly made google alert brad pitt name keep tabs^angelina jolie reportedly made google alert brad pitt name keep tabs^prince harry engaged girlfriend meghan markle^meghan markle engaged britain prince harry become first royal fiance spend christmas wit^miss north dakota cara mund crowned miss america final night competition atlantic city^prince charles walk meghan markle aisle royal wedding stepping father br^the golden globes presenters list includes penelope cruz gal gadot seth rogen^prince charles walk meghan markle aisle royal wedding stepping father br^taylor swift stalker who threatened to kill her and family sentenced to years probation,7,95,88,102,0.06862745098039216,0.8627450980392157,0
19247844,glamourmag,1172,1358475,7690,119906,2,0,63,36,redefining fulfillment women get latest beauty fashion culture news glamour,i hope change i want see community. veronica r. johnson probation offic^our country needs us we ones forge bipartisan craziness going build t^white house says kellyanne conway acted without nefarious motive told us go buy ivanka stuff^icymi kellyanne conway broke law telling us go buy ivanka stuff^kellyanne conway broke law telling us go buy ivanka stuff^today weird rumors was taylor swift carried apartment huge suitcase^a complete timeline prince harry meghan markle relationship^a complete timeline prince harry meghan markle relationship^a complete timeline prince harry meghan markle relationship^a complete timeline prince harry meghan markle relationship^a complete timeline prince harry meghan markle relationship^a complete timeline prince harry meghan markle relationship^a complete timeline prince harry meghan markle relationship^a complete timeline prince harry meghan markle relationship^the real reason justin bieber selena gomez hanging^the real reason justin bieber selena gomez hanging^justin bieber reveals real reason relationship selena gomez n't last^the real reason justin bieber selena gomez hanging^justin bieber reveals real reason relationship selena gomez n't last^the real reason justin bieber selena gomez hanging^justin bieber reveals real reason relationship selena gomez n't last^gal gadot daughter impressed mom wonder woman^gal gadot daughter impressed mom wonder woman^uh oh liam hemsworth miley cyrus wedding reportedly^katie couric opened first time working matt lauer 'today show^katie couric opened first time working matt lauer 'today show^katie couric opened first time working matt lauer 'today show^katie couric opened first time working matt lauer 'today show^twitter meme ing ivanka trump 'us weekly 'why i disagree with my dad cover^twitter meme ing ivanka trump 'us weekly 'why i disagree with my dad cover^twitter meme ing ivanka trump 'us weekly 'why i disagree with my dad cover^amal george clooney welcome twins names cute congrats^amal george clooney welcome twins names cute congrats^keith urban appropriately gushed nicole kidman cmt awards^here fans think kylie jenner already baby^here fans think kylie jenner already baby^here fans think kylie jenner already baby^here fans think kylie jenner already baby^here ton fans think kylie jenner *already* baby^selena gomez called nick jonas ruining double date joe jonas taylor swift^selena gomez called nick jonas ruining double date joe jonas taylor swift^selena gomez called nick jonas ruining double date joe jonas taylor swift^hailee steinfeld rumors dating justin bieber^hailee steinfeld rumors dating justin bieber^hailee steinfeld rumors dating justin bieber^hailee steinfeld rumors dating justin bieber^anastasia steele er dakota johnson wore prettiest interesting updo 've seen come see^americanidol fueling katy perry taylor swift feud^americanidol fueling katy perry taylor swift feud^amp shared the gorgeous pix romantic vacay^amp shared the gorgeous pix romantic vacay^kris jenner developing kardashian kids spinoff yet^kris jenner developing kardashian kids spinoff yet^kris jenner developing kardashian kids spinoff yet^kris jenner developing kardashian kids spinoff yet^meghan markle moving london weeks prince harry could tie knot sooner think^meghan markle moving london weeks prince harry could tie knot sooner think^ryan seacrest texted kris jenner kylie pregnancy live tv and replied^ryan seacrest texted kris jenner kylie pregnancy live tv and replied^khlo kardashian opened instagram sunday reliving tristan thompson cheating kuwtk^khlo kardashian opened instagram sunday reliving tristan thompson cheating kuwtk^selena gomez reveals kidney transplant emotional instagram post^selena gomez reveals kidney transplant emotional instagram post^americanidol fueling katy perry taylor swift feud^americanidol fueling katy perry taylor swift feud^ed sheeran engaged girlfriend cherry seaborn and announcement ruin^caitriona balfe outlander engaged^caitriona balfe outlander engaged^caitriona balfe outlander engaged^ellen degeneres apologizes jenna dewan accidentally calling 'tatum^ellen degeneres apologizes jenna dewan accidentally calling 'tatum^ellen degeneres apologizes jenna dewan accidentally calling 'tatum^ellen degeneres apologizes jenna dewan accidentally calling 'tatum^taylor swift released insanely catchy new song called gorgeous listen^j.k. rowling really sorry killing beloved harry potter character^j.k. rowling really sorry killing beloved harry potter character^j.k. rowling really sorry killing beloved harry potter character^here frustrating reason best album nominee lorde wo n't performing grammys^your fave mindy kaling reportedly pregnant first child^your fave mindy kaling reportedly pregnant first child^rihanna wants time travel back day lost virginity^rihanna wants time travel back day lost virginity^rihanna wants time travel back day lost virginity^mila kunis makes monthly donations planned parenthood mike pence name^here likely reason meghan markle n't pippa middleton wedding ceremony^meghan markle n't allowed sit next prince harry pippa middleton wedding reception^prince harry meghan markle reportedly 'as good engaged^prince harry meghan markle reportedly 'as good engaged^prince harry meghan markle reportedly 'as good engaged^khlo kardashian kylie jenner joke many babies^this huge a 'grey anatomy spin coming abc^this huge a 'grey anatomy spin coming abc^this huge a 'grey anatomy spin coming abc^this huge a 'grey anatomy spin coming abc^this huge a 'grey anatomy spin coming abc^kylie jenner still missing kardashian jenner christmas card^kylie jenner still missing kardashian jenner christmas card^blake lively shuts reporter asked question fashion^blake lively shuts reporter asked question fashion^blake lively shuts reporter asked question fashion^blake lively shuts reporter asked question fashion,65,36,-29,101,0.6435643564356436,-0.2871287128712871,1
19593048,KISS107,1448,23063,316,191171,0,1,71,28,cincinnati hit music station real ppl tweet robots,probably let real we get guys meet every artist ever still working getting guys meet^robert pattinson on movie roles 'people are trying to put you in a box^amber rose i did not laugh at molestation victim^entertainment tonight chatted reese witherspoon monday hollywood premiere new docu series sh^john mayer has been hospitalized emergency appendectomy^sag awards nominations see full list of screen actors guild nominees^american music awards nominations amas nominees full list^chris pratt files divorce from anna faris^sharon osbourne apologizes to justin bieber 'i was wrong to 'attack you^celebrities react nelsan ellis dead at^ed sheeran did not 'break friendship code with taylor swift^kanye west may person family n't beef caitlyn jenner^with respective careers miley cyrus liam hemsworth worthy following social media the^jamie foxx katie holmes finally out public as couple^miranda lambert let music talking the country crooner finally opening split ex hus^celebrities react trump withdraws steph curry white house invitation^celebrity reaction jimmy kimmel monologue on las vegas shooting and guns^beyonce not demanding silent delivery room despite report^beyonce not demanding silent delivery room despite report^are selena gomez amp the weeknd working on a movie together^celebrity reactions donald trump phoenix rally speech^jimmy kimmel talks donald trump harvey weinstein on 'gma^stars celebrate rosh hashanah see celebrity tweets about jewish new year^selena gomez vogue cover story see interview highlights^katie couric said matt lauer pinched her on the ass on 'today back in^kendall jenner jealous ex^celebrities react to hurricane irma^chris brown slammed by judge for skipping karrueche tran court hearing^no drake is n't 'lusting after rihanna despite new rumors^taylor swift wins countersuit against dj david mueller in groping trial^kylie jenner is pregnant with travis scott baby^katie holmes not pregnant and planning wedding with jamie foxx^lady gaga taylor kinney not secretly dating despite late and wrong report^sorry drake amp bella hadid are not 'secretly dating^kim kardashian sued for allegedly stealing lighting technique for selfies^ryan lochte charge dropped in rio robbery case^celebrity reactions prince harry meghan markle engaged^halle berry not pregnant at despite reports^mariah carey amp french montana did not flirt in recording studio^watch kim kardashian first interview since robbery on 'ellen degeneres show videos^nope justin bieber is not dating hailee steinfeld^hailee steinfeld responds to justin bieber dating rumors^justin bieber dating hailee steinfeld photo^robert pattinson amp katy perry are not dating^beyonce birth twins still hospital 'minor issue^beyonce birth twins still hospital 'minor issue^is liam hemsworth mad at miley cyrus for texting nick jonas^justin bieber fan arrested trespassing at singer beverly hills home^kanye west may person family n't beef caitlyn jenner^is demi lovato upset about meghan trainor performing the 'smurfs movie song^mary j. blige hacked did not write kendu isaacs hate tweet^justin bieber did not attend vanity fair oscars after party^are mariah carey amp joe jonas feuding^joe jonas sophie turner 'already thinking of having kids is made up story^flo rida not performing at donald trump inauguration despite report^chris brown urges fans to donate to year old boy 'new legs gofundme^oprah not running for president says gayle king^grammy awards see the full winners list^grammy awards see the full winners list^iggy azalea blasts nick young after accidental dinner reunion^avril lavigne 'mildly amused by death conspiracy^kanye west is not rebooting 'american idol^kim kardashian slams 'invasive surrogacy reports^fans react u2 cancels st. louis concert amid police protests^jimmy fallon felt need to share 'heartfelt message about charlottesville^no zayn is not 'desperate to defend girlfriend gigi hadid^selena gomez reveals she had a kidney transplant amp her friend was her donor^selena gomez reveals she had a kidney transplant amp her friend was her donor^celebrities thank barack obama on last day as president^obamas celebrate th anniversary after false split stories^mariah carey not dating both nick cannon and bryan tanaka despite report^shortly tmz revealed selena gomez entered mental health facility due reported emotional brea^harry styles announces intimate world tour see the dates^million dollar listing fredrik eklund derek welcome twins^khlo kardashian makes her first public appearance since pregnancy news^the bachelor bekah m was on missing persons list until fan recognized her^taylor swift teases new song 'gorgeous on instagram listen to a snippet^heather locklear hospitalized with minor injuries after car crash^bachelor nick viall vanessa grimaldi split end engagement^we feel right ... rough time break yall^hugh hefner cause death has been revealed^hugh hefner cause death revealed^alex rodriguez year old daughter sings for jennifer lopez photos^what elle king skipped her wedding for a rock concert^taylor swift teases new song 'gorgeous on instagram listen to a snippet^justin timberlake announces 'the man of the woods tour see the dates^here the complete list of bet awards winners^here what hocus pocus thackery binx looks like now^star jones ex husband al reynolds comes out as bisexual in candid blog^bachelorette peter kraus reveals he suffered eating disorder^tori kelly is engaged to german basketball player andre murillo^watch harry styles kiss james corden in christmas themed 'carpool karaoke^jennifer lawrence darren aronofsky split^it official david foster katharine mcphee engaged^billboard music awards nominations see full list of bbmas nominees^camila cabello announces her 'never be the same tour see the dates^gigi hadid slams body shamers for calling her 'too skinny at nyfw^are khloe kardashian tristan thompson ready get harry meghan walk aisle that wh^demi lovato announces tour with dj khaled see the dates^chris pratt files divorce from anna faris,71,29,-42,100,0.71,-0.42,1
403670899,ibtimes_india,123,16481,439,141516,0,4,87,7,international business times india edition indian news global news consumer follow-,the us department education withdrawn seven documents imposed discrimination among students.^the us department education withdrawn seven documents imposed discrimination among students.^what amp say florida mass shooting orlando orlandonightclubshooting^us president donald trump lashed journalists press briefing donaldtrump whitehouse^is jennifer aniston furious justin theroux 'divorce interview jenniferaniston justintheroux^is jennifer aniston furious courteney cox justin theroux jenniferaniston courteneycox^is jennifer aniston furious justin theroux 'divorce interview jenniferaniston justintheroux^angelina jolie brad pitt wedding 'maleficant actress denies getting married near future^george clooney amal alamuddin wedding anniversary actor adorable quotes wife slam divorce rumours ...^truth brad pitt amp jennifer aniston 'miracle baby bradpitt jenniferaniston^truth brad pitt amp jennifer aniston 'miracle baby bradpitt jenniferaniston^princessdiana princess diana secret affair john f kennedy jr^angelina jolie headed 'physical meltdown actress 'going without food sleep angelinajolie^angelina jolie headed 'physical meltdown actress 'going without food sleep angelinajolie^a new report claims meghan might pregnant twins meghanmarkle royalfamily^a new report claims meghan markle pregnant twins reportedly revealed sex the^a new report claims meghan might pregnant twins meghanmarkle royalfamily^a new report claims meghan markle pregnant twins reportedly revealed sex b^angelina jolie 'hospital 'wasting away angelinajolie^jennifer aniston vacationing italy brad pitt daughter shiloh jenniferaniston bradpitt^selena gomez billboard woman year confirm relationship^oh boy have angelinajolie bradpitt kids 'gone wild since split^mileycyrus liamhemsworth wedding called due differing personalities report^omg ben affleck secretly got engaged snl producer girlfriend lindsay shookus^according reports justin theroux upset heartbroken jennifer aniston interview justintheroux^justin theroux jealous jennifer aniston relationship hunky gym trainer justintheroux^according reports justin theroux upset heartbroken jennifer aniston interview justintheroux^kendall jenner reveals jealous kylie friends 'spent days crying room'^kendall jenner reveals jealous kylie friends 'spent days crying room'^is really war^jennifer aniston write autobiography amid brad pitt reunion rumours jenniferaniston bradpitt^jennifer aniston write autobiography amid brad pitt reunion rumours jenniferaniston bradpitt^selena gomez quits social media yet avoiding justin hailey marriage updates selenagomez justinbieber^angelina jolie brad pitt fighting children custody holiday season^jennifer lawrence secretly dating red sparrow co star joel edgerton jenniferlawrence joeledgerton^has isis hacked meghan markle intimate photos arm twist royals england isis meghanmarkle^has isis hacked meghan markle intimate photos arm twist royals england isis meghanmarkle^ben affleck falls bike batman actor could suffer long term 'brain damage benaffleck^is angelina jolie poiling six kids win custody battle brad pitt angelinajolie bradpitt^is angelina jolie poiling six kids win custody battle brad pitt angelinajolie bradpitt^justin bieber 'is selena gomez despite marrying hailey baldwin justinbieber selenagomez^justin bieber 'is selena gomez despite marrying hailey baldwin justinbieber selenagomez^a 'jealous angelinajolie looking dirt bradpitt^angelina jolie reportedly misses brad pitt thinks one true love life angelinajolie bradpitt^angelina jolie 'misses talking brad pitt here truth angelinajolie bradpitt^angelina jolie reportedly misses brad pitt thinks one true love life angelinajolie bradpitt^angelina jolie 'misses talking brad pitt here truth angelinajolie bradpitt^a claim made headlines suggesting tomcruise began flirting extra presenter renee bargh.^a claim made headlines suggesting tomcruise began flirting extra presenter renee bargh.^brad pitt snubs angelinajolie invite spend halloween children bradpitt^omg is all apologies split the^katie holmes jamie foxx not dating actress rep trashes relationship rumours^is jennifer aniston showing new revenge body impress boyfriend brad pitt jenniferaniston^is jennifer aniston showing new revenge body impress boyfriend brad pitt jenniferaniston^top gun cast tom cruise 'begging actress star sequel husband opposes topgun2^kendall jenner dangerous diet model thin frame shocks people close her^emma stone opened special bond ryan gosling ryangosling emmastone^emma stone opened special bond ryan gosling ryangosling emmastone^what bradpitt angelinajolie relationship '12 years hell^hollywood princeharry moving hollywood live couple get engaged months^is angelina jolie poiling six kids win custody battle brad pitt angelinajolie bradpitt^is brad pitt dating jennifer garner amid divorce battle angelina jolie bradpitt jennifergarner^angelina jolie brad pitt custody battle getting controversial every passing day jenniferaniston^is angelina jolie poiling six kids win custody battle brad pitt angelinajolie bradpitt^angelina jolie brad pitt custody battle getting controversial every passing day jenniferaniston^it claimed angelina plans use diary win custody battle angelinajolie bradpitt^it claimed angelina plans use diary win custody battle angelinajolie bradpitt^is angelina jolie poiling six kids win custody battle brad pitt angelinajolie bradpitt^is angelina jolie poiling six kids win custody battle brad pitt angelinajolie bradpitt^angelina jolie dating new man left kids 'disappointed angelinajolie hollywood^angelina jolie dating new man left kids 'disappointed angelinajolie hollywood^justin theroux opens divorce jennifer aniston calls 'heartbreaking justintheroux jenniferaniston^is jennifer aniston furious justin theroux 'divorce interview jenniferaniston justintheroux^actor justin theroux recently opened divorce jennifer aniston jenniferaniston justintheroux^actor justin theroux recently opened divorce jennifer aniston jenniferaniston justintheroux^is jennifer aniston furious justin theroux 'divorce interview jenniferaniston justintheroux^according reports justin theroux upset heartbroken jennifer aniston interview justintheroux^justin theroux jealous jennifer aniston relationship hunky gym trainer justintheroux^according reports justin theroux upset heartbroken jennifer aniston interview justintheroux^margot robbie marriage crumbling due busy career margotrobbie^margot robbie marriage crumbling due busy career margotrobbie^jennifer aniston still talks justin theroux here truth jenniferaniston justintheroux^jennifer aniston still talks justin theroux here truth jenniferaniston justintheroux^truth behind jennifer aniston amp justin theroux 'uncomfortable reunion jenniferaniston justintheroux^truth behind jennifer aniston amp justin theroux 'uncomfortable reunion jenniferaniston justintheroux^brad pitt estranged wife angelinajolie headed erious breakdown bradpitt^is jennifer aniston showing new revenge body impress boyfriend brad pitt jenniferaniston^is jennifer aniston showing new revenge body impress boyfriend brad pitt jenniferaniston^was ecret miscarriage one reasons jenniferaniston justintheroux grew apart^the weeknd intentions reach selena gomez emotional meltdown selenagomez^the weeknd intentions reach selena gomez emotional meltdown selenagomez^selena gomez billboard woman year confirm relationship^harry potter star matthew lewis marries girlfriend angela jones italy photos matthewlewis angelajones^check complete list winners billboard music awards billboardmusicawards2018^check complete list winners form billboard music awards billboardmusicawards2018^check complete list winners billboard music awards billboardmusicawards2018^check complete list winners form billboard music awards billboardmusicawards2018^a complete winners list oscars oscars90 oscars2018 academyawards2018,87,11,-76,98,0.8877551020408163,-0.7755102040816326,1
3226282347,thisisinsider,618,389233,2947,137948,0,1,55,38,our mission inform inspire find us facebook instagram youtube follow top stories day,you 'll definitely make statement one costumes^jennifer aniston justin theroux separating two years marriage say 'll remain friends^snl star wants people stop offended let comedians jobs^kaley cuoco shared inside look wedding karl cook beautiful^kate middleton birth exclusive hospital wing probably cost lot less giving birth us^meghan markle wore 675 heels kate middleton left hospital royal baby th^kate middleton left hospital mere hours giving birth shocking may think^kate middleton stylist come hospital birth royal baby looking like princes^prince harry opened asking prince charles walk meghan markle aisle royal wedding amid d^a look inside unique relationship oprah winfrey stedman graham partner years^george clooney injured motorcycle accident sardinia^matt lauer reportedly told fans 'll 'be back tv nearly year fired 'today show se^people think tennis player looks exactly like liam hemsworth 're losing^fergie josh duhamel reportedly split views kids talk couples need have^trump made one biggest royal faux pas visiting queen people outraged^kylie jenner travis scott became parents months meeting complete timeline rel^reports suggest miley cyrus liam hemsworth called wedding apparently of^john krasinski flew miles every weekend see emily blunt kids filming montreal^hailey baldwin professed support justin bieber selena gomez relationship back 'i 'm sure^kevin hart wife eniko parrish welcome new baby boy 'god truly amazing^people freaking news kylie jenner reportedly pregnant travis scott baby^hailey baldwin replaced engagement ring new band people think already married justin^denies reports already married^jennifer lopez may dropped hint wants boyfriend alex rodriguez propose new song el anill^katy perry took jab taylor swift americanidol swift probably n't care feud^kylie jenner travis scott became parents months meeting complete timeline rel^prince harry meghan markle could visit united states sooner eected^meghan markle nephew says developing special cannabis strain royal wedding calls 'markle'^here workout gives 'revenge body^couples met 'dancing stars^all details know far meghan markle prince harry fairy tale wedding^three days go here details need know meghan markle prince harry fairy tale weddi^all details need know meghan markle prince harry fairy tale wedding royalwedding^twelve days go here details need know meghan markle prince harry fairy tale^all details need know meghan markle prince harry fairy tale wedding^t days all details need know meghan markle prince harry fairy tale wedding^all details need know meghan markle prince harry fairy tale wedding including offici^every detail need know prince harry meghan markle fairy tale wedding^all details need know meghan markle prince harry fairy tale wedding^all details need know meghan markle prince harry fairy tale wedding^all details need know meghan markle prince harry fairy tale wedding^blac chyna says entire kardashian family trying ruin suing 'millions dollars'^angelina jolie dumped superstar divorce lawyer middle custody battle brad pitt^brad pitt lawyers say angelina jolie trying turn media custody battle^here need know angelina jolie brad pitt ugly divorce custody battle^everything need know angelina jolie brad pitt year relationship current divorce battle^ryan seacrest texted kris jenner ask kylie reported pregnancy live tv reply super crypti^priyanka chopra basically recreated meghan markle prince harry engagement photo 'll ma^reacts kuwtk episode tristan thompson reported cheating 'you may forgive for^jennifer lawrence says still terrified getting 'blindsided nude photos stolen^prince harry opened asking prince charles walk meghan markle aisle royal wedding amid d^nick jonas priyanka chopra confirmed engagement complete timeline whirlwind relations^pete davidson confirmed engagement complete timeline confusing relati^kylie jenner travis scott became parents months meeting complete timeline rel^katy perry took jab taylor swift americanidol swift probably n't care feud^target selling britney spears shirts men 're flying shelves^musicians pay tribute rock legend tom petty dead^will smith jada pinkett smith n't call married^ed sheeran got engaged cherry seaborn girlfriend years^showed fans makeup everyday takes less minutes^photos show kate middleton style evolved years^photos show kate middleton style evolved years^photos show kate middleton style evolved years^photos show kate middleton style evolved years^photos show kate middleton style evolved years^photos show kate middleton style evolved years^photos show kate middleton style evolved years^photos show kate middleton style evolved years^photos show katemiddleton style evolved years^everything know strangerthings season far things^here lorde wo n't performing grammys even though nominated album year^carrie underwood 'may may cried getting pulled speeding honestly relate^meghan markle father officially longer attending royal wedding eected walk down^prince harry opened asking prince charles walk meghan markle aisle royal wedding amid d^mindy kaling reportedly pregnant first child^releasing vampire frappuccinos halloween^blac chyna granted temporary restraining order rob kardashian^kim kardashian shares first unfiltered photo chicago west everyone saying mini me^dj producer avicii warned 'i 'm going die documentary released months found dead^supermodel karlie kloss engaged joshua kushner ring huge^engaged joshua kushner everything know millionaire power couple^year old 'full house star john stamos eecting first child new fianc e caitlin mchugh^reportedly engaged fans handle news^gameofthrones stars kit harington rose leslie officially married see best photos stunning^enrique iglesias anna kournikova share first photos newborn twins fans obsessed^enrique iglesias anna kournikova share first photos newborn twins fans obsessed^princess michael kent apologizes wearing 'racist brooch meet meghan markle^reasonswhy season returns netflix may everything know fans eect^everything know far season reasonswhy^where are they now the cast 'that '70s show^gwyneth paltrow denies amber rose claim 'becky good hair^reasonswhy renewed season here tv shows coming back another season^rihanna says 'uncomfortable drake said loved mtv vmas 're longer friends 'i^says 'uncomfortable said loved mtv vmas 're longer friends,55,39,-16,94,0.5851063829787234,-0.1702127659574468,1
94576407,hot1079syracuse,504,6416,177,180329,0,0,61,33,all the hits for syracuse home millz an station,robert pattinson on movie roles 'people are trying to put you in a box^teen choice awards nominations first wave of nominees full list^john mayer has been hospitalized emergency appendectomy^sag awards nominations see full list of screen actors guild nominees^karrueche tran granted five year restraining order against chris brown^american music awards nominations amas nominees full list^chris pratt files divorce from anna faris^sharon osbourne apologizes to justin bieber 'i was wrong to 'attack you^celebrities react nelsan ellis dead at^ed sheeran did not 'break friendship code with taylor swift^jamie foxx katie holmes finally out public as couple^celebrities react trump withdraws steph curry white house invitation^celebrity reaction jimmy kimmel monologue on las vegas shooting and guns^beyonce not demanding silent delivery room despite report^jimmy kimmel talks donald trump harvey weinstein on 'gma^brad pitt gq divorce interview highlights on angelina jolie kids and drinking^selena gomez vogue cover story see interview highlights^katie couric said matt lauer pinched her on the ass on 'today back in^jennifer garner ben affleck file for divorce amid false reconciliation rumor^kendall jenner jealous ex^celebrities react to hurricane irma^chris soules had no alcohol in system after crash negative for drugs^no drake is n't 'lusting after rihanna despite new rumors^taylor swift wins countersuit against dj david mueller in groping trial^katie holmes not pregnant and planning wedding with jamie foxx^sorry drake amp bella hadid are not 'secretly dating^kim kardashian sued for allegedly stealing lighting technique for selfies^kristen stewart on dating robert pattinson 'the public were the enemy^ryan lochte charge dropped in rio robbery case^kim kardashian slams cocaine claim 'i do not play with rumors like this^celebrity reactions prince harry meghan markle engaged^halle berry not pregnant at despite reports^mariah carey amp french montana did not flirt in recording studio^watch kim kardashian first interview since robbery on 'ellen degeneres show videos^hailee steinfeld responds to justin bieber dating rumors^robert pattinson amp katy perry are not dating^beyonce birth twins still hospital 'minor issue^beyonce birth twins still hospital 'minor issue^karrueche tran granted five year restraining order against chris brown^justin bieber fan arrested trespassing at singer beverly hills home^tony awards nominations see full tonys nominees list^chloe grace moretz apologizes for 'red shoes marketing^celebrities remember orlando pulse nightclub shooting victims one year later^is demi lovato upset about meghan trainor performing the 'smurfs movie song^meghan markle twins with kate middleton during outing with queen^kim kardashian reportedly getting ready divorce kanye west^justin bieber did not attend vanity fair oscars after party^are mariah carey amp joe jonas feuding^chris brown urges fans to donate to year old boy 'new legs gofundme^iggy azalea blasts nick young after accidental dinner reunion^kanye west is not rebooting 'american idol^fans react u2 cancels st. louis concert amid police protests^jimmy fallon felt need to share 'heartfelt message about charlottesville^no zayn is not 'desperate to defend girlfriend gigi hadid^selena gomez reveals she had a kidney transplant amp her friend was her donor^selena gomez reveals she had a kidney transplant amp her friend was her donor^robert pattinson amp charlie hunnam talk 'lost city of z on 'gma video^chris soules 'devastated after killing kenny mosher in fatal accident^mariah carey not dating both nick cannon and bryan tanaka despite report^mariah carey not dating both nick cannon and bryan tanaka despite report^michael strahan 'looking forward to working with alex rodriguez at abc^here how help victims las vegas mass shooting^'dance moms abby lee miller sentenced to one year in prison^ed sheeran is engaged longtime girlfriend cherry seaborn^million dollar listing fredrik eklund derek welcome twins^khlo kardashian makes her first public appearance since pregnancy news^taylor swift teases new song 'gorgeous on instagram listen to a snippet^'stranger things kids get big pay raise season^bachelor nick viall vanessa grimaldi split end engagement^rachel mcadams is reportedly pregnant with her first child^rachel mcadams is reportedly pregnant with her first child^'happy days star erin moran dead at^hugh hefner cause death revealed^hugh hefner cause death has been revealed^alex rodriguez year old daughter sings for jennifer lopez photos^taylor swift teases new song 'gorgeous on instagram listen to a snippet^jenny slate and chris evans break up again^justin timberlake announces 'the man of the woods tour see the dates^here what hocus pocus thackery binx looks like now^kim kardashian shares first photo baby chicago west^freeform nights of halloween schedule is here^bachelorette peter kraus reveals he suffered eating disorder^tori kelly is engaged to german basketball player andre murillo^watch harry styles kiss james corden in christmas themed 'carpool karaoke^'storm chasers star joel taylor dead at^jennifer lawrence darren aronofsky split^billboard music awards nominations see full list of bbmas nominees^billboard music awards nominations see full list of bbmas nominees^camila cabello announces her 'never be the same tour see the dates^gigi hadid slams body shamers for calling her 'too skinny at nyfw^'black panther is officially the most tweeted about movie of all time^meryl streep joins big little lies season^zayn malik reveals just how much he talks one direction today^chris pratt files divorce from anna faris,61,33,-28,94,0.6489361702127661,-0.2978723404255319,1
128626186,cambio,16249,177120,3138,60883,0,0,14,79,where find fashion beauty inspiration tech and taylor swift cambio tweets snapchat cambiosnap,britney spears terrified fan rushes onstage vegas show^the one thing that is reportedly keeping selena gomez from moving from justin bieber^'us weekly cover ivanka trump sparks disagree dad meme^think harry styles jealous sees video^jennifer garner denounces people magazine cover story divorce^why kourtney kardashian jealous kim watch new keepingupwiththekardashians clip find^kylie jenner says she misses her gray hair^see kylie jenner biggest fashion hits misses^kylie jenner says she misses her gray hair^see kylie jenner biggest fashion hits misses^see kylie jenner biggest fashion hits misses^did demi lovato wilmer valderrama get engaged^did demi lovato wilmer valderrama get engaged^kourtney kardashian scott disick never getting back together like ever^sacrebleu beyonc turned role beauty beast^styles announces world tour dates^dance moms star abby lee miller sentenced one year prison fraud^justin hartley this is us marries soap star chrishell stause^meet new faces joining cast reasons why season^teen mom maci bookout admits fears ex ryan could die drug overdose^'glee star charice pempengco changes name jake zyrus revealing 'my soul male^ariana grande breaks silence following deadly manchester arena elosion^blake lively injured set the rhythm section halting production^inside harry styles relationship tess ward 'they 're great match^youtube star austin jones arrested child pornography charges^robert pattinson says nearly fired 'twilight^rob kardashian daughter dream says hi dad sweet video^zac efron zendaya trapeze body slam fail make lol^liam payne sure wants marry cheryl cole^vanessa hudgens joins so you think you can dance judge^julianne hough brooks laich wedding straight magazine here pictures prove it^kylie jenner sparks engagement rumors giant diamond ring^inside colton haynes jeff leatham star studded wedding^francia raisa bares scars selena gomez kidney transplant gym^jay z family feud video teaser shows beyonc confessional box^twitter going crazy regina george look alike^demi lovato gives us serious princess protection program vibes ellen^'fuller house season trailer many spoilers a proposal pregnancy trip tokyo^watch zendaya cringe critiques old youtube videos^watch zendaya cringe critiques old youtube videos^sonny with a chance star brandon mychal smith arrested dui charge^we ca n't stop watching rare video selena quintanilla singing bidi bidi bom bom english^harry styles groped onstage fans condemn sexual assault^harry styles 8.5 million hollywood hills bachelor pad sale^selena gomez releases sexy new music video fetish^kendall jenner weighs caitlyn dissing kardashians memoir you raised^francia raisa mother elains daughter selena gomez recovered kidney transplant^why selena gomez likes taylor swift boyfriend joe alwyn^christina aguilera promises new album coming response fan clever message^haylie duff pregnant baby no^liam payne rita ora hint fifty shades freed collaboration^jonas brothers continue fueling reunion rumors new photo^teen mom catelynn lowell heading home treatment suicidal thoughts^nick jonas dating georgia fowler serious^selena gomez releases new single music video ''bad liar ''^sophia grace grown music^pretty little liars boss i. marlene king answers lingering finale questions^rob kardashian reveals new side blac chyna heartfelt throwback photos^rob amp big star christopher big black boykin dead^selena gomez releases epic 'bad liar music video^hilary duff packs pda beach ely sandvik^justin bieber mom defends light disapproval selena gomez mother^one direction fans gush new rare photo louis tomlinson briana jungwirth son freddie^millie bobby brown jacob sartorius fuel dating rumors cute selfie^beyhive rips taylor swift music video director saying beyonc copied bad blood^camila cabello says ariana grande shaken manchester bombing^disney star orlando brown arrested following family dispute^caitlyn jenner spends father day kendall kylie months tension^jennifer hudson set join the voice coach season^karlie kloss edits katy perry inspired caption apparent jab taylor swift^wilmer valderrama attends ex girlfriend demi lovato th birthday party^selena gomez wears justin bieber jersey attending hockey game^riverdale k.j apa opens car crash hour work day^let photos liam hemsworth short shorts start day right^fergie josh duhamel split years marriage^why taylor swift got two grammy nominations^jamie lynn spears pregnant second child^zac efron jokes flirting madonna i guess could say tapped^the internet convinced miranda lambert lyric change blake shelton^zayn malik plea donate family friend cancer brings twitter trolls^ariana grande manchester benefit concert air abc freeform^meryl streep joins hbo big little lies season^she back 'pretty little liars sneak peek brings old foe back mix^selena gomez sizzles satin lace date night the weeknd^khloe kardashian kylie jenner joke many babies^shia labeouf arrested disorderly conduct public drunkenness^'revenge co stars emily vancamp josh bowman engaged^pretty little liars getting spinoff starring sasha pieterse janel parrish^demi lovato announces tour dates dj khaled^zayn malik reveals backup plan never became famous singer^robert pattinson toys 'twilight fans emotions possible reboot^jonah hill bulging biceps serve major fitness motivation^things need know taylor swift new boyfriend joe alwyn,14,79,65,93,0.15053763440860216,0.6989247311827957,0
17852343,YahooEnt,1391,640383,4628,69562,0,0,41,50,be know pop culture celeb stories live without,robert pattinson fka twigs split might get back together 'that girl wants marry'^the unhealthy habit contributed jennifer lawrence darren aronofsky split^australian media outlets happy vanity fair cover story^photo proof liam hemsworth miley cyrus broken^photo proof liam hemsworth miley cyrus broken^offers kim cattrall role 'sex city cohen satc3^hannibal buress arrested disorderly intoxication miami^fergie josh duhamel split 'this long time coming says source^kim kardashian embarrassed sisters fashion sense^george clooney reveals hilarious way halloween changed twins^rising british star josh o connor play prince charles marion bailey play elizabeth the crown.^already married hailey baldwin wears diamond band instead engagement ring justin bieber^hailey baldwin praises 'incredible hubby bieber new interview amid report 'not ex selena gomez^are keith urban nicole kidman not according photos^michael strahan co host rd hour 'good morning america with sara haines^michael strahan co host rd hour 'good morning america sara haines^nicole kidman bravely captures massive tarantula horrified children look 'get back mom^justin theroux steps year old model erika cardenas^the weeknd bares broken heart new album post selena gomez split want bella back^caitlyn jenner hits charity event austria instead son brody wedding^jenniferaniston gets delicious revenge pint sized cinnamon roll thief officexmasparty clip^brigitte nielsen pregnant fifth child see baby bump^parading patriots jennifer garner kids ride atop truck fourth july parade^brad pitt rumored love interest neri oxman addresses romance reports first time^not everyone thrilled taylor swift got political instagram 'be quiet sing^michael strahan co host rd hour 'good morning america with sara haines^michael strahan co host rd hour 'good morning america sara haines^new dad travis scott pleads guilty disorderly conduct riot debacle^julia roberts shares sweet hug husband danny moder bid farewell summer^khlo kardashian shows 'revenge body amid rough patch tristan thompson^teri hatcher denies 'broke homeless living van 'it totally absurd'^meghan markle moving london is royal engagement prince harry next^teri hatcher denies 'broke homeless living van 'it totally absurd'^kevin hart relives cheating scandal playing j. cole music video^lindsaylohan wears hijab sparking mixed feelings social media via^selena gomez reveals big secret she kidney transplant summer^gwyneth paltrow angelina jolie others say harvey weinstein harassed^australian actor damon herriman type cast charles manson^sandra bullock married boyfriend bryan randall rep says^selena gomez leaves treatment center 'emotional breakdown^selena gomez leaves treatment center 'emotional breakdown^bill paxton family files wrongful death lawsuit hospital^jason mraz opens 'two spirit sexuality 'i 've eeriences men^drew barrymore spray painted ex boyfriend car '90s^courtney love warned women harvey weinstein^luann de lesseps accuses russell simmons groping elevator 'he pig^kelly clarkson 'when i really skinny i wanted kill^fka twigs reveals 'huge fibroid tumors removed uterus 'i felt really alone'^engaged zandy reich see gorgeous ring^robertpattinson tells nearly got fired twilight i determined make serious^thehandmaidstale star yvonne strahovski pregnant first child^helped formerly homeless pregnant fan buy house baby gear via^'2 broke girls star beth behrs marries 'mad men alum michael gladis^'2 broke girls star beth behrs marries 'mad men alum michael gladis^josh brolin addresses diane lane domestic abuse arrest 'there elaining^mattdamon apologizes sexual misconduct comments i really wish listened^jonah hill brother jordan feldstein cause death released^gigi hadid zayn malik break timeline romance^haylie duff pregnant baby no^jesse camp star mtv wan na be vj reported missing police^goldenglobes live streamed first time^simon cowell rushed hospital cary accident london home friday^rushed hospital scary accident london home^blac chyna assistant dies taken life support report^outlander renewed seasons plus see first season photos^host american music awards amas^kaley cuoco hits gym 'badass one armed workout two weeks shoulder surgery^makes kanye west snapchat kourtney birthday party watch^kendra wilkinson files divorce hank baskett look back ups downs^daytime emmy awards complete winners list days of our lives the talk gma among honorees^aaronpaul wife lauren welcome first child^joel taylor star of discovery channel 'storm chasers dead at^jennifer lawrence darren aronofsky split year dating^the unhealthy habit contributed jennifer lawrence darren aronofsky split^fullerhouse renewed season^brooke burke files divorce david charvet years marriage^kaley cuoco engaged boyfriend karl cook watch emotional reaction proposal^surprise petedavidson engaged dating weeks^jayz announce on run ii stadium tour dates^announces year las vegas residency lasvegasgoesgaga^'buffy vampire slayer star nicholas brendon arrested alleged domestic violence girlfriend^how watch grammys online^shakira postpones el dorado world tour opening dates 'continue vocal rest^will smith addresses jada pinkett divorce rumors new song ahead world cup performance^katie couric said matt lauer 'pinches ass lot^channing tatum spotted without wedding ring first time since jenna dewan split^shiloh child star blake heron cause death revealed^michael jackson musical coming broadway^mama june daughter lauryn 'pumpkin shannon gets married las vegas^kaleycuoco karl cook celebrate engagement disneyland^kaley cuoco says ex husband ryan sweeting 'ruined word marriage,41,50,9,91,0.4505494505494506,0.0989010989010989,0
9695312,billboard,3170,7686362,25213,229726,3,1,39,48,music charts news,miley cyrus donald trump f king nightmare^miley cyrus donald trump f king nightmare^music modernization act unanimously passes us house representatives^hillary clinton donald trump tweeted mass shooting orlando nightclub pulse^leslie jones urges critics stop unearthing comedians old tweets it dumb^john mayer hospitalized emergency appendectomy^a timeline harry styles amp james corden latelateshow bromance^a timeline harry styles amp james corden latelateshow bromance^watch liam hemsworth pull epic prank miley cyrus^watch liam hemsworth pull epic prank miley cyrus^superbowl halftime show set list here wish list monster hits^amp the make list best superbowl halftime shows^as get ready watch rule sb47 take look list best superbowl halftime shows ever^lady gaga talks play super bowl halftime show sources say top list^as get beer wings ready sb47 take look list best superbowl halftime shows ever^kanye west smiles battles kardashians family feud^kanye west amp kim kardashian share family christmas card^selena gomez amp justin bieber timeline relationship^popshop podcast fun facts launched october over episodes hosted several celebrity gue^ariana grande returns u.k. first show since one love manchester^the weeknd almost released upbeat album split selena gomez^lady gaga talks bradley cooper dynamic filming a star is born he accepted actress and^katy perry responds americanidol contestant love taylor swift^country musicians react mel tillis death^travis scott pleads guilty disorderly conduct^fan sues gwen stefani amp live nation stampede left broken leg^lalaland songwriters emma stone cool quirky singing style amp new broadway show^lalaland songwriters emma stone cool quirky singing style new broadway show^beyonce shawn mendes amp stars tweet support earthquake victims mexico city^breaks silence rootsy new music fiance liam hemsworth amp america unity need^breaks silence rootsy new music fiance liam hemsworth amp america unity need^breaks silence rootsy new music fiance liam hemsworth amp america unity need^jennifer lawrence terrified mother trailer^amp travis scott a timeline relationship^amp a timeline relationship^selena gomez amp justin bieber timeline relationship^kylie jenner amp travis scott a timeline relationship^a timeline kylie jenner amp travis scott relationship^good charlotte benji joel madden compare favorite family traditions amp underrated songs^katy perry responds americanidol contestant love taylor swift^ed sheeran reveals love yourself originally written new album divide^ed sheeran reveals love yourself originally written new album divide^ed sheeran reveals love yourself originally written new album divide^here help victims las vegas mass shooting^koko gorilla knew sign language dies^marries evans mexico^harry styles announces dates intimate world tour^harry styles announces dates intimate world tour^harry styles announces dates intimate world tour^beyonce surprises colin kaepernick present sports illustrated muhammad ali legacy award^katy perry reveals new album title witness announces fall tour dates^katy perry reveals new album title witness announces fall tour dates^lin manuel miranda grandmother dies christmas day my heart pieces^american idol renewed second season abc^third suspect arrested connection xxxtentacion murder^tamar braxton files divorce vincent herbert^iconic brady bunch house sale nearly 1.9 million^nelly criminal investigation sexual assault report^amanda seyfried sings hilarious google translated mamma mia songs tonight show^the complete list brit awards winners^mac miller opens ariana grande breakup recent engagement billboardnews^selena gomez jokes fixed tan met gala^honored first ever latin ama dick clark achievement award^honored first ever latin ama dick clark achievement award^sam smith announces the thrill all album release date north american tour^sam smith announces the thrill all album release date north american tour^ashley judd sues harvey weinstein sexual harassment defamation^american horror story season title revealed^justin timberlake announces man woods north american tour dates who coppin tickets^announces new album man woods reveals release date^paris jackson cleans graffiti dad michael jackson star hollywood walk fame^mtv video music awards returning l.a.^things know michelle williams husband phil elverum^jennifer hudson joins the voice coach season plus miley cyrus returns^camila cabello lindsay lohan taylor swift biggest fans iheartradio jingle ball nyc^taylor swift stalker sentenced years probation^lady gaga announces launch date las vegas enigma residency^billboard latin music awards complete winners list billboards2014^icymi here complete list winners last night billboard latin music award billboards2018^see complete list billboard latin music award winners billboards2014^jamie lynn spears pregnant second child^rent set fox next live musical^rent set fox next live musical^rent set fox next live musical^david foster engaged^drag race all stars finale season crowns winner amp delivers new queer classic video recap^reese witherspoon confirms legally blonde happening it true^prince william prince harry best man royal wedding^madonna lot live tonight relive best superbowl halftime shows ever can better^as get ready watch rule sb47 take look list best superbowl halftime shows ever^as get beer wings ready sb47 take look list best superbowl halftime shows ever,42,49,7,91,0.4615384615384616,0.07692307692307693,0
124219349,TandCmag,915,352749,1000,61835,0,4,49,37,town country authority meaning modern society amusing guide exceptional people exclusive places,tonight first time moderating presidential debate holt registered republican debatenight^the most popular baby names every state^the most popular baby names every state^the most popular unique baby names every state^from duchess cambridge look royal attendees take look prince louis christening compar^how kate middleton first appearance with royal baby no compares george charlotte debuts^rachel weisz daniel craig have most interesting love story^the crown season coming and princess diana introduced^the crown season coming and princess diana introduced^the crown season coming and princess diana introduced^the crown season coming and princess diana introduced^the crown season coming and princess diana introduced^the crown season coming and princess diana introduced^the crown season coming and princess diana introduced^the crown season coming and princess diana introduced^the crown season coming and princess diana introduced^the crown season coming and princess diana introduced^the crown season coming and princess diana introduced^the crown season coming and princess diana introduced^from princess diana brother crown prince yugoslavia queen many godchildren^the crown season coming and princess diana introduced^the crown season coming and princess diana introduced^the crown season coming and princess diana introduced^catherine duchess cambridge parents earned millions party planning business get scoop on^prince william catherine duchess cambridge come long way since days st. andrews university^prince william catherine duchess cambridge come long way since days st. andrews university^prince william catherine duchess cambridge come long way since days st. andrews university^prince william catherine duchess cambridge come long way since days st. andrews university^catherine duchess cambridge parents earned millions party planning business get scoop on^prince william catherine duchess cambridge come long way since days st. andrews university^prince william catherine duchess cambridge come long way since days st. andrews university^prince william catherine duchess cambridge come long way since days st. andrews university^prince william catherine duchess cambridge come long way since days st. andrews university^catherine duchess cambridge parents earned millions party planning business get scoop on^princess eugenie marry jack brooksbank fall windsor castle venue prince harry meghan mar^princess eugenie marry jack brooksbank fall windsor castle venue prince harry meghan mar^princess eugenie marry jack brooksbank fall windsor castle venue prince harry meghan mar^princess eugenie marry jack brooksbank fall windsor castle venue prince harry meghan mar^princess eugenie marry jack brooksbank fall windsor castle venue prince harry meghan mar^prince william catherine duchess cambridge come long way since days st. andrews university^prince william catherine duchess cambridge come long way since days st. andrews university^prince william catherine duchess cambridge come long way since days st. andrews university^prince william catherine duchess cambridge come long way since days st. andrews university^prince william catherine duchess cambridge come long way since days st. andrews university^prince william catherine duchess cambridge come long way since days st. andrews university^prince william catherine duchess cambridge come long way since days st. andrews university^prince william catherine duchess cambridge come long way since days st. andrews university^prince william catherine duchess cambridge come long way since days st. andrews university^prince william catherine duchess cambridge come long way since days st. andrews university^prince william catherine duchess cambridge come long way since days st. andrews university^prince william catherine duchess cambridge come long way since days st. andrews university^prince william catherine duchess cambridge come long way since days st. andrews university^prince william catherine duchess cambridge come long way since days st. andrews university^prince harry calls princess diana his ideal role model first obama foundation summit^prince harry calls princess diana his ideal role model first obama foundation summit^the royal family christmas cards through years^outlander star is engaged see her gorgeous ring here outlander starz^outlander star is engaged starz^outlander star is engaged see her gorgeous ring here outlander starz^things know about pippa middleton fianc james matthews^things know about pippa middleton fianc james matthews^things know about pippa middleton fianc james matthews^marvelous mrs. maisel actress rachel brosnahan pays tribute her aunt kate spade^why meghan markle will not have maid honor royal wedding^why meghan markle will not have maid honor royal wedding royalwedding harryandmeghan^everything you need know about pippa middleton wedding dress designer^everything you need know about pippa middleton wedding dress designer pippaswedding^cbs news pbs fire charlie rose following sexual harassment allegations^kermit frog is getting new voice after years^mindy kaling is reportedly pregnant her first child^meghan markle confirms her father thomas markle sr. will not attend royal wedding^outlander renewed seasons^everything we know so far about pippa middleton wedding^everything we know so far about pippa middleton wedding^did we just learn actress who 'll play princess diana feud season^prince william reveals how he earned street cred with prince george^princess eugenie marry jack brooksbank fall windsor castle venue prince harry meghan mar^princess eugenie marry jack brooksbank fall windsor castle venue prince harry meghan mar^princess eugenie marry jack brooksbank fall windsor castle venue prince harry meghan mar^princess eugenie marry jack brooksbank fall windsor castle venue prince harry meghan mar^princess eugenie marry jack brooksbank fall windsor castle venue prince harry meghan mar^princess eugenie marry jack brooksbank fall windsor castle venue prince harry meghan mar^princess eugenie marry jack brooksbank fall windsor castle venue prince harry meghan mar^princess eugenie marry jack brooksbank fall windsor castle venue prince harry meghan mar^princess eugenie marry jack brooksbank fall windsor castle venue prince harry meghan mar^meghan best friend jessica mulroney pippa middleton royal wedding^the best labor day sales furnish your entire home^meryl streep joins cast big little lies season biglittlelies merylstreep^meryl streep joins cast big little lies season^meryl streep joins cast big little lies season biglittlelies merylstreep,49,41,-8,90,0.5444444444444444,-0.08888888888888889,1
24403379,WiLD955,104,8939,205,63424,0,0,65,25,the palm beaches hit music station listen live,robert pattinson on movie roles 'people are trying to put you in a box^teen choice awards nominations first wave of nominees full list^john mayer has been hospitalized emergency appendectomy^sag awards nominations see full list of screen actors guild nominees^karrueche tran granted five year restraining order against chris brown^what would life like apparently includes lonely life road amp tons shows^american music awards nominations amas nominees full list^chris pratt files divorce from anna faris^sharon osbourne apologizes to justin bieber 'i was wrong to 'attack you^celebrities react nelsan ellis dead at^jamie foxx katie holmes finally out public as couple^celebrities react trump withdraws steph curry white house invitation^celebrity reaction jimmy kimmel monologue on las vegas shooting and guns^beyonce not demanding silent delivery room despite report^celebrity reactions donald trump phoenix rally speech^jimmy kimmel talks donald trump harvey weinstein on 'gma^stars celebrate rosh hashanah see celebrity tweets about jewish new year^brad pitt gq divorce interview highlights on angelina jolie kids and drinking^katie couric said matt lauer pinched her on the ass on 'today back in^jennifer garner ben affleck file for divorce amid false reconciliation rumor^kendall jenner jealous ex^celebrities react to hurricane irma^chris brown slammed by judge for skipping karrueche tran court hearing^chris soules had no alcohol in system after crash negative for drugs^no drake is n't 'lusting after rihanna despite new rumors^taylor swift wins countersuit against dj david mueller in groping trial^kylie jenner is pregnant with travis scott baby^katie holmes not pregnant and planning wedding with jamie foxx^sorry drake amp bella hadid are not 'secretly dating^kim kardashian sued for allegedly stealing lighting technique for selfies^kristen stewart on dating robert pattinson 'the public were the enemy^ryan lochte charge dropped in rio robbery case^not attending paris fashion week contrary claims^kim kardashian slams cocaine claim 'i do not play with rumors like this^celebrity reactions prince harry meghan markle engaged^halle berry not pregnant at despite reports^mariah carey amp french montana did not flirt in recording studio^watch kim kardashian first interview since robbery on 'ellen degeneres show videos^watch kim kardashian first interview since robbery on 'ellen degeneres show videos^hailee steinfeld responds to justin bieber dating rumors^justin bieber dating hailee steinfeld^justin bieber dating hailee steinfeld photo^robert pattinson amp katy perry are not dating^beyonce birth twins still hospital 'minor issue^karrueche tran granted five year restraining order against chris brown^justin bieber fan arrested trespassing at singer beverly hills home^tony awards nominations see full tonys nominees list^chloe grace moretz apologizes for 'red shoes marketing^celebrities remember orlando pulse nightclub shooting victims one year later^is demi lovato upset about meghan trainor performing the 'smurfs movie song^did get engaged^joe jonas sophie turner 'already thinking of having kids is made up story^chris brown urges fans to donate to year old boy 'new legs gofundme^iggy azalea blasts nick young after accidental dinner reunion^avril lavigne 'mildly amused by death conspiracy^kanye west is not rebooting 'american idol^fans react u2 cancels st. louis concert amid police protests^jimmy fallon felt need to share 'heartfelt message about charlottesville^no zayn is not 'desperate to defend girlfriend gigi hadid^selena gomez reveals she had a kidney transplant amp her friend was her donor^robert pattinson amp charlie hunnam talk 'lost city of z on 'gma video^chris soules 'devastated after killing kenny mosher in fatal accident^obamas celebrate th anniversary after false split stories^mariah carey not dating both nick cannon and bryan tanaka despite report^michael strahan 'looking forward to working with alex rodriguez at abc^harry styles announces intimate world tour see the dates^khlo kardashian makes her first public appearance since pregnancy news^the bachelor bekah m was on missing persons list until fan recognized her^taylor swift teases new song 'gorgeous on instagram listen to a snippet^bachelor nick viall vanessa grimaldi split end engagement^rachel mcadams is reportedly pregnant with her first child^demi lovato reveals that she contemplated suicide at age^hugh hefner cause death revealed^alex rodriguez year old daughter sings for jennifer lopez photos^taylor swift teases new song 'gorgeous on instagram listen to a snippet^jenny slate and chris evans break up again^the bachelor ben higgins and lauren bushnell break up^justin timberlake announces 'the man of the woods tour see the dates^here what hocus pocus thackery binx looks like now^the narwhal frappuccino is here it tastes like pink starburst^star jones ex husband al reynolds comes out as bisexual in candid blog^tori kelly is engaged to german basketball player andre murillo^watch harry styles kiss james corden in christmas themed 'carpool karaoke^'storm chasers star joel taylor dead at^jennifer lawrence darren aronofsky split^camila cabello announces her 'never be the same tour see the dates^gigi hadid slams body shamers for calling her 'too skinny at nyfw^'black panther is officially the most tweeted about movie of all time^demi lovato announces tour with dj khaled see the dates^chris pratt files divorce from anna faris,65,25,-40,90,0.7222222222222222,-0.4444444444444444,1
15375383,celebsnow,3585,132851,589,168790,0,0,77,13,for latest celebrity gossip go,awks blac chyna 'blocked using kardashian name trying trademark 'angela kardashian'^david beckham admits my marriage struggle becks victoria facing years living apart^looks like short offers sending this message husband number four^kerry katona shares message husband number four gets amazing reaction^kerry katona shares message husband number four gets amazing reaction^liam payne sends fans meltdown cosies cheryl 'lookalike x factor performance^liam payne sends fans meltdown cosies cheryl 'lookalike x factor performance^fans brand this 'fake latest sexy kim kardashian snap ...^we always united fergie josh duhamel announce split eight years marriage^liam payne headed shock career move cheryl finally set speak split^gushes weddings emotional post following liam payne split^reveals rare details baby bear opens family life cheryl split^comeback song release date 'leaked prepares spill beans liam payne split^cheryl sends fan message 'love happiness liam payne finally breaks silence 'difficult split^cheryl opens 'personal struggle new lyrics following liam payne split^liam payne hints split cheryl 'months ago opens heartbreak first time^cheryl set open liam payne split elosive comeback song shock lyrics^omg cheryl comeback song 'about liam payne split released very soon^liam payne makes shock revelation relationship status two months cheryl split^awkward cheryl liam payne 'planning this romantic gesture split^liam payne headed shock career move ex cheryl finally set speak split^liam payne reveals truth behind cheryl split opens heartbreak first time^reveals adorable details baby bear opens family life cheryl split^liam payne sends huge statement cheryl split fans like^cheryl comeback song release date 'leaked prepares spill beans liam payne split^liam payne divides fans makes shock social media move cheryl split^cheryl determined 'get back top following liam payne split 'll it^cheryl opens truggle personal lyrics following liam payne split^cheryl shows 'vulnerability personal lyrics following liam payne split^huge news comeback song 'leaked prepares spill beans liam payn^simon cowell plan get cheryl back top liam payne split^liam payne gets honest dumped cheryl split 'it story life^liam payne makes shock revelation relationship status two months cheryl split^awkward cheryl liam payne 'planning this romantic gesture split^awkward cheryl liam payne 'planning this romantic gesture split^liam payne reveals truth behind cheryl split opens heartbreak first time^liam payne gets honest dumped cheryl split 'it story life^liam payne hints cheryl broke him opens split first time^liam payne opens baby bear first time since cheryl split^cheryl sends cutest message marriage following liam payne split^cheryl sends fan cutest message 'love happiness liam payne speaks 'difficult split^cheryl sends fan cutest message marriage liam payne speaks 'difficult split^cheryl set open liam payne split elosive comeback song shock lyrics^awkward liam payne confesses getting dumped 'the story life cheryl split^liam payne gets honest dumped cheryl split^liam payne opens big changes cheryl split rewrites album^simon cowell plan get cheryl back top liam payne split^opens baby bear first time since cheryl split^cheryl opens truggle personal lyrics following liam payne split^cheryl liam payne prove moved split new videos fans spot something odd^liam payne revealed this love life cheryl split^liam payne transforms home bachelor pad revealing never felt closer family following cheryl sp^livid angelina jolie you 're sleeping jen ange accuses brad getting close ex^is brad pitt secretly dating sienna miller following split angelina jolie here know ...^is brad pitt secretly dating sienna miller following split angelina jolie here know ...^is miley cyrus pregnant liam hemsworth baby^amal george clooney welcome twins announce funniest way^justin bieber hailey baldwin put pda alec baldwin claims already married^i never living eek miley cyrus regrets that naked wrecking ball music video reason ...^'miserable robert pattinson moves belongings 'depressed kristen stewart la home split^is kim kardashian husband kanye west secretly the romantic man ever^are kim kardashian kanye west secretly goths here evidence^are kim kardashian kanye west secretly goths here evidence^are kim kardashian kanye west secretly goths here evidence^so jenner daughters kendall kylie tears very emotional speech^angelina jolie hits 'misleading leak custody battle brad pitt^angelina jolie hits 'misleading leak custody battle brad pitt^katie holmes reaches former dawson creek co star joshua jackson divorce tom cruise actor jo ...^revealed how courteney cox helping bestie jennifer aniston divorce justin theroux^revealed how courteney cox helping bestie jennifer aniston divorce justin theroux^you wo n't believe courteney cox helping best friend jennifer aniston divorce justin theroux^following ant mcpartlin lisa armstrong shock divorce news see timeline relationship pictures.^following ant mcpartlin lisa armstrong shock divorce news see timeline relationship pictures.^following ant mcpartlin lisa armstrong shock divorce news see timeline relationship pictures.^has jennifer aniston split justin theroux i know truth^kylie jenner back spotlight fans convinced hiding something^it war khloe kim kardashian trampoline session puts kylie jenner hospital^prince harry asks prince william best man see adorable throwback photos brothers^prince harry asks prince william best man see adorable throwback photos brothers^has secretly got engaged girlfriend cherry seaborn this hollywood actor drops big hint ...^has ed sheeran secretly got engaged girlfriend cherry seaborn^justin bieber sensationally cancels remaining purpose world tour dates fans not happy^justin bieber sensationally cancels remaining purpose world tour dates fans not happy^'it f**ked kim kardashian finally spoken tristan thompson cheating allegations^'it f**ked kim kardashian finally spoken tristan thompson cheating allegations^'it f**ked kim kardashian finally spoken tristan thompson cheating allegations^'it f**ked kim kardashian finally spoken tristan thompson cheating allegations^eek prince harry did meghan markle make this major fashion faux pas pippa middleton wedding^eek did prince harry girlfriend meghan markle make this major fashion faux pas pippa middleton wedding^omg shaves head completely bald need see pic,77,13,-64,90,0.8555555555555555,-0.7111111111111111,1
138749160,MetroUK,2631,306784,4003,287525,2,0,55,32,all latest news follow us instagram,is snapchat shutting rumours closure addressed^rt is snapchat shutting november via^kim kardashian got eyes kanye west rest world calls miserable^kim kardashian got eyes kanye west rest world calls miserable^jennifer lawrence split darren aronofsky sick talking mother^jennifer aniston justin theroux lovingly split two years marriage^kylie jenner takes fans walking tour mega mansion kinds beautiful^kate middleton picture style elegance stepped private lindo wing st mary hospit^shock report claims emma stone ryan gosling used body doubles la la land^harry styles dating naked diet chef tess ward pair met friends^kim kardashian warned doctors stop taking selfies painful wrist injury^what macaulay culkin net worth date mila kunis^sarah jessica parker says perhaps find way make sex and the city^jennifer aniston justin theroux lovingly split two years marriage^fergie opens mummy shaming working parent split josh duhamel^inside fergie josh duhamel tumultuous romance split years together^miley cyrus liam hemsworth show 'wedding bands coffee run^are jennifer aniston selena gomez set showdown^justin bieber sparks split fears selena gomez mysterious instagram post^sam smith forced give co writing credit tom petty hit song stay with me^sam smith forced give co writing credit tom petty hit song stay with me^pregnant kylie jenner travis scott spending much needed quality time together birth first bab^kim kardashian upset kanye west white house rant donald trump^marilyn manson reveals justin bieber apologetic texts pair settle bizarre feud^jennifer aniston justin theroux lovingly split two years marriage^hailee steinfeld dismisses crazy justin bieber dating rumours^dakota johnson awkward moment director luca guadagnino prevents dress slippage^taylor swift standing bullies new tour^kim kardashian upset kanye west white house rant donald trump^caitlyn jenner nowhere seen son brody destination wedding kaitlynn carter^has royal family ever twins would first line kate middleton twins time^kanye west warned date kim kardashian sex tape^kylie jenner making sister kim kardashian jealous lavish push present^travis scott pleads guilty disorderly conduct days welcoming baby kylie jenner^are jennifer aniston selena gomez set showdown^tyga left heartbroken kylie jenner first child travis scott^blac chyna suing entire kardashian family damaging brand nude picture scandal^blac chyna suing entire kardashian family damaging brand nude picture scandal^kendall jenner considers getting gun keeping up with the kardashians kim kardashian convinced^kendall jenner considers getting gun keeping up with the kardashians kim kardashian convinced^priyanka chopra really excited meghan markle hearing royal baby news^dancing with the stars keen get caitlyn jenner waltzing across tv screens^kim kardashian upset kanye west white house rant donald trump^move simon kanye west could taking spot americanidol judging panel^prepare terrified thanks jennifer lawrence first trailer horror film mother^kim kardashian happy pregnant sister khloe lamar odom heartbreak^kim kardashian disgusted scott disicks desperate revenge sister kourtney^selena gomez reveals kidney transplant friend donor^brad pitt 'has n't reached jennifer aniston amid marriage breakdown^brad pitt 'has n't reached jennifer aniston amid marriage breakdown^kylie jenner baby girl stormi steals spotlight north west birthday bash^kylie jenner keeping pregnancy steps away spotlight^brad pitt highly unlikely prosecuted child abuse allegations leave crying devastated^brad pitt highly unlikely prosecuted child abuse allegations leave crying devastated^brad pitt highly unlikely prosecuted child abuse allegations leave crying devastated^brad pitt devastated sudden deaths good friends chris cornell brad grey^selena gomez feeling empowered completing two week treatment depression anxiety^lady gaga cancels final ten dates joanne world tour due severe pain impacting performance^courtney love warned women harvey weinstein interview i get libelled i say^stranger things officially renewed season netflix^stranger things officially renewed season netflix^jada pinkett smith calls tupac biopic all eyez on me deeply hurtful depiction relationship^breaking prince harry asks prince william best man wedding meghan markle^prince harry asks prince william best man wedding meghan markle^dance moms abby lee miller sentenced year day prison fraud charge^katy perry announces new album witness release date epic tour^rita ora kisses cardi b music video girls despite backlash bisexual claims^the walking dead renewed season new showrunner^nicki minaj open billboard music awards minute performance feat david guetta jason derulo^dancing with the stars emma slater sasha farber married^first look emma roberts returns american horror story cult^dennis rodman enters rehab following dui arrest^remembering avicii tributes celebrities friends dj found dead^bill cosby retrial sexual assault delayed march^is pippa middleton invited prince harry meghan markle royal wedding^breaking bad star aaron paul announces wife lauren eecting first child^buffy the vampire slayer actor nicholas brendon arrested domestic violence girlfriend^golden globes host seth meyers jokes harvey weinstein first person booed dies^taylor swift announces new album reputation first single coming tomorrow^caitlyn jenner says rob kardashian stupid blac chyna social media rant^kylie jenner khloe kardashian joke many babies^disgraced movie mogul harvey weinstein georgina chapman reach divorce settlement^ben affleck dating new woman moves family home amid jennifer garner divorce^ed westwick investigated lapd allegations rape^pregnant kylie jenner still noticeably missing kardashian christmas card series^judge declares mistrial bill cosby sexual assault case^kris jenner addresses reports daughter kylie pregnant^mila kunis ashton kutcher give unprecedented look family life surprise parents home makeover show^get ready clear diaries folks april giraffe pregnant yet,57,32,-25,89,0.6404494382022472,-0.2808988764044944,1
16513752,Star941FM,4439,13567,250,41067,0,1,66,22,star san diego radio station best variety day,the centers disease control prevention reported deaths lettuce borne e.coli outbreak lunch^teen choice awards nominations first wave of nominees full list^john mayer has been hospitalized emergency appendectomy^report kim kardashian is having 'divorce docs drawn up is 'miserable with kanye west^report kim kardashian is having 'divorce docs drawn up is 'miserable with kanye west^sag awards nominations see full list of screen actors guild nominees^karrueche tran granted five year restraining order against chris brown^american music awards nominations amas nominees full list^coming up rhoc scoop new season plus defends^chris pratt files divorce from anna faris^celebrities react nelsan ellis dead at^ed sheeran did not 'break friendship code with taylor swift^johnny depp sued by former business managers^beyonce not demanding silent delivery room despite report^are selena gomez amp the weeknd working on a movie together^jimmy kimmel talks donald trump harvey weinstein on 'gma^brad pitt gq divorce interview highlights on angelina jolie kids and drinking^selena gomez vogue cover story see interview highlights^selena gomez vogue cover story see interview highlights^katie couric said matt lauer pinched her on the ass on 'today back in^jennifer garner ben affleck file for divorce amid false reconciliation rumor^celebrities react to hurricane irma^chris brown slammed by judge for skipping karrueche tran court hearing^chris soules had no alcohol in system after crash negative for drugs^did jennifer lopez 'like a comment dissing mariah carey rumors claiming jlo threw shade mariah ...^kanye west concerts on hold indefinitely kanye checked hospital yesterday home kim ...^kanye west concerts on hold indefinitely kanye checked hospital yesterday home kim ...^katie holmes not pregnant and planning wedding with jamie foxx^lady gaga taylor kinney not secretly dating despite late and wrong report^sorry drake amp bella hadid are not 'secretly dating^kim kardashian sued for allegedly stealing lighting technique for selfies^kristen stewart on dating robert pattinson 'the public were the enemy^ryan lochte charge dropped in rio robbery case^kim kardashian not attending paris fashion week despite claims^kate hudson brad pitt false dating rumor mocked by oliver hudson photo^celebrity reactions prince harry meghan markle engaged^halle berry not pregnant at despite reports^watch kim kardashian first interview since robbery on 'ellen degeneres show videos^watch kim kardashian first interview since robbery on 'ellen degeneres show videos^hailee steinfeld responds to justin bieber dating rumors^beyonce birth twins still hospital 'minor issue^is liam hemsworth mad at miley cyrus for texting nick jonas^karrueche tran granted five year restraining order against chris brown^justin bieber fan arrested trespassing at singer beverly hills home^tony awards nominations see full tonys nominees list^coming up gets ready tonight premiere plus^chloe grace moretz apologizes for 'red shoes marketing^celebrities remember orlando pulse nightclub shooting victims one year later^is demi lovato upset about meghan trainor performing the 'smurfs movie song^justin bieber did not attend vanity fair oscars after party^are mariah carey amp joe jonas feuding^joe jonas sophie turner 'already thinking of having kids is made up story^jessica simpson gives birth baby boy congrats^flo rida not performing at donald trump inauguration despite report^flo rida not performing at donald trump inauguration despite report^chris brown urges fans to donate to year old boy 'new legs gofundme^grammy awards see the full winners list^grammy awards see the full winners list^kanye west is not rebooting 'american idol^fans react u2 cancels st. louis concert amid police protests^report jessica simpson pregnant just months giving birth first child star eect ...^coming up actor dennis quaid kinmovie upcoming reagan biopic ti^robert pattinson amp charlie hunnam talk 'lost city of z on 'gma video^chris soules 'devastated after killing kenny mosher in fatal accident^mariah carey not dating both nick cannon and bryan tanaka despite report^michael strahan 'looking forward to working with alex rodriguez at abc^kourtney kardashian amp scott disick are back together they 've reunited one half years apart^harry styles announces intimate world tour see the dates^'dance moms abby lee miller sentenced to one year in prison^khlo kardashian makes her first public appearance since pregnancy news^the bachelor bekah m was on missing persons list until fan recognized her^taylor swift teases new song 'gorgeous on instagram listen to a snippet^rachel mcadams is reportedly pregnant with her first child^alex rodriguez year old daughter sings for jennifer lopez photos^taylor swift teases new song 'gorgeous on instagram listen to a snippet^jenny slate and chris evans break up again^justin timberlake announces 'the man of the woods tour see the dates^star jones ex husband al reynolds comes out as bisexual in candid blog^watch harry styles kiss james corden in christmas themed 'carpool karaoke^kendrick lamar makes history with pulitzer prize win for 'damn album^'storm chasers star joel taylor dead at^jennifer lawrence darren aronofsky split^kelly clarkson reveals secret behind her pound weight loss^billboard music awards nominations see full list of bbmas nominees^taylor swift announces new album 'reputation see the cover art^camila cabello announces her 'never be the same tour see the dates^gigi hadid slams body shamers for calling her 'too skinny at nyfw^'black panther is officially the most tweeted about movie of all time^chris pratt files divorce from anna faris,66,23,-43,89,0.7415730337078652,-0.4831460674157304,1
19731305,radionow1057,747,2408,92,23129,0,0,58,30,all the hits for binghamton home an station,robert pattinson on movie roles 'people are trying to put you in a box^teen choice awards nominations first wave of nominees full list^john mayer has been hospitalized emergency appendectomy^sag awards nominations see full list of screen actors guild nominees^karrueche tran granted five year restraining order against chris brown^chris pratt files divorce from anna faris^sharon osbourne apologizes to justin bieber 'i was wrong to 'attack you^ed sheeran did not 'break friendship code with taylor swift^jamie foxx katie holmes finally out public as couple^celebrities react trump withdraws steph curry white house invitation^celebrity reaction jimmy kimmel monologue on las vegas shooting and guns^beyonce not demanding silent delivery room despite report^celebrity reactions donald trump phoenix rally speech^jimmy kimmel talks donald trump harvey weinstein on 'gma^stars celebrate rosh hashanah see celebrity tweets about jewish new year^brad pitt gq divorce interview highlights on angelina jolie kids and drinking^selena gomez vogue cover story see interview highlights^jennifer garner ben affleck file for divorce amid false reconciliation rumor^celebrities react to hurricane irma^chris soules had no alcohol in system after crash negative for drugs^no drake is n't 'lusting after rihanna despite new rumors^taylor swift wins countersuit against dj david mueller in groping trial^katie holmes not pregnant and planning wedding with jamie foxx^kim kardashian sued for allegedly stealing lighting technique for selfies^kristen stewart on dating robert pattinson 'the public were the enemy^ryan lochte charge dropped in rio robbery case^celebrity reactions prince harry meghan markle engaged^halle berry not pregnant at despite reports^mariah carey amp french montana did not flirt in recording studio^watch kim kardashian first interview since robbery on 'ellen degeneres show videos^hailee steinfeld responds to justin bieber dating rumors^robert pattinson amp katy perry are not dating^beyonce birth twins still hospital 'minor issue^beyonce birth twins still hospital 'minor issue^karrueche tran granted five year restraining order against chris brown^justin bieber fan arrested trespassing at singer beverly hills home^tony awards nominations see full tonys nominees list^chloe grace moretz apologizes for 'red shoes marketing^celebrities remember orlando pulse nightclub shooting victims one year later^is demi lovato upset about meghan trainor performing the 'smurfs movie song^meghan markle twins with kate middleton during outing with queen^kim kardashian reportedly getting ready divorce kanye west^justin bieber did not attend vanity fair oscars after party^are mariah carey amp joe jonas feuding^chris brown urges fans to donate to year old boy 'new legs gofundme^iggy azalea blasts nick young after accidental dinner reunion^kanye west is not rebooting 'american idol^kim kardashian slams 'invasive surrogacy reports^fans react u2 cancels st. louis concert amid police protests^jimmy fallon felt need to share 'heartfelt message about charlottesville^no zayn is not 'desperate to defend girlfriend gigi hadid^selena gomez reveals she had a kidney transplant amp her friend was her donor^selena gomez reveals she had a kidney transplant amp her friend was her donor^robert pattinson amp charlie hunnam talk 'lost city of z on 'gma video^chris soules 'devastated after killing kenny mosher in fatal accident^obamas celebrate th anniversary after false split stories^mariah carey not dating both nick cannon and bryan tanaka despite report^mariah carey not dating both nick cannon and bryan tanaka despite report^'dance moms abby lee miller sentenced to one year in prison^ed sheeran is engaged longtime girlfriend cherry seaborn^million dollar listing fredrik eklund derek welcome twins^khlo kardashian makes her first public appearance since pregnancy news^the bachelor bekah m was on missing persons list until fan recognized her^taylor swift teases new song 'gorgeous on instagram listen to a snippet^heather locklear hospitalized with minor injuries after car crash^bachelor nick viall vanessa grimaldi split end engagement^rachel mcadams is reportedly pregnant with her first child^rachel mcadams is reportedly pregnant with her first child^demi lovato reveals that she contemplated suicide at age^hugh hefner cause death has been revealed^hugh hefner cause death revealed^alex rodriguez year old daughter sings for jennifer lopez photos^taylor swift teases new song 'gorgeous on instagram listen to a snippet^jenny slate and chris evans break up again^justin timberlake announces 'the man of the woods tour see the dates^here what hocus pocus thackery binx looks like now^star jones ex husband al reynolds comes out as bisexual in candid blog^kim kardashian shares first photo baby chicago west^bachelorette peter kraus reveals he suffered eating disorder^tori kelly is engaged to german basketball player andre murillo^watch harry styles kiss james corden in christmas themed 'carpool karaoke^'storm chasers star joel taylor dead at^jennifer lawrence darren aronofsky split^billboard music awards nominations see full list of bbmas nominees^billboard music awards nominations see full list of bbmas nominees^camila cabello announces her 'never be the same tour see the dates^'black panther is officially the most tweeted about movie of all time^chris pratt files divorce from anna faris,58,30,-28,88,0.6590909090909091,-0.3181818181818182,1
16815644,ABCPolitics,475,782003,6416,133857,3,75,2,7,reports news political team,"rep. jim jordan announces plan run speaker house should american people entrust us t^new rep. jim jordan announces plan run speaker house should american people entrust us w^morning alleged attack nyc bombing suspect wrote trump failed protect nation facebook accordi^pelosi says gop efforts impeach rosenstein make statement pres trump law the attack^new pres trump joint statement european commission pres jean claude juncker we agree today first of^director national intelligence dan coats says wishes pres trump made different statement russia e^director national intelligence dan coats says wishes pres trump made different statement russia e^pelosi says gop efforts impeach rosenstein make statement pres trump law the attack^should concerned infrastructure u.s. italy deadly bridge collapse tells^should concerned infrastructure u.s. italy deadly bridge collapse tells^new in second critical statement many days sen. ben sasse says following pres trump trade war tweet^the centers disease control prevention cdc warns dressing pet chickens halloween^a new report centers disease control prevention finds abortions lowest rate since^a new report centers disease control prevention finds abortions lowest rate since^the centers disease control prevention cdc warns dressing pet chickens halloween^the centers disease control prevention warn u.s. canadian consumers eat romaine lettuce^the centers disease control prevention cdc warns dressing pet chickens halloween^a new report centers disease control prevention finds abortions lowest rate since^republican rep. duncan hunter wife margaret pleaded guilty misusing 250,000 campaign funds to^republican rep. duncan hunter wife margaret pleaded guilty misusing 250,000 campaign funds to^as president trump legal team sets new conditions interview robert mueller goes one^rudy giuliani conditions pres trump interview special counsel robert mueller we 've ev^pres trump personal attorney rudy giuliani says trump legal team close determining president^pres trump personal attorney rudy giuliani says trump legal team close determining president^pres trump personal attorney rudy giuliani says trump legal team close determining president^pres trump personal attorney rudy giuliani says trump legal team close determining president^this week george stephanopoulos airs p today wabc new york due nyc marathon tune s^happening now all eyes pres trump prepares make nomination fill supreme court vacancy le^there number key inconsistencies story 're given abc news says saudi ara^there number key inconsistencies story 're given abc news says saudi ara^pres trump made least eight public statements week true supported known ev^president donald trump job approval rating advanced second highest career new abc news/washing^this morning what issues voters care election and party trust handle tho^president donald trump job approval rating advanced second highest career new abc news/washing^happening now we 're days midterm elections abc news political director breakin^congress averted partial government shutdown week real fight begins border wall fundin^pres trump made least eight public statements week true supported known ev^this truly horrific scene abc news reports pittsburgh community grappl^new first lady melania trump plans visit another center housing migrants point week spokesperson^president tump says send written answers special counsel robert mueller week signals h^president donald trump job approval rating advanced second highest career new abc news/washing^i n't said jpmorgan chase ceo jamie dimon tells abc news n't bragge^president donald trump job approval rating advanced second highest career new abc news/washing^new republican national committee selects charlotte north carolina host convention we look forward to^hhs secretary alex azar tells abc news president trump one hundred percent clear w^orlando mass shooting this act terror ... this also act hate^new postpones first event pres obama following orlando mass shooting^watch orlando mass shooting we steel resolve respond^full transcript final presidential debate^senate majority leader mitch mcconnell issues statement executive order signed pres trump i glad pr^pres trump hugged american flag conclusion remarks national federation independent busi^the centers disease control prevention cdc warns dressing pet chickens halloween^a new report centers disease control prevention finds abortions lowest rate since^a new report centers disease control prevention finds abortions lowest rate since^the centers disease control prevention cdc warns dressing pet chickens halloween^the centers disease control prevention warn u.s. canadian consumers eat romaine lettuce^the centers disease control prevention cdc warns dressing pet chickens halloween^a new report centers disease control prevention finds abortions lowest rate since^just in vice president biden deliver statement rose garden :10 pm est^alert news special report vice president biden makes statement rose garden^watch live pres trump holds campaign rally las vegas^happening now pres trump holds campaign rally las vegas nevada^outgoing ohio gov john kasich tells considering run president trump se^fifty years heroism vietnam war retired marine sgt maj. john l. canley receives medal of^outgoing ohio gov john kasich tells considering run president trump se^outgoing ohio gov john kasich tells considering run president trump se^fifty years heroism vietnam war retired marine sgt maj. john l. canley receives medal of^outgoing ohio gov john kasich tells considering run president trump se^fifty years heroism vietnam war retired marine sgt maj. john l. canley receives medal of^while delivering keynote speech touting republican tax cuts cincinnati ohio vice president mike pence sa^you said something podium was accurate press sec sarah sanders questioned multiple times du^one two turkeys appealing thanksgiving pardon pres trump appears white house press briefi^white house press secretary sarah sanders take questions reporters camera briefing afternoo^read transcript exclusive interview former trump attorney fixer michael cohen^watch live delivers remarks watch party philadelphia pa^president donald trump delivers remarks national electrical contractors association convention philadelph^watch live delivers remarks afl cio convention philadelphia^watch live pres donald trump makes remarks gop retreat philadelphia^oprah winfrey actively considering running president close friend gayle king says.^oprah winfrey actively considering running president close friend gayle king says.^ivanka trump closing shop eponymous fashion brand she said wanted focus policy wor^law amp order svu star diane neal running congress new york^law amp order svu star diane neal running congress new york^the supreme court declines hear appeal brendan dassey whose murder conviction subject net^new the supreme court declines hear appeal brendan dassey whose murder conviction subject th^the supreme court declines hear appeal brendan dassey whose murder conviction subject net^new the supreme court declines hear appeal brendan dassey whose murder conviction subject th",5,82,77,87,0.057471264367816084,0.8850574712643678,0
14173315,NBCNews,1757,6802207,41960,224944,1,71,7,6,the leading source global news info years our new free streaming service,"full statement attorney general jeff sessions recusal investigation russian contacts tru^in latest statement white house press sec sanders says stand statement revocation journa^after florida secretary state orders recount begin ron desantis releases video statement saying stil^in latest statement white house press sec sanders says stand statement revocation journa^joseph jackson patriarch musical jackson family died age according statement t^sen. sasse statement tariffs we verge painful stupid trade war bad ... tempora^the number homicides committed using guns gone nearly third nationwide recent years according to^it unlikely romaine lettuce yuma growing region still available stores restaurants d^more ,000 people die cardiovascular disease u.s. every year leading cause death both^in may centers disease control prevention said cases tick borne diseases lyme disease hav^more ,000 people die cardiovascular disease u.s. every year leading cause death both^death rates rose alzheimer disease diabetes flu pneumonia three leading causes death acc^president trump blasted retired adm. bill mcraven navy seal led raid killed osama bin laden^president trump blasted retired adm. bill mcraven navy seal led raid killed osama bin laden^president trump blasted retired adm. bill mcraven navy seal led raid killed osama bin laden^president trump blasted retired adm. bill mcraven navy seal led raid killed osama bin laden^new rudy giuliani tells nbc news phone interview spoken phone lawyers special cou^rudy giuliani confirms nbc news special counsel robert mueller rejected trump team offer presiden^democrats hold point advantage heading midterm elections poll finds^new trump approval rating remains steady tumultuous week poll finds^new trump approval rating remains steady tumultuous week poll finds^democrats hold point advantage heading midterm elections poll finds^democrats hold point advantage heading election day according new poll^majorities american voters disapprove president trump handling russia immigration border acc^democrats hold point advantage heading election day according new poll^new democrats hold point advantage heading midterm elections poll finds^democrats hold point advantage heading midterm elections poll finds^new poll trump approval rating remains steady tumultuous week poll finds^democrats hold point advantage heading election day according new poll^two thirds latinos favor democratic control congress according new // poll^the u.s. department education announced thursday would automatically cancel 150 million student loans con^the u.s. department education announced thursday would automatically cancel 150 million student loans con^the u.s. department education announced thursday would automatically cancel 150 million student loans con^i sitting trying find collusion crime collusion crime giuliani said inter^in tweet rep. tulsi gabbard slams president trump saudi arabia bitch president statement^in tweet rep. tulsi gabbard slams president trump saudi arabia bitch president statement^live president trump delivers remarks national federation independent business th anniversary celebration^president trump giving extended criticism immigration policy speech national federation o^president trump blasted retired adm. bill mcraven navy seal led raid killed osama bin laden^president trump blasted retired adm. bill mcraven navy seal led raid killed osama bin laden^president trump speaks national republican congressional committee annual march dinner watch live^live president trump speaks national republican congressional committee annual march dinner^the number homicides committed using guns gone nearly third nationwide recent years according to^in may centers disease control prevention said cases tick borne diseases lyme disease hav^more ,000 people die cardiovascular disease u.s. every year leading cause death both^breaking a police officer two victims killed shooting chicago hospital monday afte^days ahead annual united nations general assembly meeting new york president trump campaign rally^watch live president trump holds campaign rally las vegas^watch live hillary clinton holds campaign rally las vegas^democrats enjoy point advantage republicans congressional preference midterm elections e^democrats point advantage republicans congressional preference midterm elections ev^watch matt lauer interview former president george w. bush video^rt matt interview president george w. bush airs next week here preview^just in house speaker paul ryan statement senate passage bipartisan budget act now time the^as close special report today listen john mccain words reflecting life prepa^noted quoted msnbc hosts congressional leadership florida recount white house tensions^noted quoted hosts birthright citizenship maga rallies president trump final midterm message.^live white house press briefing^live white house press briefing^live sec pompeo speaks white house briefing president trump meetings saudi leaders abo^live white house press briefing^the finches detained quarantine turned u.s. department agriculture veterinary service^tens thousands pounds jimmy dean meat products possibly containing pieces metal recalled acc^tens thousands pounds jimmy dean meat products possibly containing pieces metal recalled acc^ready eat salads made small suppliers across country recalled might contaminate^tens thousands pounds jimmy dean meat products possibly containing pieces metal recalled acc^ready eat salads made small suppliers across country recalled might contaminate^watch live hillary clinton makes remarks african methodist episcopal general conference philadelphia^in us saudi trade goods services worth 45b top erts us including aircraft^in us saudi trade goods services worth 45b top erts us including aircraft^in us saudi trade goods services worth 45b top erts us including aircraft^just in president trump directs u.s. trade rep identify 200b worth chinese goods additional tariffs^comedian hannibal buress arrested miami disorderly intoxication via^prince harry meghan markle delighted able share happy news public announcing^meghan markle mother doria ragland says happy lovely news looks forward welc^live anchor latest calif. bar mass shooting attack.^shots fired beverly hills house kanye west rapper tekashi ix9ine filming music video th^royal insiders historians nodded heads knowingly venue prince harry meghan markle may w^angelina jolie brad pitt headed court early next month battle custody the^a second suspect murder rapper xxxtentacion arrested florida authorities say^a second suspect murder rapper xxxtentacion arrested florida authorities say^olivia newton john postpones tour dates due breast cancer battle via^just in us supreme court declines hear appeal brendan dassey whose murder conviction subject 'ma^bill cosby sexual assault retrial delayed spring^academy award winning american screenwriter dustin lance black british olympic diver tom daley announced soc",8,77,69,85,0.09411764705882353,0.8117647058823529,0
155514121,People_SA,5678,156030,285,87449,0,0,62,23,peoplesa hottest celebrity news real life stories,leslie jones urges critics stop digging comedians old jokes^busy philipps entertains famous friends lindsay lohan dance challenge^nazoke gt benaffleck getting back together gt^kanye west still friendly former law caitlyn jenner^hotgossip apparently irritated poaching hairdresser readon gt^local stars celebrate women day^sarah jessica parker open sharon stone joining sex city^fergie josh duhamel considering second child split^bette midler crawled offstage initial hello dolly run^liam payne hints cheryl initiated split new ep^liam payne feeling positive months cheryl split^cheryl bemoans end dating life liam payne split^cheryl set record straight liam payne split music^liam payne confirms reworking album cheryl split^wendell pierce advised meghan duchess sussex call fishbowl got much^meghan duchess sussex returning tv new royal documentary^chrissy teigen criticizes meghan duchess sussex father latest tabloid tell^estranged sister meghan duchess sussex talks celebrity big brother^matt smith proposes vanessa hudgens play meghan duchess sussex^joaquin phoenix rooney mara found love shooting biblical epic report^julia roberts hurt headlines marriage^selena gomez fears overcome depression anxiety^selena gomez fears overcome depression anxiety^britney spears left terrified sons pull hilarious prank^julia roberts offers chance join pretty woman inspired shopping spree^kristen stewart girlfriend stella maxwell move together report^jennifer aniston asks courteney cox set new man^wendell pierce advised meghan duchess sussex call fishbowl got much^meghan duchess sussex returning tv new royal documentary^chrissy teigen criticizes meghan duchess sussex father latest tabloid tell^estranged sister meghan duchess sussex talks celebrity big brother^matt smith proposes vanessa hudgens play meghan duchess sussex^kourtney kardashian jealous kim totally get kardashians^ben affleck jennifer garner settle divorce case report^jennifer lopez introduces new boyfriend alex rodriguez mother^kristen stewart utterly proud response saturday night live monologue^carrie underwood honours husband mike fisher following ice hockey retirement^carrie underwood honours husband mike fisher following ice hockey retirement^the weeknd scrapped 'upbeat album selena gomez split^the weeknd scrapped 'upbeat album selena gomez split^reality tv star pal confirms jamie foxx katie holmes dating^brody jenner disappointed dad caitlyn skipped wedding^caitlyn jenner skips son brody jenner wedding^kendall kylie jenner 'did n't even rsvp brother brody wedding^katie holmes seen mystery man ...^new mum khloe kardashian leaning ex lamar odom support^new mum khloe kardashian leaning ex lamar odom support^new mum khloe kardashian 'leaning ex lamar odom support^angelina jolie relieved brad pitt abuse investigation closed^brad pitt hits back angelina jolie child support jab^angelina jolie bizarre plot capture warlord joseph kony report^kylie jenner never misses night travis scott^prince william catherine duchess cambridge debut new prince^prince william catherine duchess cambridge debut new prince^prince william catherine duchess cambridge debut new prince^prince william catherine duchess cambridge debut new prince^gwen stefani gifts blake shelton flagpole birthday^emma stone i imagine life without ryan gosling^meghan markle considered bond girl role royal relationship report^david beckham fight speeding claim technicality^joel madden terrified botox approaches^chris martin dakota johnson ready move together^fergie returns stage national anthem fiasco^fergie returns stage national anthem fiasco^kim kardashian tristan thompson unfollow social media^kim kardashian tristan thompson unfollow social media^kim kardashian tristan thompson unfollow social media^drew barrymore spray painted ex boyfriend car^jada pinkett smith gabrielle union call time year feud^jada pinkett smith gabrielle union call time year feud^jada pinkett smith gabrielle union call time year feud^ariana grande cancels vietnam concert due health problems^stranger things star shannon purser comes bisexual^steve martin martin short colonoscopy parties tom hanks^dwayne johnson wants marry frances mcdormand^dwayne johnson wants marry frances mcdormand^michael fassbender alicia vikander married report^jennifer lawrence darren aronofsky split report^taylor swift stalker sentenced years probation told stay away singer^celine dion donates proceeds las vegas concert shooting victims^john cena nikki bella split six years^john cena nikki bella split six years^sarah hyland dominic sherwood break report^sarah hyland dominic sherwood break report^mila kunis treated parents surprise home makeover,62,23,-39,85,0.7294117647058823,-0.4588235294117647,1
33863876,hellomag,1967,192331,1361,137193,0,0,66,17,the celebrity royal news magazine website hello like us follow us instagram snapchat tiktok via,it official confirm romance^princeharry found love see timeline relationship^victoria beckham spice girl dance moves embarrassed david party last night see funny video ...^find liam payne spent first birthday since cheryl split^opened split cheryl first time^liam payne making big life change following cheryl split^cheryl admits liam payne split statement 'cringeworthy^find duchess cambridge summer holiday different year ...^the duchess cambridge stylist natasha archer bares baby bump gorgeous bikini snap see photo^how stunning duchess cambridge pregnant stylist natasha archer look see growing baby bump^exclusive anita rani revealed hopes duchess cambridge duchess sussex count^find duchess cambridge summer holiday different year ...^the duchess cambridge maternity leave different prince louis prince george princess cha^designer tea towels next big thing ask duchess cambridge^how glamorous duchess cambridge look went church sunday morning queen^pick copy week hello read duchess cambridge tropical island date prince^you buy headband duchess cambridge wore prince louis christening^kate garraway nude high heels zara look like belong duchess cambridge wardrobe^the duchess cambridge joined queen church sunday ...^the 5 tights duchess cambridge wears stop shoes slipping^exclusive anita rani revealed hopes duchess cambridge duchess sussex count^have picked copy week hello yet read duchess cambridge tropical island date^here wo n't seeing photos duchess cambridge family holiday mustique ...^the duchess cambridge 39 statement earrings want need autumn^the initial earrings think duchess cambridge christmas list^read duchess cambridge tropical island date prince william plus exclusive int^the duchess cambridge rainbow wardrobe one colour rarely wears^is next time 'll see duchess cambridge summer we hope^this tv star favourite play young prince charles thecrown wait^prince charles duchess cornwall iconic polo match photo recreated the crown^prince charles duchess cornwall iconic polo match photo recreated the crown^the crown confirms play prince charles queen mother third season^how stay great shape find^hollywood superstar bradpitt spoken fighting back demons read latest i^things could getting serious new boyfriend see star latest photo^miley cyrus says regrets wrecking ball video^miley cyrus says regrets wrecking ball video^selena gomez spoken split the weeknd^are jamie foxx katie holmes dating find ...^are katie holmes jamie foxx dating^chris pratt anna faris still living together despite split^chris pratt anna faris still living together despite split^chris pratt anna faris still living together despite split^read details bradpitt angelinajolie joint divorce statement^bradpitt angelinajolie release statement regarding divorce read details^bradpitt angelinajolie released joint statement regarding divorce see details^julia roberts shares rare personal photo husband danny moder^look hello special collectors edition celebrating royal wedding prince harry meghan markle.^look hello special collectors edition celebrating royal wedding prince harry meghan markle.^look hello special collectors edition celebrating royal wedding prince harry meghan markle.^jessica simpson gives birth baby boy ...^jessica simpson gives birth son ace knute johnson ...^the signs prince harry meghan markle destined fairy tale wedding^a month month timeline prince harry meghan markle fairy tale romance royal wedding nears^the signs prince harry meghan markle destined fairy tale wedding^the signs prince harry meghan markle destined fairy tale wedding^read details bradpitt angelinajolie joint divorce statement^bradpitt angelinajolie release statement regarding divorce read details^bradpitt angelinajolie released joint statement regarding divorce see details^more baby news the gorgeous rachel weisz daniel craig welcomed first child find gender^prince harry meghan markle aides apologise late reply following royal wedding^prince harry meghan markle aides apologise late reply following royal wedding^david beckham facing speeding charge london driving bentley limit^did male model william levy 'the brad pitt cuba play part breakdown jlo marc marriage hellomag^ben fogle sent message prince harry meghan markle missing royalwedding^prince william missing fa cup final prince harry meghan markle wedding th may ...^anna kournikova welcome twins nicolas lucy read week hello^anna kournikova welcome twins nicholas lucy pick copy week issue read^confirmed meghan markle prince harry spend christmas queen members royal family.^meghan markle dad reacts news prince charles walk aisle royal wedding^hugh hefner cause death revealed days funeral^sophie turner engaged see stunning ring^duchess meghan must follow this important royal shoe rule^granted temporary restraining order^granted temporary restraining order^justin theroux breaks social media silence jennifer aniston split^prince harry says royal family 'loved meghan markle christmas^is rosamund pike set play princess diana feud season two^everything know princess eugenie jack brooksbank royal wedding far ...^one month go here everything need know princess eugenie jack brooksbank royal wedding ...^it royal wedding tomorrow find everything need know princess eugenie jack brooksbank^gwyneth paltrow wishes 'brother chris martin happy birthday see sweet family snap posted^is mandy moore engaged musician taylor goldsmith she spotted dazzling ring,66,17,-49,83,0.7951807228915663,-0.5903614457831325,1
19329393,PerezHilton,569,6009906,38215,321262,0,1,69,13,this account for man follow for booking inquiries email bookings.com,correction robert pattinson first interview after cheating scandal will be on the the daily show^leslie jones addresses issue offensive jokes comedians right tell^angelinajolie amp bradpitt are finally getting married on screen deets here lt 3 lt 3 lt 3 lt 3^brad pitt prepares for married life with angelina jolie by crashing wedding^jennifer lawrence throws serious shade at kristen stewart for cheating^divergent star shailenewoodley throws mad shade twilight calls kristenstewart franchise toxic^jessica simpson debuts baby bump^amp jenner interact amp^done bs^bradpitt amp angelinajolie wo n't going war combined fortune thanks ironclad prenup^who says ca n't nabbed american idol crown and love season finale^here real reason amp traveled seattle^whoa is tennis player liam hemsworth twin^happy birthday^jennifergarner heidiklum usually lovely ladies landed worst dressed list week sad take a^wow rt justin bieber drugged up tour bus cops confirm narcotics were found^does mean druggie rt drugged up tour bus cops confirm narcotics found^justinbieber amp selenagomez further confirm their reunion with party pda^funnyordie jerryoconnell know *really* happened steveharvey week^brad pitt amp jennifer aniston headed for a showdown at the toronto film festival^brad pitt amp jennifer aniston headed for a showdown at the toronto film festival^anna wintour banned kris jenner amp the real housewives new york from the met gala^kimkardashian shares day three family christmas card teaser adorable shot reigndisick look^shares version family christmas card pic here^kanyewest concerts hold indefinitely rapper recovers recent breakdown^here big winners amas^nick cannon kanye west made peace kim kardashian^angelinajolie reportedly still trying prove bradpitt committed child abuse^happy birthday^fans think baby bump^here happy news bf sam asghari looking adorable basketball game^jessica simpson debuts baby bump^kim kardashian reveals she suffering from morning sickness^did katie holmes pick up the check on her dinner date with the mystery man^brad pitt amp jennifer aniston headed for a showdown at the toronto film festival^brad pitt amp jennifer aniston headed for a showdown at the toronto film festival^elosive fights^chrisbrown teased collab zayn amp internet freaking out^fans think baby bump^privacy time reportedly misses parts old life^oh hello no just no rt kristen stewart wants as her robert pattinson rebound^revenge body eert heed advice^in honor st birthday sexy gigihadid gifs^tells 'always family watch^the custody battle angelinajolie bradpitt continues^angelinajolie divorce lawyer laurawasser never great fit cutthroat battle bradpitt^brad pitt furious angelina jolie going public child custody battle^angelinajolie see past anger bradpitt amid elosive custody battle^brad pitt reportedly sees kids every day several hours amid ongoing custody battle^bradpitt amp angelinajolie reportedly secret meeting make things work amid custody battle^angelinajolie amp bradpitt custody battle far^alert taylor swift briefly comes hiding^nick cannon kanye west made peace kim kardashian^angelinajolie new man^justintheroux speaks openly first time like divorce jenniferaniston^justintheroux gets real divorce jenniferaniston^what divorce jenniferaniston justintheroux may never even married first place the newes^elosive fights^happy birthday^happy birthday^jennifer aniston amp justin theroux embroiled in an east coast vs. west coast battle^jennifer aniston amp justin theroux embroiled in an east coast vs. west coast battle^jennifer aniston wins wedding location battle with justin theroux knot to be tied in cali^jennifer aniston amp justin theroux embroiled in an east coast vs. west coast battle^do u want return spotlight^ready live life away spotlight^marioncotillard left absolutely devastated rumors bradpitt mistress^kyliejenner declares family prank war kimkardashian sent penis shaped treat^whoa kendalljenner anwarhadid hooking^kendalljenner anwarhadid^qb tombrady criticized kissing son long lips where you stand issue^dance moms star lee miller sentenced year prison^congratulations idina nph nominations announced for the th annual tony awards see complete list here^harvey weinstein accused raping multiple women elosive report^who knew rap^apparently hospitalized attending oscars party^update stan lee feeling great brief hospitalization^reflects mother past suicide attempt we always got ta best really pay attention when^says sex tape leak like raped^is ready start family get kuwtk season finale recap here^clarifies pathological liar comment doubling^harrystyles covers kanyewest ultralightbeam first ever solo concert watch^home alone star john heard cause death revealed,69,14,-55,83,0.8313253012048193,-0.6626506024096386,1
20442930,Daily_Star,3611,190724,1868,483798,0,4,62,16,your official daily star twitter page,shock fashion firm uses models having sex graphic ad campaign^shock fashion firm uses models having sex graphic ad campaign^shock fashion firm uses models having sex graphic ad campaign^shock fashion firm uses models having sex graphic ad campaign^kate middleton prince william keeping huge secret george protect^could husband number four gmb^did leak jennifer aniston baby news^liam payne melts hearts cute cake tribute son bear ... cheryl keeps away^queen warned prince harry meghan markle behaviour wedding tiara row^cheryl reveals 'inner struggle vulnerable new liam payne split tracks^l reveals truth behind cheryl split we broken knew months ago firsttimeoutnow^how much liam payne worth following cheryl split^reveals truth behind cheryl split we broken knew months ago lpfirsttime^liam payne opens bear payne first time since cheryl split^how much liam payne worth following cheryl split^how much liam payne worth following cheryl split^liam payne new 'cheryl split track polaroid elained jonas blue^cheryl reveals 'inner struggle vulnerable new liam payne split tracks^cheryl split causes liam payne delay debut album 'there big changes^liam payne opens bear payne first time since cheryl split^cheryl liam payne split music video love made me do details leak online^cheryl reveals 'inner struggle vulnerable new liam payne split tracks^cheryl reveals 'inner struggle vulnerable new liam payne split tracks^reveals 'inner struggle vulnerable new liam payne split tracks^katy perry hints hooked famous face raunchy game^britney spears dissected plastic surgeon overhauled entire face^the wedding miley cyrus liam hemsworth not walking aisle together^the wedding miley cyrus liam hemsworth not walking aisle together^the wedding miley cyrus liam hemsworth not walking aisle together^eebaftas baftas awards la la land leads winner list^we 're still chris pratt anna faris split^meghan markle prince harry announce royalbaby way rules duchess foll^james hewitt speaks out rumours prince harry real dad affair diana royalwedding^james hewitt speaks out rumours prince harry real dad affair diana royalwedding^is james hewitt prince harry real dad proof ginger hair revealed^james hewitt speaks out rumours prince harry real dad affair diana royalwedding^james hewitt speaks out rumours prince harry real dad affair diana royalwedding^james hewitt speaks out rumours prince harry real dad affair diana royalwedding^are justin bieber hailey baldwin married already^are justin bieber hailey baldwin married already^are justin bieber hailey baldwin married already^jennifer lopez drops bombshell sex confession new boyfriend alex rodriguez^jennifer lopez makes bombshell sex confession new boyfriend alex rodriguez^regrets swinging naked wrecking ball video 'i 'm never living^angelina jolie wows goes braless red carpet^is 'privately jealous success^world exclusive prince harry secret lover revealed us actress meghan markle^prince harry secret lover revealed stunning us tv star^is done kardashians reality star misses crucial interview^meghan markle moving to uk prince harry engagement looms^meghan markle moving to uk prince harry engagement looms^meghan markle moving to uk prince harry engagement looms^is kourtney kardashian pregnant baby number^uh oh ... war^meghan markle prince harry apologise delayed royal wedding thank cards^'ruined whole thing prince harry reveals royal wedding bouquet fail royalwedding princeharry meghanmarkle^'ruined whole thing prince harry reveals royal wedding bouquet fail royalwedding princeharry meghanmarkle^'ruined whole thing prince harry reveals royal wedding bouquet fail royalwedding princeharry meghanmarkle^the truth behind jenniferaniston justintheroux split^kim kardashian 'terrified social media bans phones home protect children^kylie jenner bff catapults spotlight strips fashion range^kylie jenner knows steal spotlight even somebody plus one^marion cotillard 'devastated brad pitt cheating allegations^war guess^allergic underwear kimkardashian ditches knickers date night kanye^is kim kardashian allergic clothes^prince harry net worth how much royal engaged meghan markle actually worth^a second suspect arrested xxxtentacion murder case^a second suspect arrested xxxtentacion murder case^breaking nelly arrested suspicion rape following 'incident tour bus^breaking us rapper nelly arrested suspicion 'rape following incident tour bus^breaking us rapper nelly arrested suspicion 'rape following incident tour bus^heartbreak love island dead rip^breaking country music star timmcgraw collapses onstage ireland^a second suspect arrested xxxtentacion murder case^a second suspect arrested xxxtentacion murder case^the latest celebrity fashion trend bound make blush^'hot felon jeremy meeks files divorce wife melissa^playboy supremo hugh hefner cause death revealed^playboy supremo hugh hefner cause death revealed^matthew lewis star marries angela jones much harry potter worth^matthew lewis star marries angela jones much harry potter worth,62,20,-42,82,0.7560975609756098,-0.5121951219512195,1
18742360,TheWrap,12443,233275,4423,196288,0,2,29,50,we got hollywood covered follow instagram behind scenes everything thewrap,white house react orlando mass shooting^morgan freeman comments reporter melas led her report harassment accusations^leslie jones hopes comedians 'snl can move past constant trump jokes^ashton kutcher calls out tabloid cheating story 'these magazines lack integrity^ashton kutcher calls out tabloid cheating story 'these magazines lack integrity^ashton kutcher calls out tabloid cheating story 'these magazines lack integrity^charlie sheen settles lawsuit against national enquirer over corey haim rape report^responds praise 'i 'd never support ... hatred racism'^katie couric breaks silence matt lauer 'this was not matt we knew today tod ...^emily blunt talk smack each other while working out video^'the crown casts older prince charles queen mother season time jump thecrown^oscar parties the top invites events nominee gatherings^'big little lies season returns more cast members adds news ones^'why i disagree with my dad ivanka trump meme takes off^'why i disagree with my dad ivankatrump meme takes off^'why i disagree with my dad ivanka trump meme takes off^golden globes the complete list nominees updating live goldenglobes^'boy erased film review nicole kidman russell crowe shine gay conversion therapy drama^'destroyer film review nicole kidman repulsively brilliant hardcore action flick^is kathy griffin career over top crisis managers weigh in^taylor swift calls out kim kardashian 'snake subtweet 'bully move^elon musk 'pedo tweet inquiry answered thai rescue diver lawyer preps lawsuit^'homecoming julia roberts is ready 'get started first teaser amazon series video amazon^matthias schoenaerts star black list thriller 'ruin^donald trump rips 'no talent stephen colbert 'what he says is filthy^kristen stewart laughs off tabloid reports that she quitting acting video^'flip flop atlanta was not supposed be part franchise fliporflop fliporflopatlanta^harvey weinstein estranged wife georgina chapman life after scandal 'humiliated so broken'^blake shelton settles lawsuit over in touch rehab story^abc gives series order drama 'take two starring rachel bilson eddie cibrian^'modern family star julie bowen makes pest herself set photo^'modern family renewed more seasons abc^'modern family renewed more seasons abc^'modern family renewed more seasons abc^'modernfamily renewed more seasons abc^keri russell early talks join 'star wars episode ix cast^cma awards the complete winners list updating cmaawards^naacp image awards the complete winners list updating^'jesus christ superstar set nbc next live musical^tony awards nominations the complete list from 'frozen 'harry potter^jim carrey wrongful death lawsuit dismissed^'the crown casts 'outlander star tobias menzies as new prince philip thecrown^mtv movie amp tv awards the complete list winners updating^claire danes says 'homeland will end with season^portia de rossi says steven seagal unzipped his pants during her audition with him^frank avruch star 'bozo clown dies^val kilmer admits cancer battle first time 'i did have healing^val kilmer admits cancer battle first time 'i did have healing^kim cattrall brother found dead after being reported missing^creative arts emmys the complete list night winners updating live^kathie lee gifford why she contacted friends harvey weinstein bill cosby post scandal i don judge them^jesse camp former mtv vj reported missing riverside^'american horror story season title revealed comic con^'american horror story season title revealed comic con^justin timberlake announces new album 'man woods video^launches instagram 'relief challenge hurricane harvey victims^starz renewed seasons starz outlander^'aquaman makes huge splash comic con first trailer video sdcc2018^daytime emmy awards the complete winners list updating^wants marry 'crush frances mcdormand video^jennifer hudson joins 'the voice season coach^jennifer hudson joins 'the voice season coach^jennifer hudson joins 'the voice season coach^jennifer hudson joins 'thevoice season coach^celine dion all people poses naked vogue photo^katy perry host 'mtv video music awards vmas cc^cox digiovanni years ago got matt damon ben affleck adopt 'inclusion rider p^'rent picked fox next live musical^edward norton production company sued over deadly fire film set 'motherless brooklyn'^billboard music awards complete winners list bbmas^returns direct 'jurassic world^lena dunham joins 'american horror story season^lena dunham joins 'american horror story season^meryl streep joins 'big little lies season^netflix shows binge watch alone this holiday season photos^richard simmons hospitalized with 'severe indigestion^beyonce reported headline^leslie jones accuses ritz carlton racism 'they do n't like black people^ving rhames says police held him gunpoint his own home^ving rhames says police held him gunpoint his own home^ben affleck jennifer garner officially file divorce,29,52,23,81,0.3580246913580247,0.2839506172839506,0
330255896,IrishMirror,899,38249,521,227483,0,1,66,14,official home irish daily mirror twitter latest news sport celebrity gossip also facebook,chicago hospital shooting 'multiple victims gunman opens fire^george clooney danced meghan kate fergie turned exclusive details party year^is everyone family copying kim now bruce jenner shows rather feminine nails^is everyone family copying kim now bruce jenner shows rather feminine nails^new only fools horses video watch david beckham poke fun glasses gag sport relief^new only fools horses video watch david beckham poke fun glasses gag sport relief^katie holmes pregnant jamie foxx baby wedding^katie holmes pregnant jamie foxx baby wedding^kerry katona reveals looking husband number four suffers year long sex drought^skinny angelina jolie reveals painfully thin arms red carpet brad pitt stays away netflix premiere^hotel co laois honeymooned named one world 'top h^meghan markle 'frustrated strict royal rules 'learning hard way life inside family^brad pitt 'apologises jennifer aniston 'absentee husband leaving angelina jolie^brad pitt 'apologises jennifer aniston 'absentee husband leaving angelina jolie^cherry seaborn double date courteney cox johnny mcdaid wedding rumours^ed sheeran cherry seaborn double date courteney cox johnny mcdaid^fights furious neighbours 'bologna incident the real reasons behind jennifer aniston justin theroux^admits single sparking rumours ditched model cairo dwek two months cheryl spl^cheryl set move 3.75million mansion split liam payne^cheryl breaks silence split liam payne emotional comeback single love made me do^video justin bieber dedicates song baby selena gomez pair appear finally confirm romance^ben affleck looks dumps tense outing jennifer garner daughter seraphina^jennifer garner 'wipes away tear tense reunion estranged husband ben affleck^ben affleck looks dumps tense outing jennifer garner daughter seraphina^jennifer garner 'wipes away tear tense reunion ben affleck^cherry seaborn double date courteney cox johnny mcdaid wedding rumours^ed sheeran cherry seaborn double date courteney cox johnny mcdaid^justin bieber model tati neves sex star what think^kendall kylie jenner 'jealous 'upset caitlyn jenner 'engagement year old student sophia hut^breaking is pregnant rapper boyfriend travis scott baby reps confirm^kylie jenner is pregnant rapper boyfriend travis scott baby reps confirm^kylie jenner 'pregnant rapper boyfriend travis scott baby^'remorseful justin bieber sobs selena gomez enters mental health facility following hailey baldwin marriage^brad pitt 'apologises jennifer aniston 'absentee husband leaving angelina jolie^brad pitt 'apologises jennifer aniston 'absentee husband leaving angelina jolie^justin bieber 'makes hailey baldwin priority sobbing selena gomez 'breakdown^is kim kardashian losing hair reality star seen 'bald patches workout^jennifer lopez confirms relationship new boyfriend drake cutest way new year^jennifer lopez looks incredible dinner date new boyfriend^the real reason mel b ended turbulent marriage stephen belafonte revealed^the real reason mel b ended turbulent marriage stephen belafonte revealed^brad pitt 'apologises jennifer aniston 'absentee husband leaving angelina jolie^brad pitt 'apologises jennifer aniston 'absentee husband leaving angelina jolie^angelina jolie breaks silence brad pitt 'bad marriage breakdown^calvin harris surrounds gorgeous women taylor swift split^watch kendall jenner break tears praises dad bruce following sex change revelations^kris vs caitlyn jenner the bitter rows nasty jibes endless power struggle^jennifer aniston puts brave face ellen degeneres makes joke marriage^amanda byram quits rte dancing with the stars^amanda byram quits dancing with the stars host lands big money presenting gig london los angeles^claudine keane talks replace amanda byram rte dancing with the stars^amanda byram quits dancing with the stars host lands big money presenting gig london los angeles^jennifer aniston justin theroux wedding pictures inside doomed fairytale day ended divorce^at last kim kardashian admits selfie obsession ridiculous^at last kim kardashian admits selfie obsession ridiculous^jennifer lawrence admits still terrified nude photo leak^billy connolly wife pamela blast 'daft old fart michael parkinson saying comic could n't remember close^billy connolly wife pamela blast 'daft old fart michael parkinson saying comic could n't remember close^inside billy connolly loving family life parkinson battle means longer recognises friends^jennifer aniston clears justin theroux relationship rumours we know truth^susanna reid looks ready punch piers morgan furious row david beckham breaking law^angelina jolie breaks silence brad pitt 'bad marriage breakdown^terrified kimkardashian breaks tears kanyewest worrying phone call what wrong^terrified kim kardashian tears worrying phone call kanye west^why pregnant kylie jenner decided stay spotlight^brad pitt 'has crying devastated angelina jolie surprise divorce^it war kylie jenner poses like sister kim kardashian insists queen^ed sheeran engaged girlfriend cherry seaborn^legally blonde actor luke wilson us golfer bill haas involved fatal car crash left one person dead^blake lively injured set the rhythm section causing production temporarily halted dublin ireland^khloe kardashian makes first public appearance since 'pregnancy news^justin bieber cancels remaining purpose world tour dates^justin bieber cancels remaining purpose world tour dates purposeworldtour^breaking meghan markle dad 'will not attend royal wedding prince harry major heart surgery'^breaking simon cowell rushed hospital accident london home^simon cowell rushed hospital accident london home^jay z admits marriage beyonce n't totally built truth^pippa middleton 'snubbed prince harry meghan mysteriously left wedding reception invite list^cardi b confirms secretly married offset last year^bedraggled jenniferaniston seen first time since justin theroux split pair prepare 240million sl^weinstein company 'left choice file bankruptcy,66,15,-51,81,0.8148148148148148,-0.6296296296296297,1
26340080,WFLANews,4118,16950,580,172860,0,16,42,22,"tampa bay news traffic weather station listen on-air online ,000 devices via",the maine centers disease control prevention released findings woods pond beach closed n^according centers disease control prevention created minimal risk possible eure h^life eectancy united states dropped third year row falling one tenth year y^the centers disease control prevention reported popular kellogg cereal linked sa^centers disease control prevention cdc issued statement aiming keep healthy holi^trump touted america first foreign policy fiery speech united nations tuesday slamming glob^first lady melania trump delivered first major interview abc news recent trip africa we^a shocking new poll published nbc news wall street journal shows republican enthusiasm mi^the centers disease control prevention says salmonella outbreak connected brand growing m^the maine centers disease control prevention released findings woods pond beach closed n^according centers disease control prevention created minimal risk possible eure h^life eectancy united states dropped third year row falling one tenth year y^centers disease control prevention cdc issued statement aiming keep healthy holi^john schnatter founder public face nationwide pizza chain papa john resigned chairman o^white house press secretary sarah huckabee sanders unloaded press pool daily briefing wednesday^the u.s. department agriculture food safety inspection service fsis says 're recalling^robert pattinson on movie roles 'people are trying to put you in a box^john mayer has been hospitalized emergency appendectomy^sag awards nominations see full list of screen actors guild nominees^american music awards nominations amas nominees full list^chris pratt files divorce from anna faris^sharon osbourne apologizes to justin bieber 'i was wrong to 'attack you^celebrities react nelsan ellis dead at^celebrities react trump withdraws steph curry white house invitation^celebrities react trump withdraws steph curry white house invitation^celebrity reaction jimmy kimmel monologue on las vegas shooting and guns^celebrity reaction jimmy kimmel monologue on las vegas shooting and guns^meghan markle prince harry eecting first child the happy news come began day tour to^celebrity reactions donald trump phoenix rally speech^jimmy kimmel talks donald trump harvey weinstein on 'gma^jimmy kimmel talks donald trump harvey weinstein on 'gma^stars celebrate rosh hashanah see celebrity tweets about jewish new year^katie couric said matt lauer pinched her on the ass on 'today back in^kendall jenner jealous ex^celebrities react to hurricane irma^katie holmes not pregnant and planning wedding with jamie foxx^lady gaga taylor kinney not secretly dating despite late and wrong report^sorry drake amp bella hadid are not 'secretly dating^kim kardashian sued for allegedly stealing lighting technique for selfies^kim kardashian sued for allegedly stealing lighting technique for selfies^ryan lochte charge dropped in rio robbery case^ryan lochte charge dropped in rio robbery case^kim kardashian slams cocaine claim 'i do not play with rumors like this^celebrity reactions prince harry meghan markle engaged^robert pattinson amp katy perry are not dating^beyonce birth twins still hospital 'minor issue^celebrities remember orlando pulse nightclub shooting victims one year later^joe jonas sophie turner 'already thinking of having kids is made up story^celebrities react nfl players kneel lock arms during national anthem^celebrities react nfl players kneel lock arms during national anthem^grammy awards see the full winners list^grammy awards see the full winners list^fans react u2 cancels st. louis concert amid police protests^jimmy fallon felt needed abandon usual jokes share heartfelt message charlottesville^jimmy fallon felt need to share 'heartfelt message about charlottesville^no zayn is not 'desperate to defend girlfriend gigi hadid^selena gomez reveals she had a kidney transplant amp her friend was her donor^obamas celebrate th anniversary after false split stories^here how help victims las vegas mass shooting^khlo kardashian makes her first public appearance since pregnancy news^crazy criminals report survivor jenna morasca arrested dui after allegedly biting cop^the bachelor bekah m was on missing persons list until fan recognized her^taylor swift teases new song 'gorgeous on instagram listen to a snippet^rachel mcadams is reportedly pregnant with her first child^hugh hefner cause death revealed^hugh hefner cause death revealed^hugh hefner cause death has been revealed^taylor swift teases new song 'gorgeous on instagram listen to a snippet^wfla entertainment news jenny slate and chris evans break up again^justin timberlake announces 'the man of the woods tour see the dates^star jones ex husband al reynolds comes out as bisexual in candid blog^'storm chasers star joel taylor dead at^jennifer lawrence darren aronofsky split^taylor swift announces new album 'reputation see the cover art^camila cabello announces her 'never be the same tour see the dates^gigi hadid slams body shamers for calling her 'too skinny at nyfw^'black panther is officially the most tweeted about movie of all time^netflix reportedly reviving carmen sandiego with gina rodriguez^see ya weinstein company file for bankruptcy after sex scandals^chris pratt files divorce from anna faris,42,38,-4,80,0.525,-0.05,1
2468647092,E_philippines,309,9583,33,13911,0,0,53,27,the official e online twitter philippines ch57 sky destiny digital ch61 cignal ch33 cablelink,how like meat little raw well done catch episode kuwtk tonight pm e^we dance without care kuwtk episodes repeat today plus tune e brand new^emotional rollercoaster even begin describe tune brand new kuwtk episode monday th nove^drama always rolling fam 've always held together keep kards brand new epis^which kardashian colour feeling today tune mondays brand new episodes kuwtk pm^drama house get latest deets kards brand new kuwtk episode monday pm e^no matter distance matter time kardashians bra^leave send energy way tune e catch brand new episode kuwtk tonigh^the fam always got backs catch brand new episode kuwtk happening tomorrow pm e^excited crazy blessed don miss koko baby shower monday october brand new kuwtk episode e^when comes fashion kim gets savage watch deal khloe kourtney latest kuwtk episode rep^scott disick malibu chili cook off saturday know his ex h^scott disick malibu chili cook off saturday know his ex h^what mean n't dating despite rumors appears true^younes bendjima spent holiday weekend together talked breakup being^shayla kevin revengebody transformations beyond inspirational follow journey tonight revenge b^it sure n't easy scott icymi catch latest kuwtk episode today pm e^we dance without care kuwtk episodes repeat today plus tune e brand new^skourt butting heads icymi catch beef repeat episode kuwtk e^something cooking icymi miss kim chef mode replay episode kuwtk today e 5pm^we never knew kards/jenners could sneaky tune new episode kuwtk next monday o^emotional rollercoaster even begin describe tune brand new kuwtk episode monday th nove^sister amp mom goals do n't miss new episode kuwtk tomorrow pm happening e khloekardashian^drama always rolling fam 've always held together keep kards brand new epis^tag someone needs deets kylie best kept secret stay tuned tomorrow new episode kuwtk^the kind variety show live icymi catch newest episode kuwtk tonight e 5pm.^which kardashian colour feeling today tune mondays brand new episodes kuwtk pm^japan meet glam kim werkin across kyoto new kuwtk tune tonight e pm^a fam plays together stays together catch latest kuwtk episode today stay tuned new episo^the fam taking break next monday catch latest kuwtk today e 0pm^kris answer problems what without tune kuwtk catch kris jenner life^drama house get latest deets kards brand new kuwtk episode monday pm e^the weekends rode pass us like chase mondayblues away tomorrow new kuwtk episode h^tough times always make way bigger better things do n't miss new kuwtk happening next monday october^leave send energy way tune e catch brand new episode kuwtk tonigh^the baby landed tune kuwtk tonight baby chi first episode e pm kourtneykardashian^kris clearly scott biggest critic tune catch episodes kuwtk tonight pm look new^kourtney kardashian literally us icymi catch newest kuwtk episode tomorrow pm e^alright fam make guess ... shocked get answers kuwtk tonight pm e^can guess said scott do n't miss new episode kuwtk tomorrow pm kimkardashian^who one true guardian khloe eyes find tomorrow episode kuwtk pm e^the fam always got backs catch brand new episode kuwtk happening tomorrow pm e^excited crazy blessed don miss koko baby shower monday october brand new kuwtk episode e^when comes fashion kim gets savage watch deal khloe kourtney latest kuwtk episode rep^despite contentious custody battle bradpitt angelinajolie maintains role international peacekee^tonight episode kuwtk incredibly emotional khloe advice everyone watching^leave ride die sister looks like khlo leaning sisters ever tonight^no matter day time place family comes first kardashians tune new kuwtk episode toni^scott disick malibu chili cook off saturday know his ex h^scott disick malibu chili cook off saturday know his ex h^kylie struggles pressures spotlight watch lifeofkylie episodes today pm onl^it sure n't easy scott icymi catch latest kuwtk episode today pm e^kourtney kardashian scott disick are back together after year half apart kuwtk^it relationship rocks jenner confirms n't spoken long time^he host returning host oscars awards^wags miami stars ashley nicole roberts marries philip wheeler^brie larson reveals emma stone jennifer lawrence aved life '' celebrities^how kim kardashian kanye west are trying give north west normal life^kyliejenner sparks engagement rumors with giant diamond ring^gal gadot chris hemsworth spar social media over whether wonder woman thor would win fight^blac chyna fearful rob kardashian next move what else could^rachelmcadams pregnant first child feeling going regular mom go^theweeknd deletes selenagomez social media^ryan reynolds best response wonder woman beating deadpool^julianne moore zoe saldana sia team raise awareness hiv/aids^how preparing make big splash pippa middleton wedding^blac chyna granted temporary restraining order rob kardashian^chrisbrown recalls night assaulted rihanna i felt like f king monster^world ugliest dog is english bulldog zsa zsa ugliestdogcontest worldsugliestdog^here ben platt became broadway pitch perfect man^cristianoronaldo girlfriend georginarodriguez gives birth th baby^struggling zip outfit anyone ever tried clothes^arianagrande makes triumphant musical return with no tears left cry^nikkibella wanted include breakup johncena upcoming season totalbellas show fans th^did scott disick send kourtney kardashian bella thorne flowers day we 're saying chance..^scott disick makes two women las vegas catch kuwtk full season marathon e^travisscott facetimes kyliejenner during nyc performance amid pregnancy reports^selena gomez new los angeles home totally affordable by hollywood standards least^jennifer garner sets record straight ben affleck divorce story mom garden club lights phone^playmates playboy models recreate iconic covers decades later,53,27,-26,80,0.6625,-0.325,1
34655603,TheSun,382,1522361,7338,462747,4,2,58,15,news website year never miss story news sport entertainment happens give us like facebook,nasa wants pay someone 12k stay bed days ... apply^is snapchat shutting truth behind rumours^is snapchat shutting truth behind rumours^rt is snapchat shutting end year the truth behind rumours^man one four world throat rotted away cocaine^family mum whose four kids died petrol bomb arson blaze hold christmas vigil remains ill hospita^here jennifer aniston justin theroux biggest custody battle completely understand^here jennifer aniston justin theroux biggest custody battle completely understand^goldie hawn says marriage would split years partner kurt russell^harry styles secretly dating naked chef blogger tess ward^brad pitt angelina jolie split huge 200million fortune ever divorce signing pre nup^psychic twins claim princess diana warned prince harry meghan markle future^psychic twins claim princess diana warned prince harry meghan markle future^ed sheeran cherry seaborn go double date courteney cox johnny mcdaid eyes cherry^revealed the real reason jennifer aniston justin theroux split^revealed the real reason jennifer aniston justin theroux split^liam payne makes touching admission split cheryl^cheryl reveals refused move liam payne split^liam payne makes light split cheryl^liam payne opens split cheryl first time^miley cyrus liam hemsworth 'call wedding 'not ready baby^the durrells josh o connor play prince charles the crown series three^thecrown films moment young prince charles camilla parker bowles fell love^ed sheeran cherry seaborn go double date courteney cox johnny mcdaid eyes cherry^kendall jenner responds pregnancy rumors fans claim sporting baby bump selfie^exclusive drake secretly hooking walsall singer jorja smith^kim kardashian left fuming kanye west tries control puts instagram^how last minute dash h amp m helped land meghan markle job suits^kim kardashian upset kanye west announces moving chicago tells never leave la^meghan markle prince harry didn t announce baby news princess eugenie wedding^katy perry throws shade taylor swift americanidol auditions^brad pitt pal says angelina till loves despite begging judge divorce^the eye watering amount david beckham earns month^angelina jolie dad breaks silence split brad pitt^angelina jolie breaks silence marriage split brad pitt^angelina jolie dad breaks silence split brad pitt^angelina jolie dad breaks silence split brad pitt^kendall jenner responds pregnancy rumors fans claim sporting baby bump selfie^kim kardashian furious kanye west quit politics family poured millions dollars venture^six secret lovers prince harry bride meghan markle revealed^kylie jenner misses american music awards dog goes labour^meghan markle brother pens heartfelt letter urging sister get touch father^kar dashing aisle secretly planning wedding kanye west..^prince harry meghan markle moving secret tribute princess diana^prince harry meghan markle pay moving secret tribute princess diana^prince harry meghan markle pay moving secret tribute princess diana flowers^celebrities react death linkin park singer chester bennington^angelina jolie brad pitt 'headed court battle latest divorce row^david beckham splashes 3m buy london pub mate guy ritchie ... whole new makeover plan^pride of britain viewers swoon david beckham surprises guest^david beckham abseils cliff 'insensitive comments left wife victoria tears^intimate details angelina jolie brad pitt elosive marriage breakdown revealed big screen^angelina chokes speaks breakdown marriage brad pitt^intimate details angelina jolie brad pitt elosive marriage breakdown revealed big budget movie^angelina chokes speaks breakdown marriage brad pitt^here jennifer aniston justin theroux biggest custody battle completely understand^here jennifer aniston justin theroux biggest custody battle completely understand^katy perry throws shade taylor swift americanidol auditions^kim kardashian leaves nothing imagination date night kanye west^kim kardashian leaves little imagination latest selfie^revealed why devastated angelina jolie finally dumped husband brad pitt^revealed why devastated angelina jolie finally dumped husband brad pitt^revealed why devastated angelina jolie finally dumped husband brad pitt^revealed why devastated angelina jolie finally dumped husband brad pitt^neil diamond retires touring parkinson disease diagnosis^prince harry asks prince william best man^boardwalk empire star paz de la huerta accuses harvey weinstein raping twice^tina turner son craig found dead aged apparent suicide california home^hugh hefner cause death revealed^meghan dad will attend royal wedding ... going hard^exclusive meghan dad will attend royal wedding ... going hard^picture exclusive meghan markle dad gets measured royal wedding suit confirmed parents^actor ed westwick accused sexual assault third woman^here everything need know return twinpeaks^michael fassbender alicia vikander spotted honeymoon italy secret ibiza wedding^eva longoria gives birth baby boy adorable name^eva longoria gives birth baby boy adorable name^ed sheeran fiancee cherry seaborn flashes new engagement ring^ed sheeran fiancee cherry seaborn flashes huge engagement ring,62,17,-45,79,0.7848101265822784,-0.569620253164557,1
14791162,wmag,300,1494560,11750,123395,0,0,63,16,w magazine volume six the new originals,kellyanne conway told fox viewers go buy ivanka stuff^kristen stewart tried every shade bleach blond deep brunette^kristen stewart tried every shade bleach blond deep brunette^kristen stewart tried every shade bleach blond deep brunette^kristen stewart tried every shade bleach blond deep brunette^kristen stewart tried every shade bleach blond deep brunette^kristen stewart tried every shade bleach blond deep brunette^kristen stewart tried every shade bleach blond deep brunette^kristen stewart tried every shade bleach blond deep brunette^kristen stewart tried every shade bleach blond deep brunette^kristen stewart tried every shade bleach blond deep brunette^kristen stewart tried every shade bleach blond deep brunette^kate middleton new baby already left hospital^kanye west shared test convo caitlyn jenner twitter^caitlyn jenner reached kanye thank via text message^kim kardashian kanye west taking rest wish could^kim kardashian kanye west taking rest wish could^kim kardashian kanye west taking rest wish could^kim kardashian kanye west taking rest wish could^birthday girl sofia richie shares secrets behind fashion choices^miley cyrus liam hemsworth going private breakup rumors^caitlyn jenner memoir tearing house kardashian asunder^caitlyn jenner memoir tearing house kardashian asunder^caitlyn jenner memoir tearing house kardashian asunder^caitlyn jenner memoir tearing house kardashian asunder^caitlyn jenner memoir tearing house kardashian asunder^it involves prince charles prince philip thecrown^it involves prince charles prince philip thecrown^it involves prince charles prince philip thecrown^the friendship birthday boy justin theroux fab elained^officially done love^we feeling selena gomez n't heartbroken surrendering title^we feeling selena gomez n't heartbroken surrendering title^birthday girl sofia richie shares secrets behind fashion choices^opens movie makes cry^hailee steinfeld responds rumor dating justin bieber^hailee steinfeld responds 'crazy rumor dating justin bieber^nicole kidman hung aquaman comiccon2018^timoth e chalamet selena gomez rebecca hall donated salaries film charity^elle fanning star woody allen new film^elle fanning star woody allen new film^shortly rebecca hall pledged donate salaries looks like might be^pre oscars week reunited martinis^pre oscars week reunited martinis^pre oscars week reunited martinis^elle fanning star woody allen new film^julia roberts completed instagram milestone^both styles held back one answer co interview^rachelweisz gave birth baby girl first child husband danielcraig^rachel weisz gave birth daughter first child husband daniel craig^rachel weisz daniel craig welcomed first child together daughter^khlo kardashian relived relationship drama tristan thompson latest kuwtk episode^khlo kardashian relived relationship drama tristan thompson latest kuwtk episode^kanye west reportedly opening restaurant calabasas^the friendship birthday boy justin theroux fab elained^jennifer lawrence terrified^birthday girl sofia richie shares secrets behind fashion choices^birthday girl sofia richie shares secrets behind fashion choices^ariana grande pete davidson a quick timeline their relationship^ariana grande pete davidson a quick timeline relationship^reportedly made decision return rightful place spotlight^justin bieber selena gomez may broken good time^selena gomez rumored receiving treatment suffering emotional breakdown^alicia vikander friends kidnapped bachelorette party^jada pinkett smith calls tupac biopic deeply hurtful^jada pinkett smith calls tupac biopic deeply hurtful^jennifer lopez alex rodriguez n't forcing marriage time soon^real couple break^summer phoenix files divorce casey affleck^victoria secret supermodel evaluating career i take clothes anymore for^victoria secret supermodel evaluating career i take clothes anymore for^victoria secret supermodel says i take clothes anymore empty cause^the rumors true alicia vikander michael fassbender officially married^bradley cooper irina shayk welcome first child^this n't first time called redesign^this n't first time called redesign^it time babies chill kirsten dunst delightfully candid future plans^gigi hadid zayn malik break years dating read supermodel pop star dual statements here^blake griffin reportedly never serious,63,16,-47,79,0.7974683544303798,-0.5949367088607594,1
22150977,redbookmag,1632,70734,1100,61649,0,1,42,35,style beauty health home,the most popular unique baby names every state^reese witherspoon teases very first details 'legally blonde^kim kardashian seems miserable following kanye west hospitalization^angelina jolie is secretly dating handsome older guy^megyn kelly gives powerful statement matt lauer being fired from 'today show^a definitive timeline prince harry meghan markle relationship^kris jenner humongous closet is craziest thing you 'll see today^kris jenner humongous closet is craziest thing you 'll see today^did pippa middleton ban meghan markle from her wedding^kris jenner 'keeping up kardashians house is sale^brad pitt is committed having healthy relationship with angelina jolie^brad pitt committed man bob where angelina jolie oscars^taylor swift is countersuing just 1 her sexual assault trial^kris jenner 'keeping up kardashians house is sale^trump has no idea why civil war happened twitter has field day^someone just confirmed that katie holmes jamie foxx are dating^dakota johnson chris martin are officially dating^the crown season coming princess diana introduced^the crown season coming princess diana introduced^the crown season coming princess diana introduced^the crown season coming princess diana introduced^the crown season coming princess diana introduced^a new report details fight that led brad pitt angelina jolie divorce^a new report details fight that led brad pitt angelina jolie divorce^outfits that prove kate middleton meghan markle are total style twins^the internet is freaking out over kate middleton wearing sweatpants^the internet is freaking out over kate middleton wearing sweatpants^meghan markle might have dropped the biggest hint she moving to the uk for prince harry^a new report details fight that led brad pitt angelina jolie divorce^a new report details fight that led brad pitt angelina jolie divorce^ryan seacrest texted kris jenner ask about kylie pregnancy live tv here what she wrote back^kylie jenner could not look more bored by ryan reynolds at met gala if she tried^apparently amal is leaving george clooney^apparently amal is leaving george clooney^apparently amal is leaving george clooney^apparently amal is leaving george clooney^apparently amal is leaving george clooney^apparently amal is leaving george clooney^apparently amal is leaving george clooney^one iconic photographs prince harry meghan markle royal wedding fascinating bac^one iconic photographs prince harry meghan markle royal wedding fascinating bac^kate middleton prince william a timeline their relationship^selena gomez reveals she had kidney transplant over summer^enrique iglesias anna kournikova welcome twins after dating years^enrique iglesias anna kournikova welcome twins after dating years^enrique iglesias anna kournikova welcome twins after dating years^enrique iglesias anna kournikova welcome twins after dating years^enrique iglesias anna kournikova welcome twins after dating years^dance moms star abby lee miller sentenced one year in prison^'dance moms star abby lee miller has been sentenced one year in prison^ashton kutcher pays tribute mila kunis their kids in an emotional heartwarming speech^meghan markle arrives in london ahead pippa middleton wedding^prince charles will walk meghan markle down aisle royal wedding^rachel mcadams is pregnant with her first child^rachel mcadams is pregnant with her first child^rachel mcadams is pregnant with her first child^rachel mcadams is pregnant with her first child^steph ayesha curry are eecting baby no^steph ayesha curry are eecting baby no^steph ayesha curry are eecting baby no^steph ayesha curry are eecting baby no^kim kardashian shares first photo baby chicago west^kim kardashian shares first photo baby chicago west^kim kardashian shares first photo baby chicago west^kim kardashian shares first photo baby chicago west^everything we know about pippa middleton wedding dress so far^everything we know so far about pippa middleton wedding^kaley cuoco marries karl cook intimate horse ranch wedding^discovery channel 'storm chasers star joel taylor dead^discovery channel 'storm chasers star joel taylor dead^discovery channel 'storm chasers star joel taylor dead^discovery channel 'storm chasers star joel taylor dead^princess charlotte net worth is more than prince george here why^meghan markle prince harry did n't sit together at pippa middleton wedding^meghan markle prince harry did n't sit together at pippa middleton wedding^meghan markle prince harry did n't sit together at pippa middleton wedding^bradley cooper irina shayk welcome their first child^the sisterhood traveling pants cast reunited amber tamblyn directorial debut,42,36,-6,78,0.5384615384615384,-0.07692307692307693,1
32469566,harpersbazaarus,887,1683544,10320,99224,0,2,39,36,the official twitter feed harper bazaar daily source fashion beauty culture royals,read full transcript barack obama speech john mccain funeral^read full transcript barack obama speech john mccain funeral^a complete timeline katie holmes jamie foxx rumored relationship^kris caitlyn jenner reportedly interact when they have to their kids^david victoria beckham shut down rumors that they 're getting divorce^a definitive timeline miley cyrus liam hemsworth relationship^a definitive timeline miley cyrus liam hemsworth relationship^a definitive timeline miley cyrus liam hemsworth relationship^a definitive timeline prince harry meghan markle relationship^a definitive timeline prince harry meghan markle relationship^channing tatum jenna dewan announce split after almost years marriage^justin bieber reveals real reason relationship selena gomez fell apart^every photo kate middleton first official engagement after maternity leave^how kate middleton first appearance with royal baby no compares george charlotte debuts^katie couric breaks silence matt lauer firing 'today show^emma stone is vacation justin theroux south france^prince george is reportedly getting more security following isis threat^we fighting back we taking we need brad pitt come save us we badasses.^ryan reynolds responds rumors his marriage blake lively is in trouble^julia roberts november cover star america favorite pretty woman talks facing fears liv^shows major baby bump instagram^shows baby bump instagram^emma stone is vacation justin theroux south france^jennifer lopez new boyfriend and 'll definitely recognize^channing tatum jenna dewan announce split after almost years marriage^the full list winners golden globes^caitlyn jenner skipped son brody jenner wedding so did kendall kylie^how kourtney kardashian really feels about her younes bendjima breakup^shows major baby bump instagram^shows baby bump instagram^outfits prove kate middleton meghan markle are total style twins^kris caitlyn jenner reportedly interact when they have to their kids^meghan markle will take over one queen elizabeth royal duties^selena gomez amp justin theroux may be more than just friends^meghan markle kate middleton are going wimbledon together we 're so excited^never forget kylie jenner looking epically bored ryan reynolds^selena gomez amp justin theroux may be more than just friends^a complete timeline katie holmes jamie foxx rumored relationship^prince harry chose meghan markle processional song royal wedding^prince harry meghan markle talk about hidden details prince george princess charlotte royal weddin^ryan reynolds just shut down blake lively split rumors again some epic trolling^prince harry meghan markle left empty seat princess diana royal wedding^lea michele is engaged zandy reich^meghan markle will not have maid honor royal wedding^who is jessica mulroney meghan markle best friend might be maid honor royal wedding^prince charles will walk meghan markle down aisle royal wedding^kim kardashian returns paris first time since her robbery^ryan reynolds responds rumors his marriage blake lively is in trouble^after announcing yesterday longer attending royal wedding meghan markle father says wa^meghan markle dad will not attend royal wedding after suffering heart attack^prince william recreates one kate middleton childhood photos jordan^tyra banks admits she got nose job early her career^outlander was just renewed seasons^karlie kloss is engaged joshua kushner^kaley cuoco marries karl cook intimate horse ranch wedding^who is phil elverum things know about michelle williams new husband^khlo kardashian reveals her biggest parenting fear^another royal wedding way here everything need know princess eugenie jack brooksban^another royal wedding way here everything need know princess eugenie jack brooksban^another royal wedding way here everything need know princess eugenie jack brooksban^another royal wedding way here everything need know princess eugenie jack brooksban^another royal wedding way here everything need know princess eugenie jack brooksban^princess eugenie jack brooksbank royal wedding everything you need know^another royal wedding way here everything need know princess eugenie jack brooksban^another royal wedding way here everything need know princess eugenie jack brooksban^another royal wedding way here everything need know princess eugenie jack brooksban^game thrones actors kit harington rose leslie are getting married very soon^gigi bella hadid stylish sister moments^gigi bella hadid stylish sister moments nationalsiblingsday^meghan markle reportedly approves priyanka chopra nick jonas engagement^eva longoria gives birth baby boy^tbt betty white the golden girls star a 'clueless parody^tbt betty white the golden girls star a 'clueless parody^tbt betty white the golden girls star a 'clueless parody^we spotlight best runway looks standout collections new york fashion week spring^will prince william be prince harry best man royal wedding^it official prince william will be prince harry best man royal wedding,39,38,-1,77,0.5064935064935064,-0.012987012987012988,1
807095,nytimes,900,44174792,200777,372703,1,47,18,9,news tips share `` the weekly '' new tv series episodes air sundays p.m. fx hulu next day,for many jews america pittsburgh synagogue massacre shocking wake call^transcript democratic presidential debate hillary clinton bernie sanders^transcript democratic presidential debate^missed last night democratic debate here transcript^emmanuel macron spoke critically trump foreign policy trade environmental decisions speech congre^senator elizabeth warren major foreign policy speech cited need rein unsustainable ill advise^rudy giuliani lawyer president trump said interviews even trump collude russians h^here transcript first presidential debate^the transcript president trump first address joint session congress^the transcript president trump first address joint session congress^the video transcript president trump first address joint session congress^missed last night democratic debate here transcript^read full transcript sunday night democratic debate charleston^read full transcript sunday night democratic debate charleston^transcript democratic presidential debate hillary clinton bernie sanders^transcript democratic presidential debate^here transcript democratic debate miami^read full transcript barack obama speech south africa^read full transcript barack obama speech south africa^the long run response /11 offers outline mccain doctrine^the caucus arizona republican debate live blog^the caucus live blog republican debate jacksonville fla^the caucus live blog republicans meet florida tea party debate^the caucus obama press conference live blog^the caucus myrtle beach debate live blog^the caucus live blog the panetta confirmation hearing^the caucus michigan arizona primaries live blog^the caucus iowa debate live blog^the caucus charleston s.c. debate live blog^the caucus new hampshire debate live blog saturday night^the caucus illinois primary live blog^the caucus south carolina primary live blog^the caucus florida primary live blog^the caucus live blog obama cameron news conference^the caucus tampa debate live blog^the caucus live blog the panetta confirmation hearing^the caucus wisconsin recall election live blog^the caucus fox news debate live blog^the caucus alabama mississippi primaries live blog^the caucus wisconsin maryland d.c. primaries live blog^the caucus new hampshire primary live blog^the caucus south carolina debate live blog^the caucus live blog the state union^nyt markets reporter writes economists starting look whether rise called s^your daily briefing big business still torn saudi arabia the white house plans new midd^missed week top stories confused happened last week here weekend briefing^the resignation john kelly leaves one president trump four generals white house^in opinion op ed contributor cindi leive writes no woman owes anyone answer whether t.^go buy ivanka stuff i would say kellyanne conway said ethics eerts called violation^the complete list winners golden globes^the complete list winners golden globes^the complete list winners golden globes^a complete list winners emmy awards^a complete list winners emmy awards^a complete list winners emmy awards^trump frequently used n word host celebrity apprentice according new memoir omaro^how i learned tolerate blake lively^how wedding prince harry meghan markle might affect bridal trends come^how wedding prince harry meghan markle might affect bridal trends come^how wedding prince harry meghan markle might affect bridal trends come^how wedding prince harry meghan markle might affect bridal trends come^here kanye west said slavery mental health obama new interviews^here kanye west said slavery mental health obama new interviews^the kardashians picked right simpsons left launched reality show e no^the kardashians picked right simpsons left launched reality show e no^the kardashians picked right simpsons left launched reality show e no^prince harry engaged american actress meghan markle one nyt reader reaction news.^sure great movies plays tv shows year people here bes^here best tv shows^here best tv shows^the movies plays tv shows great people morris chooses the^here best tv shows according critics^another year brought another embarrassment tv riches here best tv shows according criti^here best tv shows according critics^pictures pippa middleton marries james matthews,19,56,37,75,0.2533333333333333,0.4933333333333334,0
450941680,ThisWeekABC,1143,173767,2221,83289,0,68,2,4,the official twitter account news this week hosted,"director national intelligence dan coats says wishes pres trump made different statement russia e^director national intelligence dan coats says wishes pres trump made different statement russia e^new pres trump joint statement european commission pres jean claude juncker we agree today first of^pelosi says gop efforts impeach rosenstein make statement pres trump law the attack^should concerned infrastructure u.s. italy deadly bridge collapse tells^memory lapse donald trump seeks distance advisor past ties mafia^new in second critical statement many days sen. ben sasse says following pres trump trade war tweet^a new report centers disease control prevention finds abortions lowest rate since^a new report centers disease control prevention finds abortions lowest rate since^the centers disease control prevention warn u.s. canadian consumers eat romaine lettuce^the centers disease control prevention cdc warns dressing pet chickens halloween^a new report centers disease control prevention finds abortions lowest rate since^republican rep. duncan hunter wife margaret pleaded guilty misusing 250,000 campaign funds to^republican rep. duncan hunter wife margaret pleaded guilty misusing 250,000 campaign funds to^is rudy giuliani recommending pres trump agree interview special counsel mueller i want keep an^rudy giuliani conditions pres trump interview special counsel robert mueller we 've ev^as president trump legal team sets new conditions interview robert mueller goes one^pres trump personal attorney rudy giuliani says trump legal team close determining president^stormy daniels attorney calls giuliani interview absolute unmitigat^watch full must watch interview pres trump attorney rudy giuliani^this week george stephanopoulos airs p sunday wabc new york due nyc marathon tune and^happening now we 're days midterm elections abc news political director breakin^there number key inconsistencies story 're given abc news says saudi ara^jpmorgan chase ceo jamie dimon tells abc news chief business correspondent u.s. tr^watch live as national debate immigration heats democratic strategist former new je^this truly horrific scene abc news reports pittsburgh community grappl^there number key inconsistencies story 're given abc news says saudi ara^as special counsel holds plea deal talks jerome corsi associate trump ally roger stone^sunday special edition 'this week joined abc news powerhouse political team member^happening now all eyes pres trump prepares make nomination fill supreme court vacancy le^former nj abc news chief legal analyst join morning discuss ne^sources tell news michael cohen claims pres trump knew advance june trump tower meetin^as special counsel holds plea deal talks jerome corsi associate trump ally roger stone^ten years financial crisis abc news chief business correspondent sat jpmorgan^new first lady melania trump plans visit another center housing migrants point week spokesperson^sunday anchors special edition 'this week abc news midterm election hq and^congress averted partial government shutdown week real fight begins border wall fundin^president donald trump job approval rating advanced second highest career new abc news/washing^this morning what issues voters care election and party trust handle tho^how region reacting singapore summit talks wsj seoul bureau ch^i n't said jpmorgan chase ceo jamie dimon tells abc news n't bragge^pres trump made least eight public statements week true supported known ev^which party likely voters favor headed midterm elections results f^president donald trump job approval rating advanced second highest career new abc news/washing^pres trump made least eight public statements week true supported known ev^president tump says send written answers special counsel robert mueller week signals h^as mueller investigation hits one year mark harvard law prof emeritus news chief legal^president donald trump job approval rating advanced second highest career new abc news/washing^how could president trump nominee replace justice kennedy change supreme court ideological balance abc^with new congress set come washington abc news joins thisweek off set break th^hhs secretary alex azar tells abc news president trump one hundred percent clear w^pres trump hugged american flag conclusion remarks national federation independent busi^a new report centers disease control prevention finds abortions lowest rate since^a new report centers disease control prevention finds abortions lowest rate since^the centers disease control prevention warn u.s. canadian consumers eat romaine lettuce^the centers disease control prevention cdc warns dressing pet chickens halloween^a new report centers disease control prevention finds abortions lowest rate since^just in pres trump signs new executive order protection nation foreign terrorist entry into^alert news special report vice president biden makes statement rose garden^happening now pres trump holds campaign rally las vegas nevada^outgoing ohio gov john kasich tells considering run president trump se^outgoing ohio gov john kasich tells considering run president trump se^outgoing ohio gov john kasich tells considering run president trump se^fifty years heroism vietnam war retired marine sgt maj. john l. canley receives medal of^outgoing ohio gov john kasich tells considering run president trump se^while delivering keynote speech touting republican tax cuts cincinnati ohio vice president mike pence sa^one two turkeys appealing thanksgiving pardon pres trump appears white house press briefi^read transcript exclusive interview former trump attorney fixer michael cohen^oprah winfrey actively considering running president close friend gayle king says.^oprah winfrey actively considering running president close friend gayle king says.^ivanka trump closing shop eponymous fashion brand she said wanted focus policy wor^law amp order svu star diane neal running congress new york^law amp order svu star diane neal running congress new york^the supreme court declines hear appeal brendan dassey whose murder conviction subject net",2,72,70,74,0.027027027027027032,0.945945945945946,0
20459890,deannacruz,1917,7024,87,45854,0,0,16,58,radio host fashionista crossfit lover,kim kardashian begs tristan thompson unblock her instagram^chris pratt files divorce from anna faris^matt lauer says he 'an easy mark in combative first interview since today show exit^maddie poppe wins season american idol via^is beyonce pregnant again fans are buzzing about possible baby bump tour^kim kardashian welcomes third child via surrogate with kanye west^kris jenner stand house keeping up kardashians sells after years market^kim kardashian says having three kids left her 'fully neglecting kanye west^kylie jenner gives birth welcomes first child with travis scott^kylie jenner gives birth welcomes first child with travis scott^kylie jenner gives birth welcomes first child with travis scott^brad pitt is 'absolutely smitten with mit professor neri oxman^shots fired tekashi ix9ine kanye west nicki minaj music video set^rihanna hassan jameel latest date night shuts down split rumors^grammy awards winners the complete list^kim kardashian elains her selfie obsession^ronnie ortiz magro ex jen harley arrested domestic battery after allegedly dragging him with car^blac chyna devastated revenge porn why she sent video herself kissing another man rob kardashian^anna kournikova enrique iglesias welcome twins after secret pregnancy^sharon osbourne reveals ozzy actually cheated her with six women^stranger things officially renewed season^pink graces cover people beautiful issue her two kids^rose byrne is pregnant with her second child^ed sheeran says beyonc amp 233 changes her email address every week^ed sheeran says beyonc amp 233 changes her email address every week^ed sheeran engaged girlfriend cherry seaborn^jamie foxx host bet awards^channing tatum jenna dewan have ''sunday funday '' with daughter^halle berry exact diet workout regimen revealed^will elsa get girlfriend frozen^tiffany haddish brad pitt agree hook up if they 're single^justin bieber breaks his silence hailey baldwin engagement^alicia silverstone husband christopher jarecki split after years together^john cena says he wants kids with nikki bella month after split^what know about princess diana tragic death years ago^demi lovato is 'awake with her family after apparent overdose rep says^jeopardy host alex trebek recovering from brain surgery^justin timberlake gets philosophical with stephen colbert^lollapalooza music festival evacuated due weather^cardi b shows ellen degeneres how she got pregnant^taylor swift skips annual th july party no sign squad^meghan markle flashes her engagement ring from prince harry^nelly under criminal investigation sexual assault^antonio banderas shaves his head his eyebrows^mac miller has broken his silence on his breakup with ariana grande and her engagement^james corden wife julia carey welcome third child together^james corden wife julia carey welcome third child together^chrissy teigen gives birth baby no with john legend^meghan markle confirms father attend royal wedding^dwayne johnson reveals what was behind his feud with vin diesel^miley cyrus cries writing hillary clinton thank you note^ed sheeran shares secret struggle with substance abuse^shailene woodley nearly quit acting before big little lies^justin timberlake announces man woods north american tour dates^jt is back justin timberlake announces new album man woods sneak peek video^long island medium theresa caputo husband larry split^hugh grant welcomes baby no with girlfriend anna eberstein^cardi b performs billowy metallic dress miami club^inside eva longoria star studded pajama themed baby shower^brooke burke files divorce from david charvet after years together^nick jonas priyanka chopra are engaged after months dating^roseanne revival premiere date revealed^celine dion poses naked 'vogue via^kim kardashian attends her year high school reunion^katharine mcphee david foster are engaged^khloe kardashian plays coy over kylie jenner pregnancy rumors^paris jackson shares rare home movie from her childhood^john cena nikki bella split after six years^the girls girls star golden girls parody via^meryl streep joins 'big little lies season^grammy awards winners the complete list^julia roberts acts out her movies under minutes^kim kardashian kicks off weekend with more nude sexy photos^chris pratt files divorce from anna faris,16,58,42,74,0.21621621621621626,0.5675675675675675,0
14143624,socialitelife,3047,21202,628,79445,0,0,41,33,celebrity news gossip man candy product picks,angelina jolie admits she amp brad pitt fight a lot kylie jenner amp tyga getting married celeb news in six clicks^angelina jolie is secretly dating handsome older guy^queen labordayweekend^dancing mykonos glorious meme^get ready another round baby bump pics pregnant rd child^chris pratt files divorce anna faris^wants know jenner getting along fine ... even wife^remember joined instagram posted photo lady crush^officially instagram posting new lady crushing^remember joined instagram posted photo lady crush^golden globes the complete winners list^their reps claiming story false demi lovato and ryan phillippe were hot and heavy for three months^did convert islam^baftas red carpet arrivals winners list^baftas red carpet arrivals winners list^brad pitt talks quitting drinking divorce fighting kids^brad pitt talks quitting drinking divorce fighting kids^caitlyn jenner considering bid us senate california^caitlyn jenner considering bid us senate california^in morning brief blasts sharing location home amidst stalker concerns plus^good riddance friendship final nail coffin amp jay z friendship kanye west is^listen lets read apologetic texts^matthew mcconaughey it time embrace^channing tatum jenna dewan announce separation^ladies bringing sexy an^billboard music awards nominations see full list^get ready another round baby bump pics pregnant rd child^love still air seen leaving katie holmes apartment new yo^they ca n't quit but shhhh seen leaving katie holmes a^in today end notes chris double date halloween plus news featuring^in today end notes announce first tour dates decade news featuring^love still air seen leaving katie holmes apartment new yo^they ca n't quit but shhhh seen leaving katie holmes a^katie holmes jamie foxx enjoy top secret birthday getaway mexico^angelina jolie brad pitt reportedly going battle together custody trial while claimed^in morning brief blasts sharing location home amidst stalker concerns plus^good riddance friendship final nail coffin amp jay z friendship kanye west is^did convert islam^ladies bringing sexy an^reportedly hospitalized suffering emotional breakdown^reportedly hospitalized suffering emotional breakdown^surprise enrique iglesias anna kournikova welcome twins^it official named new new live co host^it official named new new live co host^sanaa lathan sara foster both deny biting beyonc face^luann de lesseps accuses russell simmons groping her elevator 'he was just pig^ian somerhalder paul wesley vampire diaries reunion photo sparks social media frenzy e news^zac efron goes shirtless christmas hike e news^blake lively injured set 'the rhythm section^april giraffe finally gives birth new york zoo global audience delight^jennifer hudson confirmed star aretha franklin biopic e news^it looks like may actually child jessica simpson tells friends i pregnant again photos^'superman star margot kidder dead^tina turner oldest son craig dead apparent suicide ny daily news^responds haters 'if want f**k bring game^responds haters 'if want f**k bring game^sarah silverman michael sheen break up^pink battling flu before super bowl performance^the chainsmokers alex pall says he miserable amid cheating allegations e news^sofia richie breaks up with scott disick amid cheating rumors^kim cattrall issues plea find missing brother christopher cattrall e news^justin timberlake announces new album man woods^outlander renewed seasons starz thebestnewsoftheday^kaley cuoco marries karl cook romantic ceremony see their wedding photos^kylie jenner gives birth first child with travis scott e news^carrie fisher cocaine ecstasy heroin methadone system autopsy reveals^katy perry her 'darling orlando bloom meet pope francis vatican city^in week newsletter demi lovato overdose turns trump^andy cohen crashes tv reporter taping jokes he shameless camera whore e news^enrique iglesias anna kournikova share first photos their twins^billboard music awards nominations see full list^meryl streep joins big little lies season variety^oscars see complete winners list^chris pratt files divorce anna faris,41,33,-8,74,0.5540540540540541,-0.10810810810810813,1
29459494,entertainmentIE,1125,44804,474,145690,0,0,42,32,always,channing tatum jenna dewan split years marriage^watch sarah jessica parker says 'sex city may happen without samantha^golden globes the complete winners list movies^golden globes the complete winners list tv^golden globes the complete winners list tv^golden globes the complete winners list tv^golden globes the complete winners list movies^celebrities react donald trump inauguration^celebrities react donald trump inauguration^netflix 'the crown cast prince charles queen mother season three^netflix 'the crown cast prince charles queen mother season three^netflix 'the crown cast prince charles queen mother season three^alec baldwin says justin bieber niece hailey baldwin already married^alec baldwin says justin bieber niece hailey baldwin already married^alec baldwin claims justin bieber niece hailey baldwin already married^alec baldwin claims justin bieber niece hailey baldwin already married^donald trump kicked one direction one hotels refusing meet daughter^channing tatum jenna dewan split years marriage^pic rihanna laughing stretch marks makes us love even^watch katy perry keeps taylor swift feud going comments american idol^watch katy perry keeps taylor swift feud going comments american idol^watch katy perry keeps taylor swift feud going comments american idol^watch katy perry keeps taylor swift feud going comments american idol^angelina jolie reportedly involved bizarre plot arrest joseph kony^the film romantic comedy starring timothee chalamet selena gomez^rachel weisz amp daniel craig welcomed first baby together^rachel weisz gives birth first child daniel craig^rachel weisz amp daniel craig welcome first baby together^rachel weisz daniel craig welcomed first baby together^watch stephen colbert joyously reacts donald trump telling 'filthy 'a talent guy'^watch stephen colbert reacts donald trump telling 'filthy 'a talent guy'^donald trump lashes stephen colbert what says filthy^donald trump lashes stephen colbert what says filthy^watch stephen colbert joyously reacts donald trump telling 'filthy 'a talent guy'^selena gomez reveals kidney transplant thanks organ donor best friend touching post^selena gomez reveals kidney transplant thanks organ donor best friend touching post^watch katy perry keeps taylor swift feud going comments american idol^watch katy perry keeps taylor swift feud going comments american idol^watch katy perry keeps taylor swift feud going comments american idol^watch katy perry keeps taylor swift feud going comments american idol^robert pattinson charlie hunnam star elorers the lost city z friday read review^robert pattinson charlie hunnam star elorers the lost city z friday read review^prince harry asks william best man royal wedding^prince harry asks william best man royal wedding^prince harry asks william best man royal wedding^prince harry asks william best man royal wedding^listen people frantically trying figure taylor swift brand new song 'gorgeous about^listen people frantically trying figure taylor swift brand new song 'gorgeous about^listen people frantically trying figure taylor swift brand new song 'gorgeous about^barbra streisand dog bit pierce brosnan hearing sing first mamma mia film^barbra streisand dog bit pierce brosnan hearing sing mamma mia^pierce brosnan says barbra streisand dog bit hearing sing first mamma mia film^pierce brosnan says barbra streisand dog bit hearing sing mamma mia^summer phoenix files divorce casey affleck^summer phoenix files divorce casey affleck^watch jennifer lawrence calls harvey weinstein 'a horrible ass boil stellar colbert interview^watch jennifer lawrence calls harvey weinstein 'a horrible ass boil stellar colbert interview^watch jennifer lawrence calls harvey weinstein 'a horrible ass boil stellar colbert interview^watch brad pitt returns depressing weatherman 'the jim jefferies show^watch brad pitt returns depressing weatherman 'the jim jefferies show^robert de niro censored last night tony awards saying 'f**k trump^robert de niro censored last night tony awards saying 'f**k trump^jennifer lawrence darren aronofsky reportedly split^jennifer lawrence darren aronofsky reportedly split^jennifer lawrence darren aronofsky reportedly split^bradley cooper irina shayk welcome first child together^bradley cooper irina shayk welcome first child together^bradley cooper irina shayk welcome first child together^wwe stars john cena nikki bella split six years together^john cena nikki bella split six years together^justin theroux breaks social media silence first time since split jennifer aniston^emilia clarke says final game thrones scenes ''f**ked ''^emilia clarke says final game thrones scenes ''f**ked ''^emilia clarke says final game thrones scenes ''f**ked '',42,32,-10,74,0.5675675675675675,-0.13513513513513514,1
11856892,MeetThePress,408,598649,7020,65232,0,72,1,0,meet press longest-running television show history if sunday meet press mtp ifitssunday mtpdaily,tomorrow tune mtp exclusive interviews rudy giuliani ifitssunday^tomorrow trump attorney rudy giuliani exclusive interview canadian prime minister tu^this sunday trump attorney rudy giuliani exclusive interview canadian prime minister .^this morning trump attorney rudy giuliani exclusive interview canadian prime minister^coming up tune mtp exclusive interviews rudy giuliani ifitssunday^rundown embark presidential campaign style tour take states like iowa sou^what i took note critical time country chairman republican national^new fewer one five americans positive view socialism new nbc news/wall street journal poll find^watch joins mtpdaily discuss new poll^the lid following kavanaugh nomination new poll finds roe v. wade enjoys bipartisan support^download now following kavanaugh nomination new poll finds roe v. wade enjoys bipartisan^mtpthelid new poll shows high voter enthusiasm approval rating surge trump^the lid following kavanaugh nomination new poll finds roe v. wade enjoys bipartisan support^mtpthelid for independents influence election show polls new^rt guests sunday treasury secretary tim geithner first live sunday interview plus exclusive sen. john mccain^download now for independents influence election show polls new /^watch this going electorate 've never seen crunches data new^watch elains speech national federation independent business the^h e continued much damage legal position stop talking case t^watch the mtpdaily panel discussed mick mulvaney appointment challenges face role^icymi it beginning look lot like beto running president mtpdaily^watch it beginning look lot like beto running president mtpdaily^fmr white house counsel bob bauer says trump horrifying client i imagine government service.^breaking director office management amp budget mick mulvaney named acting white house chief staff.^watch fmr white house counsel bob bauer says problematic grounds recusal barr talked mueller pr^says way president handled elaining michael cohen payments women camp^tomorrow exclusive interviews mtp ifitssunday^flashback mick mulvaney joined mtp october discussed john kelly role chief staff made the^even though clear trump knowledge michael cohen payments whether empirical evide^icymi the mtpdaily panel discusses mick mulvaney appointment acting chief staff challenges wil^watch president trump announces mick mulvaney acting chief staff^there one chief staff one director communications one political director white h^impacts president investigations the scandals proliferated exte^after gop election losses wisconsin gov walker signs sweeping package republican authored lame duck legislat^watch all ways russians got involved election mtpdaily^new mueller memo denies flynn coerced lying fbi^first read all president investigations^president trump search new chief staff you see trump undercuts people wh^watch it beginning look lot like beto running president^watch fmr white house counsel bob bauer says problematic amp grounds recusal barr talked mueller prob^icymi cevallos 'nra concerned maria butina plea mtpdaily^breaking trump names mick mulvaney acting chief staff^talks president legal troubles mtpdaily there civil matters campaign finance viol^watch last week mtp gov elect tony evers d wis. talked chuck possible legal action would^watch which investigation facing could worst trump he faces potential harm if^obsessed tonight chuck obsessed story hoxie arkansas typifies saying every vote coun^coming up mtpdaily former white house counsel president obama bob bauer break la^tomorrow exclusive interviews sen. mtp ifitssunday^obsessed tonight obsessed story hoxie arkansas typifies saying every vote^new president trump announces mick mulvaney acting chief staff via tweet^watch which investigation could worst trump he faces potential harm is^this sunday exclusive interviews do n't miss mtp^watch we begin tonight crimes lies investigations mtpdaily the president den^bob bauer served white house counsel president obama called president trump without doubt m^one investigation may fall news cycle something else happens for president trump ad^icymi our full interview north korea china advising pres trump^icymi our full interview north korea china advising pres trump^new documentary shows republicans face 'dark money campaign attacks montana listen th^meet press pre empted week nbc 's coverage french open we 'll back next week^preempted coverage see next sunday^preempted coverage catch mtpdaily weekdays pm et msnbc see next sunday^meet press pre empted week nbc 's coverage french open see next week^watch celebrates years appearances meet press^welcome sunday ... meet press mtp ifitssunday^tired boring mugs without mtp logo we help buy meet press mug^download now james clapper tells michael flynn became angry man firing def^meet press november^new documentary shows republicans face 'dark money campaign attacks montana listen th^icymi is team secret caps stanley cup win last night^download now james clapper i seen lot bad stuff years intelligence nothing like this.^full interview former president george w. bush^watch when president group world leaders uncomfortable sole ce^a major federal investigation way the full weight government deployed ... spar,1,72,71,73,0.0136986301369863,0.9726027397260274,0
1917731,thehill,258,3403272,26412,629520,0,37,21,15,the hill premier source policy political news follow tweets happening washington breaking news retweets reporters,"republican national committee spent 1.5 million trump owned properties cycle^trump campaign paid 35,000 ad firm named mad men^just in trump campaign paid 35,000 ad firm named mad men^trump campaign paid 35,000 ad firm named mad men^trump gives impromptu interview fox amp friends white house lawn^obama campaign launches swing state radio ads blasting romney ryan budget^n.c. sen. kay hagan closes campaign radio ad featuring obama endorsement ncsen ncpol^josh hawley sen. mccaskill supports amnesty like hillary she supports higher taxes like hillary ... w^cnn cuts ties marc lamont hill controversial comments israel^cnn cuts ties marc lamont hill controversial comments israel^cnn cuts ties marc lamont hill controversial comments israel^cnn cuts ties marc lamont hill controversial comments israel^cnn cuts ties marc lamont hill controversial comments israel^john brennan i really serious serious concerns objections mr. trump done s^john brennan i really serious serious concerns objections mr. trump done s^john brennan i really serious serious concerns objections mr. trump done s^watch live white house holds press briefing trump trip meet world leaders canada^watch live secretary state pompeo holds white house press briefing^sarah sanders clashes repeatedly reporters heated white house briefing^sarah sanders clashes repeatedly reporters heated white house briefing^sarah sanders clashes repeatedly reporters heated white house briefing^new sarah sanders clashes repeatedly reporters heated white house briefing^watch live white house holds press briefing trump meets potential supreme court picks^sarah sanders lets trump campaign virginia chairman ask question white house briefing^dems want white house briefing separated families reunited^sarah sanders clashes repeatedly reporters heated white house briefing^watch live white house holds first press briefing since trump met putin^sarah sanders lets trump campaign virginia chairman ask question white house briefing^sarah sanders lets trump campaign virginia chairman ask question white house briefing^sarah sanders lets trump campaign virginia chairman ask question white house briefing^sarah sanders clashes repeatedly reporters heated white house briefing^sarah sanders clashes repeatedly reporters heated white house briefing^sarah sanders clashes repeatedly reporters heated white house briefing^michelle obama calls forever first lady speech thousands students^michelle obama calls forever first lady speech high school students^michelle obama calls forever first lady speech thousands students^michelle obama calls forever first lady speech high school students^nascar owners threaten fire drivers crew members protest national anthem^breaking nascar owners threaten fire drivers crew members protest national anthem^just in nascar owners threaten fire drivers crew members protest national anthem^nascar owners threaten fire drivers crew members protest national anthem^nascar owners threaten fire drivers crew members protest national anthem^nascar owners threaten fire drivers crew members protest national anthem^nascar owners threaten fire drivers crew members protest national anthem^nascar owners threaten fire drivers crew members protest national anthem^nascar owners threaten fire drivers crew members protest national anthem^nascar owners threaten fire drivers crew members protest national anthem^nascar owners threaten fire drivers crew members protest national anthem^trump defends beautiful confederate statues they greatly missed^kim kardashian visits white house meeting prison reform reports^jenna bush hager apologizes 'hidden fences flub golden globes^jenna bush hager apologizes hidden fences gaffe golden globes^jenna bush hager apologizes 'hidden fences flub golden globes^jenna bush hager apologizes hidden fences gaffe golden globes^jenna bush hager apologizes hidden fences gaffe golden globes^andy cohen calls real housewives reunion melania ivana trump spat^caitlyn jenner trump what happened promise fight lgbt americans^caitlyn jenner slams trump what happened promise fight lgbt americans^george hw bush hospitalized low blood pressure fatigue^just in george hw bush hospitalized low blood pressure fatigue^just in harvey weinstein faces new rape allegation new class action lawsuit^just in harvey weinstein pleads guilty additional felony sexual assault charges^just in the weinstein company file bankruptcy^morning joe co hosts joe scarborough mika brzezinski engaged^morning joe co hosts joe scarborough mika brzezinski engaged^morning joe co hosts joe scarborough mika brzezinski engaged^morning joe co hosts joe scarborough mika brzezinski engaged^morning joe co hosts joe scarborough mika brzezinski engaged^morning joe co hosts joe scarborough mika brzezinski engaged^morning joe co hosts joe scarborough mika brzezinski engaged^morning joe co hosts joe scarborough mika brzezinski engaged^morning joe co hosts joe scarborough mika brzezinski engaged^morning joe co hosts joe scarborough mika brzezinski engaged",21,52,31,73,0.2876712328767123,0.4246575342465753,0
2542967450,eonlineasia,249,11925,98,11080,0,0,46,27,the official e online twitter asia follow us everything entertainment fashion celebrities,photographed first time official couple see^how like meat little raw well done tune juicy kuwtk tonight pm my/kr pm sg^no matter distance matter time kardashians bra^leave send energy way tune e catch brand new episode kuwtk tonigh^excited crazy blessed don miss koko baby shower next monday october brand new kuwtk episode on^emotional rollercoaster even begin describe tune brand new kuwtk episode monday th nove^we dance without care kuwtk episodes repeat today plus tune e brand new^which kardashian colour feeling today tune mondays brand new episodes kuwtk pm my/kr^when comes fashion kim gets savage watch deal khloe kourtney latest kuwtk episode rep^drama house get latest deets kards brand new kuwtk episode monday e pm m^the fam always got backs catch brand new episode kuwtk happening tomorrow e p^scott disick malibu chili cook off saturday know his ex h^scott disick malibu chili cook off saturday know his ex h^what mean n't dating despite rumors appears true^younes bendjima spent holiday weekend together talked breakup being^the kind variety show live icymi catch newest episode kuwtk tonight e 5pm my/kr |^sister amp mom goals do n't miss new episode kuwtk tomorrow happening e pm my/kr pm sg/hk pm^leave send energy way tune e catch brand new episode kuwtk tonigh^tough times always make way bigger better things do n't miss new kuwtk happening next monday october^japan meet glam kim werkin across kyoto new kuwtk tune tonight e pm my/kr pm sg/hk |^skourt butting heads icymi catch beef repeat episode kuwtk e^excited crazy blessed don miss koko baby shower next monday october brand new kuwtk episode on^drama always rolling fam 've always held together keep kards new episo^tag someone needs deets kylie best kept secret stay tuned tomorrow new episode kuwtk^can guess said scott do n't miss new episode kuwtk tomorrow pm my/kr pm sg/hk |^emotional rollercoaster even begin describe tune brand new kuwtk episode monday th nove^we never knew kards/jenners could sneaky tune new episode kuwtk next monday o^it sure n't easy scott icymi catch latest kuwtk episode today e pm my/kr pm sg/hk^the weekends rode pass us like chase mondayblues away tomorrow new kuwtk episode h^kris answer problems what without tune kuwtk catch kris jenner life^a fam plays together stays together catch latest kuwtk episode today stay tuned new episo^which kardashian colour feeling today tune mondays brand new episodes kuwtk pm my/kr^the fam taking break next monday catch latest kuwtk today e from pm my/kr pm sg/hk^it story announcing first tune new kuwtk episode monday inside look k^drama house get latest deets kards brand new kuwtk episode monday e pm m^who one true guardian khloe eyes find tomorrow episode kuwtk e pm my/kr^the fam always got backs catch brand new episode kuwtk happening tomorrow e p^the baby landed tune kuwtk tonight baby chi first episode e pm my/kr pm sg/hk pm j^kourtney kardashian literally us icymi catch newest kuwtk episode tomorrow e 7pm my/kr |^alright fam take guess ... shocked get answers kuwtk tonight e 10^despite contentious custody battle bradpitt angelinajolie maintains role international peacekee^no matter day time place family comes first kardashians tune new kuwtk episode toni^scott disick malibu chili cook off saturday know his ex h^scott disick malibu chili cook off saturday know his ex h^it sure n't easy scott icymi catch latest kuwtk episode today e pm my/kr pm sg/hk^kourtney kardashian scott disick are back together after year half apart kuwtk^it relationship rocks jenner confirms n't spoken long time^he host returning host oscars awards^wags miami stars ashley nicole roberts marries philip wheeler^brie larson reveals emma stone jennifer lawrence aved life '' celebrities^how kim kardashian kanye west are trying give north west normal life^kyliejenner sparks engagement rumors with giant diamond ring^gal gadot chris hemsworth spar social media over whether wonder woman thor would win fight^blac chyna fearful rob kardashian next move what else could^rachelmcadams pregnant first child feeling going regular mom go^theweeknd deletes selenagomez social media^ryan reynolds best response wonder woman beating deadpool^julianne moore zoe saldana sia team raise awareness hiv/aids enews^how preparing make big splash pippa middleton wedding^blac chyna granted temporary restraining order rob kardashian^watch taylor swift end game music video with ed sheeran future^chrisbrown recalls night assaulted rihanna i felt like f king monster^world ugliest dog is english bulldog zsa zsa ugliestdogcontest worldsugliestdog^here ben platt became broadway pitch perfect man^cristianoronaldo girlfriend georginarodriguez gives birth th baby^struggling zip outfit anyone ever tried clothes^arianagrande makes triumphant musical return with no tears left cry^did scott disick send kourtney kardashian bella thorne flowers day we 're saying chance..^scott disick makes two women las vegas catch kuwtk full season marathon e^travisscott facetimes kyliejenner during nyc performance amid pregnancy reports^selena gomez new los angeles home totally affordable by hollywood standards least^jennifer garner sets record straight ben affleck divorce story mom garden club lights up^playmates playboy models recreate iconic covers decades later,46,27,-19,73,0.6301369863013698,-0.2602739726027397,1
39767661,KISSRochester,1730,5703,178,121894,0,0,55,17,all hits for rochester every morning home an station,robert pattinson on movie roles 'people are trying to put you in a box^robert pattinson on movie roles 'people are trying to put you in a box^teen choice awards nominations first wave of nominees full list^report kim kardashian is having 'divorce docs drawn up is 'miserable with kanye west^report kim kardashian is having 'divorce docs drawn up is 'miserable with kanye west^sag awards nominations see full list of screen actors guild nominees^karrueche tran granted five year restraining order against chris brown^chris pratt files divorce from anna faris^sharon osbourne apologizes to justin bieber 'i was wrong to 'attack you^ed sheeran did not 'break friendship code with taylor swift^jamie foxx katie holmes finally out public as couple^celebrities react trump withdraws steph curry white house invitation^celebrity reaction jimmy kimmel monologue on las vegas shooting and guns^beyonce not demanding silent delivery room despite report^are selena gomez amp the weeknd working on a movie together^jimmy kimmel talks donald trump harvey weinstein on 'gma^brad pitt gq divorce interview highlights on angelina jolie kids and drinking^selena gomez vogue cover story see interview highlights^katie couric said matt lauer pinched her on the ass on 'today back in^jennifer garner ben affleck file for divorce amid false reconciliation rumor^kendall jenner jealous ex^celebrities react to hurricane irma^chris brown slammed by judge for skipping karrueche tran court hearing^chris soules had no alcohol in system after crash negative for drugs^did jennifer lopez 'like a comment dissing mariah carey^katie holmes not pregnant and planning wedding with jamie foxx^sorry drake amp bella hadid are not 'secretly dating^kim kardashian sued for allegedly stealing lighting technique for selfies^kristen stewart on dating robert pattinson 'the public were the enemy^celebrity reactions prince harry meghan markle engaged^halle berry not pregnant at despite reports^watch kim kardashian first interview since robbery on 'ellen degeneres show videos^justin bieber dating hailee steinfeld photo^nope justin bieber is not dating hailee steinfeld^hailee steinfeld responds to justin bieber dating rumors^robert pattinson amp katy perry are not dating^beyonce birth twins still hospital 'minor issue^beyonce birth twins still hospital 'minor issue^karrueche tran granted five year restraining order against chris brown^tony awards nominations see full tonys nominees list^chloe grace moretz apologizes for 'red shoes marketing^celebrities remember orlando pulse nightclub shooting victims one year later^is demi lovato upset about meghan trainor performing the 'smurfs movie song^justin bieber did not attend vanity fair oscars after party^are mariah carey amp joe jonas feuding^joe jonas sophie turner 'already thinking of having kids is made up story^avril lavigne 'mildly amused by death conspiracy^jimmy fallon felt need to share 'heartfelt message about charlottesville^robert pattinson amp charlie hunnam talk 'lost city of z on 'gma video^chris soules 'devastated after killing kenny mosher in fatal accident^obamas celebrate th anniversary after false split stories^mariah carey not dating both nick cannon and bryan tanaka despite report^mariah carey not dating both nick cannon and bryan tanaka despite report^michael strahan 'looking forward to working with alex rodriguez at abc^kourtney kardashian amp scott disick are back together^here how help victims las vegas mass shooting^harry styles announces intimate world tour see the dates^'dance moms abby lee miller sentenced to one year in prison^the bachelor bekah m was on missing persons list until fan recognized her^rachel mcadams is reportedly pregnant with her first child^'happy days star erin moran dead at^hugh hefner cause death has been revealed^hugh hefner cause death revealed^alex rodriguez year old daughter sings for jennifer lopez photos^jenny slate and chris evans break up again^the bachelor ben higgins and lauren bushnell break up^star jones ex husband al reynolds comes out as bisexual in candid blog^'storm chasers star joel taylor dead at^billboard music awards nominations see full list of bbmas nominees^billboard music awards nominations see full list of bbmas nominees^'black panther is officially the most tweeted about movie of all time^chris pratt files divorce from anna faris,55,17,-38,72,0.7638888888888888,-0.5277777777777778,1
26618118,GirlfriendMAG,862,41416,282,31845,3,0,61,8,the winter issue starring noah centineo sale,nooo is snapchat shutting down at the end of^woah is snapchat shutting down at the end of^woah is snapchat shutting down at the end of^word on the street is selena gomez and the weeknd just got into their first fight^an e employee revealed the network is panicking as 'life of kylie is a disaster^liam hemsworth pulled frightening prank miley cyrus^scott disick dna tested paternity kylie jenner baby^scott disick dna tested paternity kylie jenner baby^scott disick dna tested paternity kylie jenner baby^new reports claim kendall jenner is quitting 'keeping up with the kardashians to move to paris^apparently tess ward dumped harry styles for her ex boyfriend^zomg justin bieber and selena gomez are reportedly planning to elope^kim kardashian photoshopped butt smaller fans freaking^the real reason justin bieber re followed selena gomez on instagram^liam hemsworth pulled frightening prank miley cyrus^how pregnant khloe kardashian betrayed her bae tristan thompson^sofia richie kourtney kardashian attended event same outfit^brad pitt margot robbie new scandal^pregnant troian bellisario posts really heartbreaking message online^justin bieber and selena gomez spotted making out again^selena gomez officially dumps justin bieber happy^selena gomez *real* reaction justin bieber marriage actually really sad^brad pitt margot robbie new scandal^justin bieber selena gomez bad bad^sofia richie kourtney kardashian attended event same outfit^miley cyrus cancels bora bora honeymoon with liam hemsworth^hailee steinfeld talks about dating justin bieber on live radio^katy perry is reportedly dating robert pattinson and are you screaming^taylor swift called kim kardashian bully stage tour^kim kardashian super upset kanye west right^robert pattinson amp fka twigs reportedly split because of kristen stewart^kourtney kardashian blasts pregnant sister khlo new ep 'kuwtk^new reports claim miley cyrus and liam hemsworth 'are on the rocks and we 're screaming^brody jenner wife slams caitlyn jenner ditching wedding^brody jenner beyond pissed caitlyn skipped wedding^kourtney kardashian reveals real reason breakup younes bendjima^katy perry reignites taylor swift feud dragging 'american idol^kanye west 'elosive fights kris jenner kim kardashian ca n't 'control him^the one think kylie jenner is jealous of kim kardashian will shock you^taylor swift who calvin harris steps out with gorgeous new girlfriend^fans are convinced that bindi irwin amp chandler powell are engaged^kendall jenner breaks down in tears as she speaks out about the controversial pepsi ad^selena gomez *real* reaction justin bieber marriage actually really sad^blac chyna mum has gone to town on caitlyn jenner and it nasty^uhh ... rob kardashian jennifer lawrence dating^blac chyna is suing the entire kardashian family for the weirdest reason^blac chyna has responded to rob kardashian and kylie jenner suing her for assault^kendall jenner completely flips out on keeping up with the kardashians^ryan seacrest received a text from kris jenner about kylie pregnancy live on air^ryan seacrest received a text from kris jenner about kylie pregnancy live on air^kris jenner begs kourtney kardashian take kardashian empire^kris jenner begs kourtney kardashian take kardashian empire^you have to see these pics of kylie jenner looking bored af at the met gala^selena gomez perfect response news justin bieber engagement^kanye west 'elosive fights kris jenner kim kardashian ca n't 'control him^sofia richie kourtney kardashian attended event same outfit^kanye west 'elosive fights kris jenner kim kardashian ca n't 'control him^fans are convinced that sofia richie has copied kourtney kardashian look^alert pregnant kylie jenner returns to the spotlight in a new photoshoot^pregnant kylie jenner returns to the spotlight with 'love magazine cover^pregnant kylie jenner returns to the spotlight in new calvin klein campaign with her sisters^katy perry reignites taylor swift feud dragging 'american idol^cardi b shows support selena gomez emotional breakdown^a much needed update selena gomez following emotional breakdown^blake lively injured on set of spy thriller the rhythm section^just in blake lively injured on set of spy thriller the rhythm section^okuur cardi b *may* accidentally revealed sex baby^rachel mcadams is reportedly pregnant with her first child^do these loved up snaps prove nina dobrev and glen powell are dating^just in 'zoey star jamie lynn spears is pregnant with her second child^sad news for 'the originals as the show will come to an end after season^new reports claim travis scott is cheating on pregnant kylie jenner and omg,64,8,-56,72,0.8888888888888888,-0.7777777777777778,1
2347049341,voxdotcom,279,867166,16034,111961,6,61,3,1,understand news subscribe daily elainer podcast,"the case massively eanding us house representatives one chart^the average member us house representatives represents ,184 people compare british house^the us supreme court put pennsylvania ruling hold makes clear state get new hous^the average member us house representatives represents ,184 people compare british house^none normal read full transcript sen. jeff flake blistering retirement speech^it seems george h.w bush legacy shaped political moment died but also worth con^peter strzok fbi agent sent anti trump texts testifying congress let clear unequivoca^none normal read full transcript sen. jeff flake blistering retirement speech^the condition called acute flaccid myelitis afm potentially sickened people centers for^trump weekend interview fox news puts ignorance laziness full display^we really talk trump startling statements north korea fox news interview^papa john n't appear sorry using n word^it alarming echo last year devastating fire season charred million acres the^trump yet awarding national medal arts fits president general antipathy toward arts^michelle obama n't rallying americans specifically democrats instead launching nonpartisan voter reg^new season new characters new mall^poll percent young voters say certainly vote midterms^groups like national rifle association planned parenthood aarp longer tell irs wh^there growing body scientific evidence shows low blood sugar leads hangry^in the garden party bohemian intellectuals wealthy conservatives come together wedding rehearsal dinner.^blindspotting rare buddy comedy tackles social issues it works^this fairy tale lets heroine monster princess^these books might confuse anger challenge think different way^voter purges rise states history racial discrimination^democrats learning hard way party desperately needs educate voters importance th^the men sharp objects believe women talk gossip they wrong^the relationship christianity work family balance complex ambiguous^the equalizer series best leans silliness premise^recently traveled border community south texas in essay vox describes saw^is cellphone giving cancer comprehensive guide messy frustrating research^the russia scandal collusion it also corruption america elites^the missouri duck boat tragedy reignited debate weather safety companies taking meteorological wa^how twitter helping keep classic movies alive streaming era^songwriting n't come it takes work^why embracing abolish ice medicare doom democrats^the movement ban straws n't considering affect disabled people^this chart shows people increasingly responding facebook posts members congress angry rea^watch exciting movie tv trailers super bowl nerd culture sdcc2018^ignore plot holes enjoy relentlessly upbeat pop soundtrack^costa rica plan become first carbon neutral nation world^importing generic drugs countries could bring america sky high prices^a recent supreme court decision dealt teachers unions devastating blow to survive need creative new^we switched names and sudden clients started treating us much differently^the public trust gmos will trust crispr^maria butina met donald trump jr. lived republican consultant where investigation lead^dan coats wants know despite seems trump page^it fault it biology^this makes nunes memo claims even dubious^kavanaugh suggested maybe supreme court got wrong nin^democrats winning younger voters huge numbers serious question whether young de^us ambassador russia elains decision stay trump putin summit^a carbon tax lower greenhouse gas emissions needs pretty damn high everything need know^in balancing comedy drama hbo succession becoming stunning greek tragedy^the empower act bill bipartisan support would bar companies using nondisclosure agreements hide ha^pbs democratic debate transcript key moments^here live rush transcript second presidential debate^new the weeds podcast we discuss trump address joint session congress lens policy^is crispr gene editing scientific feat risky social eeriment watch eerts lay sides d^there perspectives play debate syria ruth sums latest ep^read full transcript obama fiery anti trump speech^transcript hillary clinton official campaign launch speech^the condition called acute flaccid myelitis afm potentially sickened people centers for^in presidential candidate barack obama received harsh criticism saying would meet irania^in nevada democrats vying chance challenge incumbent sen. dean heller republican senator^read full transcript obama fiery anti trump speech^how trade wars born us government hitting chinese goods 34 billion tariffs china plans to^how trade wars born us government hitting chinese goods 34 billion tariffs china plans to^teens somethings registering vote huge numbers following taylor swift political instagram post^golden globes complete winners list^kim kardashian allowed care prison reform^oscars winners complete list",9,62,53,71,0.1267605633802817,0.7464788732394366,0
517607733,IrishSunOnline,297,14401,248,170555,0,0,44,27,exclusives news sport entertainment fantastic competitions like us facebook,jennifer aniston confronts selena gomez 'bond ex justin theroux^jennifer lawrence darren aronofsky split due 'huge age gap^jennifer lawrence holds hands boyfriend cooke maroney seven months split darren aronofsky^jamie foxx parties bikini clad ladies miami pool party katie holmes heads paris amid split rumo^justin theroux selena gomez 'totally falling jennifer aniston n't happy^harry styles secretly dating naked chef blogger model tess ward^psychic twins claim princess diana warned prince harry meghan markle 'turbulent times instabili^brad pitt apologises jennifer aniston leaving angelina jolie^ed sheeran cherry seaborn go double date courteney cox johnny mcdaid cherry is n't wearing w^miley cyrus liam hemsworth 'call wedding clash babies^ed sheeran cherry seaborn go double date courteney cox johnny mcdaid cherry is n't wearing w^kris jenner reveals rob kardashian returning keeping up with the kardashians^keeping up with kardashians spoilers dramatic moment kendall jenner calls kris middle anxiety att^brad pitt apologises jennifer aniston leaving angelina jolie^kris jenner reveals rob kardashian returning keeping up with the kardashians^keeping up with kardashians spoilers dramatic moment kendall jenner calls kris middle anxiety att^kim kardashian left reeling kanye west tries control puts instagram huge row^how last minute dash h amp m helped land meghan markle job suits^beyonce 'reunite destiny child coachella claims us report^justin bieber sparks rumours dating selena gomez lookalike hailee steinfeld^kim kardashian tressed upset husband kanye west increasingly eccentric outbursts^kim kardashian upset kanye west announces moving chicago tells never leave la^brad pitt apologises jennifer aniston leaving angelina jolie^chris martin dakota johnson definitely dating spotted holiday israel^katy perry 'throws shade taylor swift american idol auditions spotted wearing bum bag^meghan markle brother pens heartfelt letter urging sister get touch father let pa^shock contender emerges replace amanda byram dancing with the stars dwtsirl^ex strictly star set replace amanda byram host dancing with the stars^ex strictly star set replace amanda byram host dancing with the stars^shock contender emerges replace amanda byram dancing with the stars^prince harry meghan markle pay moving secret tribute princess diana royalwedding^keeping up with kardashians spoilers dramatic moment kendall jenner calls kris middle anxiety att^taylor swift ireland croke park shows hiding taylorswift^kim kardashian admits 'begging sisters kourtney khloe surrogate^justin theroux breaks social media silence following jennifer aniston divorce^jennifer aniston 'lovingly divorce husband justin theroux two years^al pacino model stepdaughter camila morrone seen leonardo dicaprio new york^selena gomez reveals kidney transplant due battle lupus^david beckham says marriage victoria hard work says romance become 'more complicated time^david beckham says marriage victoria hard work says romance become 'more complicated time^kylie jenner planning take six months spotlight 'wo n't confirm pregnancy gives birth^katy perry 'throws shade taylor swift american idol auditions spotted wearing bum bag^kim kardashian leaves nothing imagination skin tight silver jumpsuit date night kanye west^revealed why devastated angelina jolie finally dumped husband brad pitt^this moment tristan thompson caught 'cheating pregnant girlfriend khloe kardashian strip club w^breaking prince harry asks william best man wedding meghan markle^luke wilson car crash golfer bill haas legally blonde actor involved fatal ferrari smash los angeles^luke wilson crash legally blonde actor golfer bill haas involved fatal car crash los angeles^outlander fans go meltdown amid rumours caitriona balfe engaged^who dedrick d williams suspect arrested murder xxxtentacion^tina turner son craig found dead aged apparent suicide california home^tina turner son craig found dead aged apparent suicide california home^happy days star erin moran dead aged found unresponsive home^mtv reality star clay adler dead taking life^michael fassbender alicia vikander married tying knot ibiza weekend^jennifer lawrence boyfriend darren aronofsky split year dating say us reports^jennifer lawrence darren aronofsky split due 'huge age gap^jennifer lawrence boyfriend darren aronofsky split year dating say us reports^cristiano ronaldo girlfriend georgina rodriguez gives birth baby girl^this 're supposed use dry shampoo 've probably wrong^gossip girl star ed westwick denies raping actress kristina cohen home^michael fassbender alicia vikander spotted honeymoon italy secret ibiza wedding^stormy daniels porn star husband glendon crain files divorce^heidi montag spencer pratt reveal eecting baby boy^ed sheeran fiancee cherry seaborn flashes new engagement ring day london^ed sheeran fiancee cherry seaborn flashes huge engagement ring skip showbiz parties head for^ed sheeran fiancee cherry seaborn flashes engagement ring skip showbiz parties head curry after^kylie jenner 'is girl boyfriend travis scott five months pregnant claim us reports^kylie jenner ex boyfriend tyga says kid amid reports pregnant star due february^kylie jenner 'is girl boyfriend travis scott five months pregnant claim us reports^kylie jenner 'is girl boyfriend travis scott five months pregnant claim us reports,44,27,-17,71,0.6197183098591549,-0.23943661971830985,1
2097571,cnni,370,8941181,39040,204707,4,44,8,14,breaking news around world plus business style travel sport entertainment we gothere,"facebook ceo mark zuckerberg appear european parliament warns 'll much tou^the russian government sent message pessimism relations us democrats seized cont^the us house representatives set vote week bill give money security schools t^trump failed protect nation new york bombing suspect posted facebook hours detonating devi^us director national intelligence dan coats says believed needed correct record president t^the us centers disease control prevention warned us consumers eat romaine lettuce may cont^there confirmed cases acute flaccid myelitis states year according us cente^additional cases salmonella identified ongoing multistate outbreak linked raw beef produc^the number cases polio like illness acute flaccid myelitis appears peaked us cent^there cases possible confirmed acute flaccid myelitis united states year according^the us centers disease control prevention warned us consumers eat romaine lettuce may cont^as cases confirmed us centers disease control prevention says evidence suggests viral asso^the us centers disease control prevention escalated response polio like illness struc^shooting homicides rise though common methods murder remain flat according us centers^newly confirmed cases polio like illness acute flaccid myelitis announced making record^cigarette use among american adults lowest since us centers disease control prevent^former vice president joe biden offer contrast president trump foreign policy speech london^rudy giuliani says special counsel robert mueller agreed narrow scope potential interview with^at republican national committee summer meeting austin one sweating trump putin summit^president trump defended response death sen. john mccain interview bloomberg news asked^us president donald trump delivered first address joint session congress here recap^there confirmed cases acute flaccid myelitis states year according us cente^additional cases salmonella identified ongoing multistate outbreak linked raw beef produc^the number cases polio like illness acute flaccid myelitis appears peaked us cent^there cases possible confirmed acute flaccid myelitis united states year according^the us centers disease control prevention warned us consumers eat romaine lettuce may cont^as cases confirmed us centers disease control prevention says evidence suggests viral asso^the us centers disease control prevention escalated response polio like illness struc^shooting homicides rise though common methods murder remain flat according us centers^newly confirmed cases polio like illness acute flaccid myelitis announced making record^cigarette use among american adults lowest since us centers disease control prevent^a doctor pharmacy resident police officer these victims chicago hospital shooting^a police officer doctor pharmaceutical assistant dead shooting chicago mercy hospital ma^while montenegro history n't perfect country n't aggressive president trump stated need^president trump defended response death sen. john mccain interview bloomberg news asked^mark zuckerberg sister randi weighed brother controversial comments holocaust deniers exclus^trump declared nationalist rally monday night cnn global affairs analyst max boot joins ander^president trump defended response death sen. john mccain interview bloomberg news asked^the disappearing white house press briefing analysis^sarah sanders holds first white house press briefing two weeks follow live updates^the white house corrected transcript briefing call national economic council director larry kudlow mo^the disappearing white house press briefing analysis^former us first lady michelle obama poised make first major speech since leaving white house today^a watchdog group filed lawsuit week seeking documents us department agriculture eeriment^a watchdog group filed lawsuit week seeking documents us department agriculture eeriment^recall alert more ,000 pounds hormel spam canned meat products recalled the^israel says one tanks targeted hamas military post gaza saturday retaliation border fence brea^the us china tariffs gone effect ,300 goods suddenly eensive yesterday c^tensions rise us president donald trump warns 'fire fury north korea threatens attack guam^classic cars eeriencing rebirths electric vehicles trend championed prince harry meghan duche^the secret donald trump rudy giuliani know russia probe analysis^classic cars eeriencing rebirths electric vehicles trend championed prince harry meghan duche^hoda kotb replace matt lauer co host nbc today gop sen. orrin hatch retire end hi^prince william catherine duchess cambridge appear outside london hospital gave birth their^prince william catherine duchess cambridge appear outside london hospital gave birth their^retired english teacher marked letter received president trump filled grammar mista^do i need british accent former president barack obama jokes prince harry interviews radio sh^do i need british accent former president barack obama jokes prince harry interviews radio sh^do i need british accent former president barack obama jokes prince harry interviews radio sh^jamie lynn spears pregnant second child^evan spiegel must weigh whether push forward controversial app redesign could either reinvigorate sn^after days dropping slithering clues taylor swift announces 'll release new album called reputation^after days dropping slithering clues taylor swift announces 'll release new album called reputation^after days dropping slithering clues taylor swift announces 'll release new album called reputation^black panther tweeted movie time twitter says^black panther tweeted movie time twitter says^black panther tweeted movie time twitter says^black panther tweeted movie time twitter says^black panther tweeted movie time twitter says^singer demi lovato hospitalized suffering apparent drug overdose source tells cnn",12,58,46,70,0.17142857142857146,0.6571428571428571,0
2811559122,cnnphilippines,355,501450,1962,372131,6,42,10,12,news trust,"rep pantaleon alvarez we undo past certainly shape future the house representatives^cnnphasks house representatives holding contest students suggest laws country we want to^cnnphasks house representatives holding contest students suggest laws country we want to^zubiri delay budget senate ca n't faulted also slight delay rush it^new york bombing suspect facebook 'trump failed protect nation^last queen elizabeth ii line corgis dies following battle cancer^walangpasok classes level public private obando bulacan suspended monday july due bad^senate president tito sotto says pdea present drug tests schools preventive education program |^security preparations sona cnnphnewday^majority filipinos consider war drugs duterte administration important achievement pu^walangpasok classes level public private paombong bulacan suspended monday july due b^walangpasok classes level public private quezon city suspended monday july due to^ncrpo chief no specific threat sona cnnphnewday^senate president tito sotto says approval bill dissolution marriage means eanding provisio^senate president tito sotto i believe former president noynoy aquino face charges |^thread aside president speech fashion also take spotlight sona2018^walangpasok classes level public private marikina city suspended monday july due bad w^walangpasok classes level public private lingayen pangasinan suspended monday july due t^senate president tito sotto possible cancellation elections why need |^pagasa josieph continue bring rains ilocos region zambales bataan cavite batangas mindoro pala^senate president tito sotto says elections reset earlier date term extensions q^pagasa raises red rainfall warning zambales bataan a.m. orange metro manila batangas^senate president tito sotto said would senate president former chief justice lourdes sereno u^senate president tito sotto says candidates next ombudsman chief justice competent |^walangpasok classes level public private subic zambales suspended monday july due bad^marikina city mayor marcelino teodoro says eecting around ,000 families evacuate marikina r^walangpasok classes level public private bocaue bulacan suspended monday july due bad^walangpasok classes level public private masantol pampanga suspended july due ba^calida opening statement the resolution current issue hinges constitution defines marria^walangpasok classes level public private olongapo city suspended monday july due bad w^walangpasok classes level public private malolos city bulacan suspended monday july due^senate president tito sotto says brushed president duterte statements god saying unders^majority filipinos want president duterte emphasize jobs inflation sona2018 pulse asia^senate president tito sotto says less ,000 people died police operations pr^tropical depression josie exited ph a.m. pagasa says^heads motorists pay less fuel tomorrow july follow thread fuel price rollbacks^ndfp peace panel consultant rey casambre reacts senator lacson statement removing joma sison peace^senate president tito sotto eects president duterte put emphasis universal health care bill iss^walangpasok classes level public private imus cavite suspended monday july due bad we^senate president tito sotto says enabling law needed mandate people initiative |^about children ever breastfed united states according u.s. centers disease control^doj presents witness dnd head legal affairs shows certification record transcripts^congress hold joint session morning discuss proposed extension martial law mindanao const^former chief justice hilario davide jr. condemns efforts unseat women critical government wake of^about children ever breastfed united states according u.s. centers disease control^congressman john bertiz says ready undergo investigation regarding controversial viral airport vid^afp chief galvez clarifies total people died basilan bombing one soldier four cafgu members f^public awareness federalism one duterte administration campaign promises low new independent^prince harry meghan markle wed may^prince harry meghan markle wed may^chris pratt files divorce anna faris global newsroom live^west end star joins hosts celebrate international wome^kim kardashian west welcomes third child^elle faces backlash false kim kardashian kanye west breakup tweet^channing tatum jenna dewan tatum announce separation nearly nine years of^taylor swift new music video a guide means lwymmdvideo^taylor swift new music video a guide means^elle faces backlash false kim kardashian kanye west breakup tweet^gods timing really literally perfect got engaged seventh day seventh month justin bieber^after years kermit frog getting new voice^hugh hefner cause death revealed global newsroom live^'clueless actress stacey dash running congress california^report bradley cooper irina shayk welcome first child newsroom live^game thrones stars kit harington rose leslie married^kylie jenner happy snapchat new redesign^taylor swift announces new album 'reputation^meryl streep joins 'big little lies season^coachella lineup beyonc the weeknd eminem headline^demi lovato hospitalized suffering apparent drug overdose^chris pratt files divorce anna faris global newsroom live",16,54,38,70,0.22857142857142854,0.5428571428571428,0
21363471,1013KDWB,543,91436,499,169350,0,0,38,31,the twin cities hit music station all the hits listen live find us facebook,john mayer has been hospitalized emergency appendectomy^report kim kardashian is having 'divorce docs drawn up is 'miserable with kanye west^sag awards nominations see full list of screen actors guild nominees^american music awards nominations amas nominees full list^chris pratt files divorce from anna faris^sharon osbourne apologizes to justin bieber 'i was wrong to 'attack you^beyonce not demanding silent delivery room despite report^are selena gomez amp the weeknd working on a movie together^jimmy kimmel talks donald trump harvey weinstein on 'gma^celebrities react to hurricane irma^chris brown slammed by judge for skipping karrueche tran court hearing^chris soules had no alcohol in system after crash negative for drugs^did jennifer lopez 'like a comment dissing mariah carey^kanye west concerts on hold indefinitely^no drake is n't 'lusting after rihanna despite new rumors^taylor swift wins countersuit against dj david mueller in groping trial^katie holmes not pregnant and planning wedding with jamie foxx^lady gaga taylor kinney not secretly dating despite late and wrong report^sorry drake amp bella hadid are not 'secretly dating^celebrity reactions prince harry meghan markle engaged^mariah carey amp french montana did not flirt in recording studio^hailee steinfeld responds to justin bieber dating rumors^nope justin bieber is not dating hailee steinfeld^robert pattinson amp katy perry are not dating^beyonce birth twins still hospital 'minor issue^is liam hemsworth mad at miley cyrus for texting nick jonas^justin bieber fan arrested trespassing at singer beverly hills home^flo rida not performing at donald trump inauguration despite report^chris brown urges fans to donate to year old boy 'new legs gofundme^grammy awards see the full winners list^iggy azalea blasts nick young after accidental dinner reunion^meghan markle wrong rumors about prince harry new fiancee^fans react u2 cancels st. louis concert amid police protests^no zayn is not 'desperate to defend girlfriend gigi hadid^selena gomez reveals she had a kidney transplant amp her friend was her donor^chris soules 'devastated after killing kenny mosher in fatal accident^mariah carey not dating both nick cannon and bryan tanaka despite report^kourtney kardashian amp scott disick are back together^here how help victims las vegas mass shooting^harry styles announces intimate world tour see the dates^khlo kardashian makes her first public appearance since pregnancy news^the bachelor bekah m was on missing persons list until fan recognized her^taylor swift teases new song 'gorgeous on instagram listen to a snippet^'stranger things kids get big pay raise season^bachelor nick viall vanessa grimaldi split end engagement^rachel mcadams is reportedly pregnant with her first child^demi lovato reveals that she contemplated suicide at age^alex rodriguez year old daughter sings for jennifer lopez photos^'the jetsons is heading abc live action sitcom^taylor swift teases new song 'gorgeous on instagram listen to a snippet^jenny slate and chris evans break up again^taylor swift and joe alwyn photographed on a coffee date in nashville photo^justin timberlake announces 'the man of the woods tour see the dates^heidi montag is pregnant eecting first child with spencer pratt^star jones ex husband al reynolds comes out as bisexual in candid blog^freeform nights halloween schedule is here^yes freeform nights halloween schedule^tori kelly is engaged to german basketball player andre murillo^watch harry styles kiss james corden in christmas themed 'carpool karaoke^you 'll never guess how much jessica simpson airport outfit costs^'storm chasers star joel taylor dead at^jennifer lawrence darren aronofsky split^camila cabello announces her 'never be the same tour see the dates^gigi hadid slams body shamers for calling her 'too skinny at nyfw^'black panther is officially the most tweeted about movie of all time^meryl streep joins big little lies season^zayn malik reveals just how much he talks one direction today^demi lovato announces tour with dj khaled see the dates^chris pratt files divorce from anna faris,38,31,-7,69,0.5507246376811594,-0.10144927536231883,1
20576529,Channel24,1303,362510,532,60731,0,0,39,30,south africa largest entertainment news website fan flicks obsessed series lover music celebrity groupie royal buff part fam,jessica simpson shows growing baby bump pregnancy announcement^chris pratt officially files divorce anna faris^kris caitlyn jenner remain civil sake kendall kylie^royal wedding drama brought prince harry meghan markle closer^kris caitlyn jenner remain civil sake kendall kylie^chadwick boseman why black panther needed african accent^people convinced russian tennis player related^kris caitlyn jenner remain civil sake kendall kylie^kris caitlyn jenner tolerate sake kids^fergie josh duhamel announce split^kris caitlyn jenner remain civil sake kendall kylie^kris caitlyn jenner tolerate sake kids^watch heidi klum goes drab fab time lapse video via^we ca n't stop watching time lapse heidi klum getting glammed via^did justin bieber selena gomez confirm 're back together^are justin bieber hailey baldwin already married^drake rihanna n't dating hooking^pics kim kourtney kardashian make super jealous vacay snaps^jessica simpson shows growing baby bump pregnancy announcement^angelina jolie i enjoy single^kris caitlyn jenner remain civil sake kendall kylie^kris caitlyn jenner tolerate sake kids^nicole kidman embraced tough water scenes aquaman filming^catherine duchess cambridge receive princess diana title queen dies via^catherine duchess cambridge receive princess diana title queen dies via^ben affleck looking family friendly role^celebrities react death linkin park singer chester bennington^rachel weisz gives birth baby girl^rachel weisz daniel craig welcome baby girl^brad pitt angry angelina jolie amid custody battle^brad pitt angelina jolie headed trial custody battle^watch relives tristan cheating scandal^watch discusses emotional cheating episode twitter^kylie jenner latest 'bae spoil huge diamond rock ring finger^selena gomez reveals undergo kidney transplant^kris caitlyn jenner remain civil sake kendall kylie^here kylie jenner made fans question authenticity keeping up the kardashians^kourtney kardashian scott disick finally back together^fyi kourtney kardashian scott disick finally back together^enrique iglesias anna kournikova secretly welcome twins^surprise anna kournikova welcome twins^chrissy teigen john legend ready try baby via frozen embryo transfer^second suspect arrested connection xxxtentacion murder^pic eecting baby lauren hashian^announces closure dash stores^watch jessica alba reveals sex baby^youtube star austin jones arrested child pornography charges^pics khloe kardashian makes first public appearance since pregnancy news^meet ines rau magazine first transgender playmate^second suspect arrested connection xxxtentacion murder^reports summer phoenix officially files divorce casey affleck^watch reveals wont run president^john stamos caitlin mchugh officially married^tina turner son craig dead apparent suicide^hugh hefner cause death revealed^val kilmer i healing cancer^blac chyna granted temporary restraining order rob kardashian^watch behind scenes mamma mia here we go again^meghan markle scores invite pippa middleton wedding^kendra wilkinson officially files divorce hank baskett^alicia vikander michael fassbender married reports^prince harry admits 'wanted royal family^jennifer lawrence darren aronofsky split^icymi lena dunham joins cast american horror story season^lena dunham joins cast american horror story season^swift remade cover^kylie jenner confirming denying reports pregnant^terry crews comes forward sexual assault allegations 'hollywood executive^chris pratt officially files divorce anna faris,39,30,-9,69,0.5652173913043478,-0.13043478260869565,1
14790524,WGNNews,1134,282632,2595,125118,0,54,2,12,chicago source news weather sports entertainment join us facebook instagram,the search continues sailor fell imedi four miles start race mackinac^mayor mayoral candidates speak fatal police shooting^wisconsin daycare worker charged neglect child^charged bucktown hyde park carjackings^the new york police officer choked eric garner formally served departmental charges^elon musk apologizes cave rescuer 'pedo tweet^man gets life sentences abusing kids years^europe hits google record 5 billion fine^tia coleman relatives duck boat capsized table rock lake all nephew were^dad accused shoving baby wipe infant throat leaving child critical condition^west side standoff ends^a dallas motorcycle officer struck killed suspected drunk driver funeral procession anoth^chicago police investigate attempted child luring cases^man killed shooting south side^mgm sues vegas mass shooting victims argues liable^chicago police officer suffers head injury crash^scattered showers thunderstorms eected weekend^pitchfork day two photos^around town checks village links golf course reserve^special olympics celebrates th anniversary chicago^thai soccer boys released hospital speak media first time cave rescue^san francisco bans tour buses 'full house residence^california year old accidentally shoots kills year old cousin^and britain prince george marks birthday^charity baseball game honor cfd diver juan bucio cpd cmdr paul bauer^indiana man charged lincoln park home invasions sexual assaults girls^jobs coming little village via industrial project mayor says^community leaders meet plans van dyke trial demonstrations^after changing four day work week new zealand company says employees reported greater productivity better^owner nets real murder hire requests joke url^city helps teen get permit hot dog stand instead shutting^parents charged murder crying baby dies timeout^year old boy killed drive shooting west englewood^in honor nationalhotdogday offering hot dogs 5^sailor went overboard race mackinac id 'd^watch live thai soccer team leave hospital speak media first time since rescued cave^toddlers diapers found along indiana train tracks pouring rain parents arrested^woman says police raided west side home mistake^man paints backyard comply city code look green^chicago area year old earns second college degree^destiny child singer michelle williams seeks mental health help^shot fatally east garfield park^mother leg amputated bite brown recluse spider^weather temps low mostly sunny conditions full forecast^teen peanut allergy dies unknowingly eating peanut butter chips ahoy cookie^'buffy vampire slayer reboot feature african american lead^boy beats cancer help doctor creative twist knee^sunday brunch pan seared salmon^hundreds gathered downtown chicago honor victims mass shooting pittsburgh synagogue^police report drop homicides shooting victims chicago^here victims chicago mercy hospital shooting^these victims chicago mercy hospital shooting^the life character john mccain words^watch live white house holds first press briefing since president trump russia summit^north korea vows strikes us trump warns 'fire fury^selena gomez receiving mental health treatment emotional breakdown report^tony awards full list winners^april giraffe finally gives birth^breaking meghan markle dad may changed mind hopes attend royal wedding^bet awards the complete list winners^kim kardashian shares first photo chicago west^kim kardashian shares first photo chicago west^kim kardashian shares first photo chicago west^breaking former fox news ceo roger ailes dead^'storm chasers star joel taylor dead^taylor swift announces new album 'reputation^taylor swift announces new album reputation^fiona baby hippo dad henry dies,2,66,64,68,0.029411764705882356,0.9411764705882352,0
19046392,1027KIISFM,1610,339675,2450,118308,0,0,44,23,la hit music station follow us instagram snapchat- kiis fm kiisjingleball,john mayer has been hospitalized emergency appendectomy^american music awards nominations amas nominees full list^sharon osbourne apologizes to justin bieber 'i was wrong to 'attack you^kanyewest shared texts caitlynjenner amid feud kardashians kuwtk^liamhemsworth prankster see pulled fiancee mileycyrus^teen awarded 100k scholarship thanks beyonce jayz^beyonce not demanding silent delivery room despite report^celebrities react to hurricane irma^chris brown slammed by judge for skipping karrueche tran court hearing^no drake is n't 'lusting after rihanna despite new rumors^taylor swift wins countersuit against dj david mueller in groping trial^sorry drake amp bella hadid are not 'secretly dating^beyonce jayz friendship kanyewest kimkardashian reportedly beyhive kuwtk^justinbieber reportedly 'not selenagomez despite marrying haileybaldwin^hump day celebrity news host reads mean tweets welcomes new baby^mariah carey amp french montana did not flirt in recording studio^hailee steinfeld responds to justin bieber dating rumors^robert pattinson amp katy perry are not dating^beyonce birth twins still hospital 'minor issue^justin bieber fan arrested trespassing at singer beverly hills home^split made change tone new album theweeknd selenagomez^robertpattinson kristenstewart back together see pictures twilight^jamie foxx katie holmes definitely dating^scottdisick 'very happy kourtneykardashian breakup younesbendjima kuwtk^shots fired tekashi6ix9ine kanyewest nickiminaj music video shoot^introducing live iheartjingleball watch ryanseacrest^live ryanpaysyourbills winner michelle santaana paying bill^princeharry told meghanmarkle stop dressing like hollywood actress trouble paradise^chris brown urges fans to donate to year old boy 'new legs gofundme^princeharry excited baby meghanmarkle^are kyliejenner travisscott actually married kuwtk^khloekardashian allegedly refers tristanthompson truethompson dad kuwtk^khloekardashian reveals tristanthompson 'lucky pregnant cheating scandal kuwtk^beyonce jayz friendship kanyewest kimkardashian reportedly beyhive kuwtk^iggy azalea blasts nick young after accidental dinner reunion^fans react u2 cancels st. louis concert amid police protests^introducing live iheartjingleball watch ryanseacrest^live ryanpaysyourbills winner michelle santaana paying bill^when princeharry meghanmarkle come stateside royalfamily royalwedding^no zayn is not 'desperate to defend girlfriend gigi hadid^selena gomez reveals she had a kidney transplant amp her friend was her donor^faithhill performed 'what a friend we have arethafranklin funeral queenofsoul^check memorable moments arethafranklin funeral queenofsoul arethafranklin faithhill^mariah carey not dating both nick cannon and bryan tanaka despite report^khloekardashian reveals tristanthompson 'lucky pregnant cheating scandal kuwtk^harry styles announces intimate world tour see the dates^a second suspect xxxtentacion murder arrested have following case^announces king of the weekend las vegas residency^taylor swift teases new song 'gorgeous on instagram listen to a snippet^a fourth suspect xxxtentacion murder case arrested^a second suspect xxxtentacion murder arrested have following case^wendy drops mixtape with mcdonald burger king diss tracks^demi lovato reveals that she contemplated suicide at age^taylor swift teases new song 'gorgeous on instagram listen to a snippet^jenny slate and chris evans break up again^justin timberlake announces 'the man of the woods tour see the dates^justin timberlake announces new album 'man of the woods watch^the narwhal frappuccino is here it tastes like pink starburst^tori kelly is engaged to german basketball player andre murillo^watch harry styles kiss james corden in christmas themed 'carpool karaoke^kendrick lamar makes history with pulitzer prize win for 'damn album^fergie josh duhamel split years marriage read statement^camila cabello announces her 'never be the same tour see the dates^'black panther is officially the most tweeted about movie of all time^a michaeljackson musical coming broadway would fly nyc see^demi lovato announces tour with dj khaled see the dates^april giraffe pregnant ... remember long wait give birth,44,23,-21,67,0.6567164179104478,-0.31343283582089554,1
19923638,TheCut,4413,1419655,10939,160777,0,2,45,20,style self culture power ig subscribe new york,michelle barack obama ca n't wait meet kate middleton prince william historically large baby boy^michelle barack obama ca n't wait meet kate middleton prince william historically large baby boy^jennifer aniston justin theroux separated two years marriage seven years pair^jennifer aniston justin theroux separated two years marriage seven years pair^jennifer aniston justin theroux separated two years marriage seven years pair^brad pitt moonlighting furniture business^kellyanne conway says ivanka trump treated unfairly wants go buy ivanka stuff^hmm sounds like big ask considering kim kardashian^blac chyna officially blocked trademarking name angela kardashian^blac chyna officially blocked trademarking name angela kardashian^amy schumer sent jennifer lawrence bouquet flowers harsh thoughtful words split d^amy schumer sent jennifer lawrence bouquet flowers harsh thoughtful words split d^here collection wildest scenes outside hospital kate middleton gave birth^everything know brad pitt plane incident^everything know brad pitt plane incident^katie couric pained incredibly upset matt lauer alleged sexual misconduct today show^chrissy teigen opens first time battle postpartum depression^chrissy teigen opens first time battle postpartum depression^brad pitt busy fighting women^brad pitt busy fighting women^famous women waxing shaving^famous women waxing shaving^famous women waxing shaving^there reports justin bieber hailee steinfeld dating set mutual hip pastor^this execution look furthers suspicion tilda style icon transcends earth further^what bradley cooper gets nominated best director astarisborn i realized might live worl^bradley cooper wanted lady gaga completely open no artifice^princess diana former personal shopper talks thecrown believe word vintage go^princess diana former personal shopper talks thecrown believe word vintage go^princess diana former personal shopper talks thecrown believe word vintage go^robert pattinson thought teenage relationships supposed look miserable filming twilight^robert pattinson thought teenage relationships supposed look miserable filming twilight^mariah carey believes botched new year performance sabotaged they foiled^rob kardashian reportedly suing blac chyna assault battery vandalism^rob kardashian reportedly suing blac chyna assault battery vandalism^taylor swift apparently good hiding visits joe alwyn barely leaves trace^taylor swift apparently good hiding visits joe alwyn barely leaves trace^the first thing know jennifer aniston justin theroux divorce jennifer aniston fine^the first thing know jennifer aniston justin theroux divorce jennifer aniston fine^kim kardashian reportedly care much kanye leaves l.a. gossip^kim kardashian reportedly care much kanye leaves l.a. gossip^kim kardashian reportedly care much kanye leaves l.a. gossip^kim kardashian reportedly care much kanye leaves l.a. gossip^kim kardashian reportedly care much kanye leaves l.a. gossip^the things missing lifetime prince harry meghan markle movie plotlines teen stds evil^the things missing lifetime prince harry meghan markle movie plotlines teen stds evil^the things missing lifetime prince harry meghan markle movie plotlines teen stds evil^youtube star austin jones arrested child pornography charges^youtube star austin jones arrested child pornography charges^thebachelor bekah m. elains ended missing persons list instead arie and hope^thebachelor bekah m. elains ended missing persons list instead arie and hope^when prince harry propose meghan markle while roasting chicken everything need know ab^when prince harry propose meghan markle while roasting chicken everything need know ab^mindy kaling pregnant first child^mindy kaling pregnant first child^after long back forth meghan markle says dad attend royal wedding focus health^a judge granted blac chyna temporary domestic violence restraining order rob kardashian^jennifer lawrence darren aronofsky split year dating^jennifer lawrence darren aronofsky split year dating^gameofthrones irl lovers kit harington rose leslie married^from grace kelly princess diana best royal wedding dresses time^from grace kelly princess diana best royal wedding dresses time^khlo kardashian reportedly ready give tristan thompson week gossip column^khlo kardashian reportedly ready give tristan thompson gossip heard week^khlo kardashian reportedly ready give tristan thompson week gossip column^morning joe co hosts joe scarborough mika brzezinski engaged^morning joe co hosts joe scarborough mika brzezinski engaged,45,22,-23,67,0.6716417910447762,-0.34328358208955223,1
15632759,ELLEUK,1791,1175762,6539,101811,0,0,47,20,the official twitter account elle uk first fashion feminism beauty shopping celebrity news trends,kim kardashian begs tristan thompson to unblock her on instagram following cheating scandal^reese witherspoon teases the very first details of 'legally blonde^katie holmes finally breaks silence over jamie foxx split rumours^taylor swift political post was followed by a huge surge in voter registration^kim kardashian is reportedly 'not surprised but 'embarrassed by kanye west maga rant^kate middleton receives hugs from school pupils during first official engagement since maternity leave^lady gaga reveals heartbreaking reason she split taylor kinney^a complete timeline of brad pitt and jennifer aniston relationship^miley cyrus and liam hemsworth have reportedly broken up again^pippa middleton announces her pregnancy in a fitness column^trump has no idea why civil war happened twitter has field day^kim kardashian denies hooking up with drake 'never happened^selena gomez may have sent secret message justin bieber her latest instagram^kendall jenner reveals she was on the 'verge of a mental breakdown in^kim kardashian trolling her own bikini pic on instagram is everything^angelina jolie is reportedly secretly dating a handsome regular older looking real estate agent^khlo kardashian is boycotting facetime because of baby true and the elanation is hilarious^dakota johnson wows in red dior couture gown at the venice film festival 'suspiria premiere^jennifer garner is reportedly not pleased or 'surprised ben affleck is dating a year old playboy model^the full list of winners at the golden globes^caitlyn kendall and kylie jenner skipped brody jenner wedding but where were they^how to win a breakup according to selena gomez kourtney kardashian and cazzie david^how kourtney kardashian is actually feeling about her younes bendjima breakup^chris martin and dakota johnson are officially dating^katy perry said the shadiest thing about taylor swift on american idol^angelina jolie breaks her silence divorce^kim kardashian recalls 'tough conversation with khlo about tristan thompson cheating scandal^kylie jenner wants everyone to know that she 'never misses a night with travis scott^travis scott pleads guilty to disorderly conduct days after birth of daughter stormi^kendall jenner caught kissing and straddling anwar hadid for two hours following cfda awards^meghan markle might have dropped the biggest hint she moving to the uk for prince harry^meghan markle and prince harry are moving house to frogmore cottage^prince harry and meghan markle rumored to be moving tothe countryside^selena gomez amp justin theroux may be more than just friends^rachel weisz and daniel craig just welcomed their first baby together^angelina jolie and brad pitt reportedly have 'secret meeting to call a truce amid custody battle^meghan markle reveals she excited to meet her 'little one and 'join the club following baby announcement^meghan markle could n't be more excited for priyanka chopra and nick jonas engagement^meghan markle just dropped her own major royal baby hint ahead of royal wedding^meghan markle just dropped her own major royal baby hint ahead of royal wedding^khlo kardashian says watching the 'kuwtk cheating episode made her 'pissed again^selena gomez amp justin theroux may be more than just friends^meghan markle will spend her first royal birthday at a wedding with prince harry^ariana grande and pete davidson a relationship timeline of their whirlwind romance^katy perry said the shadiest thing about taylor swift on american idol^selena gomez new song 'back you is here and full of justin bieber inspired lyrics^is justin bieber trying to win selena gomez back with this titanic inspired pose^enrique iglesias anna kournikova welcome twins after dating years^the weeknd and bella hadid spotted kissing all night at coachella party^kate middleton catches princess charlotte as she falls on buckingham palace balcony^ellen page accuses brett ratner 'homophobic abusive behavior^rachel mcadams is reportedly pregnant with her first child^golden globes the best beauty looks^everything we know so far about pippa middleton wedding^taylor swift releases 'reputation track list after it leaks online and it everything we always wanted^prince william recalls how he earned street cred with prince george^princess charlotte net worth is more than prince george and here why^everything you need to know about princess eugenie amp jack brooksbank royal wedding^princess eugenie and jack brooksbank royal wedding everything you need to know^bradley cooper irina shayk welcome their first child^michelle williams is reportedly engaged to andrew youmans^alicia vikander and michael fassbender 'honeymoon in italy after secret wedding^khlo kardashian confesses she thinks about getting a nose job 'every day^gigi hadid slams body shamers calling her 'too skinny at nyfw^bella hadid and the weeknd were just spotted kissing at cannes film festival^kate middleton shines in cream alexander mcqueen dress at prince louis christening^royal wedding prince william looks adorable as prince harry best man,47,20,-27,67,0.7014925373134329,-0.4029850746268657,1
18956073,dcexaminer,204,180506,3985,426694,6,54,0,6,political news commentary washington examiner,miley cyrus calls donald trump f king nightmare^miley cyrus calls donald trump f king nightmare^miley cyrus 'donald trump f king nightmare^new york subway bombing suspect taunted trump facebook prior attack trump failed protect nation^new york subway bombing suspect taunted trump facebook prior attack trump failed protect nation^if notorious willie horton ad must referenced every time news media mention former president george h.w^video sarah palin cpac speech sarah palin thrilled cpac attendees speech yesterday^palin cpac crowd shout occupy hecklers occupy hecklers tried disrupt sarah palin cpac speech ...^amy klobuchar asked centers disease control prevention investigate rare polio like illness sp^amy klobuchar asked centers disease control prevention investigate rare polio like illness sp^the head centers disease control prevention stressed necessary remove stigma around ad^amy klobuchar asked centers disease control prevention investigate rare polio like illness sp^obama tweets 'good point mitt romney calls gun control^obama tweets 'good point mitt romney calls gun control^obama tweets 'good point mitt romney calls gun control via^obama tweets 'good point mitt romney calls gun control^the nation largest pediatrics group says time doctors start counseling parents children^social security unfunded liabilities rise 12.5 trillion according trustees report^social security unfunded liabilities rise 12.5 trillion according trustees report^endangered republican highlights opioid abuse legislation weekly address^trump refuse interview robert mueller gets info fbi informant says rudy giuliani^rudy giuliani flips says would prefer trump sit interview special counsel^rudy giuliani clinton set precedent short trump interview mueller^rudy giuliani flips says would prefer trump sit interview special counsel^rudy giuliani flips says would prefer trump sit interview special counsel^trump refuse interview robert mueller gets info fbi informant says rudy giuliani^bernie sanders campaign manager says considering presidential run^full letter house oversight committee reps. jason chaffetz elijah cummings office government ethics^president trump election campaign picked bob paduchik co chairman republican national committe^already torrid fundraising pace heading crucial congressional midterm elections next month republica^republican national committee dismisses democratic majority ripple^republican national committee raises 269m cycle best midterm ever^president trump election campaign picked bob paduchik co chairman republican national committe^already torrid fundraising pace heading crucial congressional midterm elections next month republica^president trump election campaign picked bob paduchik co chairman republican national committe^president trump requested republican national committee chairwoman ronna mcdaniel remain head th^already torrid fundraising pace heading crucial congressional midterm elections next month republica^president trump election campaign picked bob paduchik co chairman republican national committe^president trump requested republican national committee chairwoman ronna mcdaniel remain head th^president trump requested republican national committee chairwoman ronna mcdaniel remain head th^the nbc news/wall street journal poll found democrats hold percentage point advantage republicans fro^paul ryan invite putin address joint session congress comes washington fall^amy klobuchar asked centers disease control prevention investigate rare polio like illness sp^amy klobuchar asked centers disease control prevention investigate rare polio like illness sp^the head centers disease control prevention stressed necessary remove stigma around ad^amy klobuchar asked centers disease control prevention investigate rare polio like illness sp^campaign roundup obama new ad black radio^watch live trump holds campaign rally in las vegas^watch live tim kaine speaks campaign rally hillary clinton las vegas^watch live trump holds campaign rally in las vegas^watch live sarah sanders holds daily white house press briefing^there lot ways describe cnn jim acosta shows white house press briefing or^there lot ways describe cnn jim acosta shows white house press briefing or^there lot ways describe cnn jim acosta shows white house press briefing or^there lot ways describe cnn jim acosta shows white house press briefing or^watch live sarah sanders holds white house press briefing^watch live donald trump delivers remarks gop retreat philadelphia^watch live donald trump delivers remarks gop retreat philadelphia^watch live donald trump delivers remarks gop retreat philadelphia^watch live donald trump delivers remarks gop retreat philadelphia^breaking anthony weiner sentenced months prison sexting minor^just in tom brady skip new england patriots white house visit citing personal family matters^weinstein company file bankruptcy^judge declares mistrial bill cosby sexual assault case^judge declares mistrial bill cosby sexual assault case^judge declares mistrial bill cosby sexual assault case,6,60,54,66,0.09090909090909093,0.8181818181818182,0
66237835,AOL,3306,170733,2136,220406,2,5,36,21,discover today biggest news stories read,fake news claims malia obama eelled harvard drug violation^malia obama arrested 'gang thugs chicago fake news site claims^look most popular baby names state via^most popular baby names state^here ten things you need know today questions about mccain unannounced trip newborn rescued from toilet pipe^here ten things you need know today questions about mccain unannounced trip newborn rescued from toilet pipe^here ten things you need know today questions about mccain unannounced trip newborn rescued from toilet pipe^it official blake shelton gwen stefani cutest bbmas^how caitlyn jenner secretly fighting trump white house transgender rights^hannibal buress arrested disorderly intoxication miami^justin theroux stayed guest house jennifer aniston split^jennifer lopez alex rodriguez visit old stomping ground yankee stadium see pic^inside julia roberts danny moder really solid loving marriage^inside julia roberts danny moder really solid loving marriage^ellen degeneres wife portia de rossi makes cry th birthday gift^brad pitt steals show white uniform auto race^ellen degeneres wife portia de rossi makes cry th birthday gift^chris brown smashes window after 'gma interview 'everyone was terrified says insider /by^ben affleck jennifer garner settle divorce three years split report^pregnant khloe kardashian says baby mend relationship caitlyn jenner^'today anchors savannah guthrie hoda kotb dish ister like friendship^a star is born film review bradley cooper lady gaga reinvigorate classic^kourtney kardashian spotted ex younes bendjima month breakup^the biggest celebrity feuds^bffs nicole comes angelina aid messy brad pitt divorce drama drags^the biggest celebrity feuds^bffs nicole comes angelina aid messy brad pitt divorce drama drags^portia de rossi ellen divorce rumors make us feel 'accepted^larry david snl holocaust joke ripped anti defamation league offensive insensitive^david victoria beckham lead different lives works^prince harry praises prince charles walking meghan markle aisle royal wedding^jennifer aniston divulges 'truth behind relationship justin theroux^jennifer aniston divulges 'truth behind relationship justin theroux^jennifer aniston divulges 'truth behind relationship justin theroux^jennifer aniston divulges 'truth behind relationship justin theroux^jennifer aniston divulges 'truth behind relationship justin theroux^jennifer aniston divulges 'truth behind relationship justin theroux^jennifer aniston reveals 'truth behind relationship justin theroux^nick cannon quitting 'america got talent 'one best decisions i ever made career^heidi klum shows insane bikini body jumping ocean next rainbow watch^report reese witherspoon 'furious 'big little lies co star nicole kidman^how caitlyn jenner secretly fighting trump white house transgender rights^the biggest celebrity feuds^caitlyn jenner confirms n't spoken kim kardashian 'in long time 'i keep distance^'fixer upper stars chip joanna gaines address reports sold texas farmhouse^courtney love warned young women harvey weinstein^amy schumer hospitalized 'horrible kidney infection^jenny slate joins chris evans family christmas^tony awards nominations the complete list^ariana grande ex mac miller opens breakup moving 'i happy^former fox news ceo roger ailes dead^jennifer lawrence darren aronofsky split^meghan markle arrives prince harry pippa middleton wedding reception^meghan best friend jessica mulroney pippa middleton royal wedding^jennifer lopez alex rodriguez reportedly already talking marriage^labor day the best sales shop^'game thrones stars kit harington rose leslie are married^brooke burke breaks silence divorce david charvet^katharine mcphee david foster engaged^'icarly star nathan kress eecting first child wife london 'our hearts full^jennifer aniston justin theroux barely spoken since split^lorde says taylor swift squad still considers friend^meghan markle admits misses 'suits ahead show season premiere^counting on josiah duggar engaged lauren swanson,38,26,-12,64,0.59375,-0.1875,1
23228670,MSN_Entertain,1175,51647,570,41235,0,0,49,15,follow entertainment celebrity news views gossip photos msn entertainment,cheating rumors hit jennifer lopez alex rodriguez plus news^jessica simpson shows baby bump nyc pregnancy reveal^jessica simpson cradles baby bump plus celeb pics^kathy griffin gets restraining order against neighbor jeffrey mezger ceo of kb homes^how church scientology seemingly protected danny masterson amid rape allegations^matt lauer inching 'his way back society 'today ousting^channing tatum jenna dewan split nearly years marriage^selena gomez gets kidney transplant fergie josh duhamel split icymi news^did fergie josh duhamel split trust issues plus news^fergie josh duhamel differences were 'a factor split 'this has been long time coming says source^chris pratt amy poehler dating^when did ben affleck lindsay shookus start dating the complicated timeline their romance^kate hudson dumped pregnant what really going^kate hudson dumped pregnant what really going^justin theroux bikes around nyc plus celeb pics^mark hamill asks 'star wars fans lobby carrie fisher star^lorde sets record straight taylor swift friendship fiery letter^suri cruise 'desperate see dad tom cruise what really going^beyonce did not reject kim kardashian baby gifts despite report^angelina jolie brad pitt still fighting custody plus news^kim kardashian 'upset kanye said 're moving chicago news^katie holmes jamie foxx war tom cruise what going^channing tatum jenna dewan split nearly years marriage^jessica simpson shows baby bump nyc pregnancy reveal^jessica simpson cradles baby bump plus celeb pics^why katie holmes jamie foxx never leave dinner date together^kourtney kardashian ex till bitter breakup^jennifer aniston 'revenge ex what really going^jamie foxx spied visiting katie holmes n.y.c amid romantic summer^katie holmes coordinates suri mother daughter breakfast date^christina aguilera engaged boyfriend matt rutler^jennifer aniston chelsea handler still friendly despite feud reports^julia roberts shares rare pda pic husband danny moder see^jamie foxx spied visiting katie holmes n.y.c amid romantic summer^katie holmes coordinates suri mother daughter breakfast date^teri hatcher denies 'broke homeless living van^teri hatcher denies 'broke homeless living van^tom petty dead celebrities react^christina el moussa joining 'real housewives series^angelina beams grocery run kids amid battle brad pitt^brad pitt angelina jolie could messy custody battle get worse^brad pitt angelina jolie get trial date their custody battle^brad pitt ickened angelina jolie public custody battle source^teri hatcher denies 'broke homeless living van^teri hatcher denies 'broke homeless living van^are amy schumer john mayer dating^selena gomez 'chose happiness justin bieber source^justin theroux bikes around nyc plus celeb pics^bradpitt plans quit acting three years^enrique iglesias anna kournikova secretly welcome twins^kelly clarkson 'when i really skinny i wanted kill^naya rivera refiles divorce ryan dorsey arrest^summer phoenix reportedly files divorce casey affleck^chip joanna gaines welcome baby no^will ferrell reveals his least favorite saturday night live sketch all time^brooke burke files divorce david charvet plus news^billy bush wife sydney davis files divorce^portia de rossi elains wife ellen degeneres quit acting^eliza dushku is engaged boyfriend peter palandjian see sweet announcement^josh duhamel eiza gonz lez pack pda mexico^miss america winner cara mund things know about north dakota native^josh duhamel defends fergie national anthem performance^luann de lesseps sued kids ex husband^leslie jones accuses ritz carlton racism they don like black people,49,15,-34,64,0.765625,-0.53125,1
252751061,tictoc,1251,803646,6367,153530,1,40,17,5,global news world live sign daily newsletter,rt news tucked snap earnings story cond nast shutting wired gq vogue channels snapchat cutting^u.s. secretary state pompeo brushed harshly worded north korean statement cast doubt outlook f^watch japan chief cabinet secretary yoshihide suga gives statement arrest nissan chairman carlos g^u.s. secretary state pompeo brushed harshly worded north korean statement cast doubt outlook f^u.s. secretary state pompeo brushed harshly worded north korean statement cast doubt outlook f^u.s. secretary state pompeo brushed harshly worded north korean statement cast doubt outlook f^u.s. secretary state pompeo brushed harshly worded north korean statement cast doubt outlook f^watch japan chief cabinet secretary yoshihide suga gives statement arrest nissan chairman carlos g^u.s. secretary state pompeo brushed harshly worded north korean statement cast doubt outlook f^the idea option renegotiating th hour simply delusion chancellor philip ha^latest update papa john founder face new allegations israel passes contentious jewish nation bill putin invi^what 'formula rudy giuliani say robert mueller offered interview president find listening tictoc podcast^truth truth says trump lawyer rudy giuliani elaining interview special counsel mueller^truth truth says trump lawyer rudy giuliani elaining interview special counsel mueller^hush money paid stormy daniels silence alleged affair trump perfectly legal rudy giuliani says^michael cohen resigned republican national committee tictocnews^michael cohen resigned position republican national committee sources say^michael cohen resigned republican national committee tictocnews^just in a leaked poll republican national committee shows november midterms referendum o^michael cohen resigned republican national committee tictocnews^michael cohen resigned republican national committee tictocnews^michael cohen resigned republican national committee tictocnews^michael cohen resigned republican national committee tictocnews^in exclusive interview bloomberg trump commented death sen. john mccain^in exclusive interview bloomberg trump commented death sen. john mccain^facebook ceo mark zuckerberg prepared testimony house committee energy commerce released^of course national economic council director larry kudlow says trump still speaking terms chie^in exclusive interview bloomberg trump commented death sen. john mccain^watch monday white house press briefing live tictocnews :30 p.m et^soon sarah sanders holds monday white house press briefing tictocnews watch live :30 p.m. et^live white house press briefing sarah sanders tictocnews^watch the white house brings one turkeys set pardoned ceremony press briefing room^watch monday white house press briefing live tictocnews :45 p.m et^live sarah sanders holds first white house press briefing week tictocnews^live sarah sanders holds first white house press briefing weeks hours trump said russia^now sarah sanders holds first white house press briefing weeks tictocnews watch live^live sarah sanders holds first white house press briefing week tictocnews^soon sarah sanders holding first white house press briefing days hours trump said russia isn't^here full page list goods u.s. trade representative website^here full page list goods u.s. trade representative website^live house minority leader nancy pelosi holds weekly news conference amid report set meet u.s.^rolls royce looking create leaner london head office smaller location accessible the^rolls royce looking create leaner london head office smaller location accessible the^british pomp circumstance full display wedding prince harry meghan markle recap^british pomp circumstance full display wedding prince harry meghan markle recap^british pomp circumstance full display wedding prince harry meghan markle recap^british pomp circumstance full display wedding prince harry meghan markle recap^british pomp circumstance full display wedding prince harry meghan markle recap^british pomp circumstance full display wedding prince harry meghan markle recap^john mccain trump rocky relationship here timeline feud tictocnews^it secret john mccain trump rocky relationship here timeline feud tictocnews^it secret john mccain trump rocky relationship here timeline feud tictocnews^john mccain trump rocky relationship here timeline feud tictocnews^john mccain trump rocky relationship here timeline feud tictocnews^latest update at least killed elosion college crimea pompeo erdogan meet turkey discu^latest update rescuers look still missing hurricanemichael flash floods kill least sou^latest update rescuers look still missing hurricanemichael flash floods kill least sout^latest update rescuers look still missing hurricanemichael trump says scientists polit^harvey weinstein arrested processed charged rape criminal sex act sex abuse sexual misco^harvey weinstein arrested charged rape criminal sex act sex abuse sexual misconduct his la^update harvey weinstein arrested processed charged rape criminal sex act sex abuse sexual misc^here tictoc japan 150 chicken skewers coming new york city b^live ousted uber ceo travis kalanick plans sell 1.4 billion shares plus how states already gaming the,18,45,27,63,0.2857142857142857,0.42857142857142855,0
15651634,kmbc,1717,166465,1579,322591,3,11,18,31,kansas city breaking news weather channel,"melania trump undergoes kidney surgery walter reed medical center^people found dead ohio^people found dead ohio^two kansas city medical students raising awareness centers disease control prevention recommended^president trump tempers iran rhetoric speech vfw convention^president trump tempers iran rhetoric speech vfw convention^president trump tempers iran rhetoric speech vfw convention^two kansas city medical students raising awareness centers disease control prevention recommended^most popular baby names every u.s. state^most popular baby names every u.s. state^most popular baby names every u.s. state^most popular baby names every u.s. state^us slaps 50 billion tariffs chinese goods escalating trade dispute^us slaps 50 billion tariffs chinese goods escalating trade dispute^what roseanne barr net worth^what roseanne barr net worth^what roseanne barr net worth^what roseanne barr net worth^megyn kelly weighs matt lauer fired 'today show^megyn kelly weighs matt lauer fired 'today show^david cassidy fighting memory loss wants 'enjoy life^david cassidy fighting memory loss wants 'enjoy life^is kim kardashian pursuing music career^tonya harding made 'dancing with stars finale fans livid^tonya harding made 'dancing with stars finale fans livid^tonya harding made 'dancing with stars finale fans livid^tonya harding made 'dancing with stars finale fans livid^george clooney makes 27,283 every hour thanks tequila^mariah carey new year eve performance 'they foiled^'free speech rally 'fight supremacy groups set converge boston common^caitlyn jenner latest celebrity float run office^brad pitt plans to quit acting in years actor brad pitt says plans stop acting three years he ...^koko gorilla knew sign language dies^koko gorilla knew sign language dies^james franco event canceled actor denies allegations sexual misconduct^playboy founder hugh hefner cause death revealed^playboy founder hugh hefner cause death revealed^playboy founder hugh hefner cause death revealed^playboy founder hugh hefner cause death revealed^mindy kaling reportedly pregnant first child^mindy kaling reportedly pregnant first child^mindy kaling reportedly pregnant first child^'clueless actress stacey dash running congress california^'clueless actress stacey dash running congress california^'clueless actress stacey dash running congress california^'clueless actress stacey dash running congress california^kaley cuoco marries karl cook intimate horse ranch wedding^kaley cuoco marries karl cook intimate horse ranch wedding^kaley cuoco marries karl cook intimate horse ranch wedding^kaley cuoco marries karl cook intimate horse ranch wedding^discovery channel 'storm chasers star joel taylor dead^discovery channel 'storm chasers star joel taylor dead^discovery channel 'storm chasers star joel taylor dead^discovery channel 'storm chasers star joel taylor dead^billboard music awards check complete list winners^billboard music awards check complete list winners^netflix is reportedly reviving carmen sandiego with gina rodriguez^reese witherspoon confirms 'legally blonde happening^reese witherspoon confirms 'legally blonde happening^reese witherspoon confirms 'legally blonde happening^april giraffe pregnant^april giraffe pregnant^april giraffe pregnant",21,42,21,63,0.3333333333333333,0.3333333333333333,0
20252482,WISN12News,924,92004,1372,346720,3,8,23,29,wisn12 southeast wisconsin affiliate a television station follow newsroom,"melania trump undergoes kidney surgery walter reed medical center^people found dead ohio^people found dead ohio^the republican national committee announced republican national convention charlotte n.c. wi^milwaukee bid democratic national convention formally submitted today committee thinks^most popular baby names every u.s. state^most popular baby names every u.s. state^most popular baby names every u.s. state^us slaps 50 billion tariffs chinese goods escalating trade dispute^us slaps 50 billion tariffs chinese goods escalating trade dispute^us slaps 50 billion tariffs chinese goods escalating trade dispute^tonight reese witherspoon talks legally blonde do n't miss etnow wisn12^what roseanne barr net worth^megyn kelly weighs matt lauer fired 'today show^megyn kelly weighs matt lauer fired 'today show^david cassidy fighting memory loss wants 'enjoy life^david cassidy fighting memory loss wants 'enjoy life^icymi david cassidy fighting memory loss wants 'enjoy life^tonight new details fergie josh duhamel split don miss etnow wisn12^tonight miley cyrus liam hemsworth secretly get married don miss etnow wisn12^tonya harding made 'dancing with stars finale fans livid^tonya harding made 'dancing with stars finale fans livid^tonya harding made 'dancing with stars finale fans livid^tonya harding made 'dancing with stars finale fans livid^following good morning america co anchor michael strahan exclusive interview omarosa manigault newman fello^today welcomes worldofdance stars amp the waffle house shooting hero ja^today welcomes gma host amp nfl legend interview amp performance at^tomorrow welcomes gma host amp nfl legend interview amp performance^george clooney makes 27,283 every hour thanks tequila^mariah carey new year eve performance 'they foiled^'free speech rally 'fight supremacy groups set converge boston common^tonight new details angelina jolie brad pitt custody battle do n't miss etnow wisn12^caitlyn jenner latest celebrity float run office^today regis philbin is rach co host who cooking up jewish spaghetti pm wisn12^koko gorilla knew sign language dies^koko gorilla knew sign language dies^james franco event canceled actor denies allegations sexual misconduct^playboy found hugh hefner cause death revealed^playboy founder hugh hefner cause death revealed^playboy founder hugh hefner cause death revealed^mindy kaling reportedly pregnant first child^mindy kaling reportedly pregnant first child^mindy kaling reportedly pregnant first child^'clueless actress stacey dash running congress california^'clueless actress stacey dash running congress california^'clueless actress stacey dash running congress california^'clueless actress stacey dash running congress california^kaley cuoco marries karl cook intimate horse ranch wedding^kaley cuoco marries karl cook intimate horse ranch wedding^kaley cuoco marries karl cook intimate horse ranch wedding^discovery channel 'storm chasers star joel taylor dead^discovery channel 'storm chasers star joel taylor dead^discovery channel 'storm chasers star joel taylor dead^discovery channel 'storm chasers star joel taylor dead^billboard music awards check complete list winners^billboard music awards check complete list winners^netflix is reportedly reviving carmen sandiego with gina rodriguez^netflix is reportedly reviving carmen sandiego with gina rodriguez^reese witherspoon confirms 'legally blonde happening^reese witherspoon confirms 'legally blonde happening^april giraffe pregnant^april giraffe pregnant^april giraffe pregnant",26,37,11,63,0.4126984126984127,0.1746031746031746,0
47862321,9HoneyCelebrity,763,10012,124,26815,0,0,40,23,entertainment news videos exclusives australia around world,jessica alba apologises leslie jones comedian complaint company^defends sister kylie jenner forbes magazine cover arguing family self made^defends sister kylie jenner forbes magazine cover arguing family self made^chris pratt files divorce anna faris^nicole kidman brought keith urban daughters cats film festival^kim kardashian returns white house talk prison reform^hannibal buress arrested miami disorderly intoxication^katie couric finally speaks matt lauer 'today firing^admits rumours marriage 'hurt feelings^justin bieber reportedly 'not selena gomez even though married hailey baldwin^jimmy fallon caught repeatedly making joke cringey supercut video^khloe kardashian says new baby wo n't mend distant relationship caitlyn jenner^khloe kardashian says new baby wo n't mend distant relationship caitlyn jenner^angelina jolie opens divorce brad pitt 'i n't enjoy single^flaunts rock hard abs post breakup bikini snap^shots fired tekashi ix9ine video shoot los angeles kanyewest^robert pattinson looks miserable sydney kristen stewart actually smiling japan^angelina jolie brad pitt divorce all details brangelina^lindsay lohan make us tv comeback mtv reality series^have 'bachelor paradise exes keira maguire jarrod woodgate reunited^'bachelor paradise star laurina fleure says shane warne 'dirty refused flirt him^brooke blurton cassandra wood confirmed next season 'bachelor in paradise australia^'bachelor paradise the confirmed contestants returning find love ...^brooke blurton cassandra wood confirmed next season 'bachelor in paradise australia'^tiffany scanlon blasts 'bachelor paradise revealing dropped season^newly engaged recreate meghan markle prince harry engagement photo twinning^jennifer lawrence rob kardashian apparently dating^'desperate housewives star teri hatcher slams report claiming 'broke homeless^angelina jolie brad pitt divorce all details brangelina^hollywood reacts matt lauer firing 'do n't let door hit way^rachel weisz james bond star daniel craig welcome first child together^how brad pitt maintains bond children amid custody battle angelina jolie^'desperate housewives star teri hatcher slams report claiming 'broke homeless^khlo kardashian relive tristan thompson cheating scandal 'i 'm get pissed kuwtk^katy perry reportedly furious taylor swift sharing apology letter online^report jessica simpson pregnant already^billy connolly hits back 'daft old fart michael parkinson claims health^heidi klum flaunts bikini body holiday ... nipple slip^pitch perfect ruby rose reveals rebel wilson stole limelight set^kendall jenner ben simmons 'cooled^'chicago fire star dushon monique brown cause death revealed^rachel weisz pregnant eecting first child husband daniel craig^chris pratt wrote foreword anna faris new book announcing separation^breaks silence engagement lengthy instagram post^sam smith coming gender identity 'i feel much woman i man^kevin spacey replaced christopher plummer 'all money world weeks release^new 'house cards trailer shows kevin spacey character frank underwood officially killed political^'mean girls star rachel mcadams pregnant first child^portia de rossi says steven seagal unzipped pants audition^kim cattrall brother found dead reported missing^mindy kaling pregnant first child 'an uneected surprise^jonathan rhys meyers detained police alleged domestic dispute plane^colin farrell checks rehab preemptive measure amid relapse fears^queer eye tom jackson remarries ex wife abby parr secret ceremony^engaged joshua kushner future sister law^dwayne johnson huge crush frances mcdormand wants 'marry sweet gesture^big bang theory star kaley cuoco marries karl cook stunning ceremony^'breaking bad star aaron paul wife lauren welcome first child^'7th heaven actor jeremy london arrested domestic violence^denies amber rose claim jay z mistress 'becky good hair'.^khloe kardashian 'embarrassed ready forgive tristan thompson cheating^tommy lee engaged former vine star brittany furlan ring stunning^chris pratt files divorce anna faris,40,23,-17,63,0.6349206349206349,-0.2698412698412698,1
15864446,NBCNewYork,1986,292479,4605,206484,4,3,14,41,get breaking news storm team weather updates plus stories new york biggest investigative unit news tip question tips.com,according federal complaint bombing suspect posted facebook trump failed protect natio^kim kardashian shutting rumors cocaine use twitter users say caught snapchat video^kim kardashian shutting rumors cocaine use twitter users called snapchat video^kim kardashian shutting rumors cocaine use twitter users say caught snapchat video^salmonella raw chicken made people sick across states centers disease control preventio^salmonella raw chicken made people sick across states centers disease control preventio^giuliani sends top adviser new hampshire gauge interest possible presidential bid^white house releases statement kellyanne conway telling americans go buy ivanka stuff sparks backlash^brad pitt opened first time divorce angelina jolie fighting kids^brad pitt opened first time divorce angelina jolie fighting kids^brad pitt opened first time divorce angelina jolie fighting kids^shots fired set tekashi ix9ine nicki minaj kanye west music video^angelina jolie breaks silence difficult brad pitt divorce^angelina jolie breaks silence difficult brad pitt divorce^angelina jolie breaks silence difficult brad pitt divorce^this flowers royal wedding prince harry meghan markle ended^angelina jolie brad pitt headed court custody battle six children^angelina jolie brad pitt headed court custody battle six children^angelina jolie brad pitt headed court custody battle six children^angelina jolie brad pitt headed court custody battle six children^angelina jolie brad pitt headed court custody battle six children^the game thrones season trailer promises great war^avicii family implies died apparent suicide^avicii family implies died apparent suicide^avicii family implies died apparent suicide^miley cyrus retracts apology nude vanity fair portrait^heather locklear arrested time allegedly attacking cop emt^matt damon apologizes comments sexual misconduct says wish listened speaking t^breaking 'superman star margot kidder dead she 'll always remembered lois lane^meghan markle half sister fires back prince harry family remarks^anthony bourdain alcohol narcotics body time death prosecutor says^anthony bourdain alcohol narcotics body time death prosecutor says^amber heard slammed racist tweet ice checkpoint^amber heard slammed racist tweet ice checkpoint^amber heard slammed racist tweet ice checkpoint^amber heard slammed racist tweet ice checkpoint^amber heard slammed racist tweet ice checkpoint^amber heard slammed racist tweet ice checkpoint^amber heard slammed racist tweet ice checkpoint^amber heard slammed racist tweet ice checkpoint^amber heard slammed racist tweet ice checkpoint^james franco accused sexual misconduct five women including four former students one mentee^it official becca kufrin next bachelorette and safe say america rooting f^the discovery channel storm chasers star joel taylor dead age according friends^the discovery channel storm chasers star joel taylor dead age according friends^the discovery channel storm chasers star joel taylor dead age according friends^home carrie fisher debbie reynolds lived sold numerous personal items hitting auction block^victoria mahoney star wars movies first black female director^actress jaime king attacked man smashes car window son inside^watch jimmy kimmel cries pays tribute late don rickles^watch jimmy kimmel cries pays tribute late don rickles^actresses protest sexual harassment wearing black golden globes^brigitte nielsen pregnant baby^jersey shore star mike the situation sorrentino pleads guilty tax fraud case^kylie jenner pregnant according reports^april giraffe pregnant and yes oliver father here look back love story^april giraffe pregnant and yes oliver father here look back love story^april giraffe pregnant and yes oliver father here look back love story^april giraffe pregnant and yes oliver father here look back love story^april giraffe pregnant and yes oliver father here look back love story^april giraffe pregnant and yes oliver father here look back love story^april giraffe pregnant and yes oliver father here look back love story,18,44,26,62,0.2903225806451613,0.41935483870967744,0
9763482,NYDailyNews,1604,716896,10976,261150,0,1,25,36,new york hometown paper breaking news national ny lens politics sports entertainment nyc beyond about us,pornhub viewership dropped first presidential debate biggest drops democratic swing states^kendall jenner shot speculation pregnant^chris pratt officially files divorce anna faris^chris brown soulja boy feud social media karrueche tran^brad pitt angelina jolie rigid prenuptial agreement detailing 400m fortune split^fired today host matt lauer says seen easy mark aftermath sexual misconduct scandal.^fired today host matt lauer agrees give ex 20 million divorce settlement^jenna bush hager emotionally apologizes hidden fences blunder golden globes^video comedian hannibal buress arrested disorderly intoxication miami^fergie josh duhamel trying another baby split^justin bieber hailey baldwin spark rumors 're already married^revealed taylor swift we are never ever getting back together jake gyllenhaal report^host new hour good morning america^miley cyrus regrets wrecking ball music video i 'm never living^a german actress claims harvey weinstein raped hotel room cannes film festival .^brody jenner destination wedding missing practically famous family^tom identity katie holmes mystery man revealed photos^katie holmes mystery man revealed photos^host new hour good morning america^dancing with stars judge carrie ann inaba tapped host miss america competition.^kanye west new basketball sneaker may banned nba^oprah kidding running president says gayle king^jennifer aniston heartbroken months justin theroux divorce^watch live the oscars nominations see full list academy award nominees^reese witherspoon reportedly furious nicole kidman failing promote new show big little lies^british man allergic i get teary want retch moran^live audience members speak decision new co host^wife eniko parrish eecting first child together^a second suspect arrested murder rapper xxxtentacion^update anthony weiner sentenced months prison sexting minor^robert pattinson opens nearly fired twilight becoming bit sellout^meet playboy first transgender playmate ines rau^meet playboy first transgender playmate ines rau^eat pray love author elizabeth gilbert partner rayya elias dies^bristol palin reportedly joins cast teen mom og^a second suspect arrested murder rapper xxxtentacion^lindsay lohan bitten snake hike thailand^nelly criminal investigation uk alleged sexual assault^prince charles walk meghan markle aisle royal wedding^tina turner oldest son craig reportedly dead apparent suicide^kevin spacey frank underwood might written house cards^hugh hefner cause death revealed^supergirl star melissa benoist husband blake jenner finalize divorce^splitsville elle king says skipped wedding concert^my big fat greek wedding star lainie kazan reportedly arrested shoplifting san fernando valley grocery s^ashley judd sues harvey weinstein defamation sexual harassment^alia shawkat regrets defending 'arrested development co star jessica walter women voices need heard^alicia vikander michael fassbender married^former disney channel star orlando brown arrested following domestic family dispute^just in steven bochco creator 'hill street blues 'nypd blue 'l.a law dead age^jennifer lopez alex rodriguez already talking marriage report says^how get away murder star karla souza alleges raped violently attacked director early i^7th heaven party five star jeremy london arrested domestic violence^wwe star big van vader dead^katharine mcphee david foster engaged^jennifer aniston seems fine since split justin theroux^melyssa ford suffers skull fracture concussion horrific car crash^richard simmons recovering hospitalized severe indigestion^just in matt lauer fired nbc news inappropriate sexual behavior^it family affair britain royal officials say prince harry asked brother prince william bes^chris pratt officially files divorce anna faris^confirmed morning joe co hosts joe scarborough mika brzezinski engaged,25,37,12,62,0.4032258064516129,0.1935483870967742,0
34119271,vogueaustralia,758,175387,1496,41487,0,0,36,26,the official twitter home vogue australia,on list voguegamechangers prince harry meghan markle game changing humanitarians set^jennifer lawrence revealed reason behind darren aronofsky split new interview.^fergie josh duhamel split^currently celebrating th birthday mexico^six meghan markle approved travel destinations add bucket list^hair style file meghan duchess sussex^the baftas complete winners list eebaftas^kanye west remain hospital indefinitely^the emmy awards full winners list nicole kidman wins lead actress tv movie/limited series emmyawards.^the emmy awards full winners list emmyawards^the emmy awards full winners list emmyawards^are already married^currently celebrating th birthday mexico^hair style file meghan duchess sussex^is hailee steinfeld really dating justin bieber^is katy perry dating robert pattinson^angelina jolie breaks silence i n't enjoy single^dakota johnson chris martin definitely dating^dakota johnson chris martin dating^your first look charles manson new leonardo dicaprio film^hair style file catherine duchess cambridge see best hair styles^to celebrate his royal highness prince william birthday go inside wedding catherine duchess camb^hair style file catherine duchess cambridge see best hair styles^to celebrate his royal highness prince william birthday go inside wedding catherine duchess camb^kendall jenner broke tears pepsi commercial backlash^kendall jenner breaks tears response pepsi commercial backlash^kylie jenner reveals got lips done nasty comment boy^moving kensington palace live prince harry^new boyfriend meet partners husbands models^daniel craig rachel weisz welcomed baby girl^justin theroux spoken divorce jennifer aniston^your first look charles manson new leonardo dicaprio film^currently celebrating th birthday mexico^currently celebrating th birthday mexico^nicole kidman opens two miscarriages marriage tom cruise^your first look charles manson new leonardo dicaprio film^beyonc turned role disney remake beauty beast^rose byrne pregnant second child^met gala see every look red carpet arrivals themet metgala^meghan markle arrives london ahead pippa middleton wedding^the complete winners list fashion awards cfda cfdaawards^thomas markle appears bowed royal wedding could walk meghan markle aisle i^mindy kaling pregnant first child^gossip girl ed westwick accused sexual assault third woman^pippa middleton wedding everything know far^pippa middleton wedding everything know far^pippa middleton wedding everything know far^pippa middleton wedding everything know far^julia louis dreyfus reveals diagnosed breast cancer^alicia vikander michael fassbender married^jennifer lawrence darren aronofsky split one year^jennifer lawrence revealed reason behind darren aronofsky split new interview.^this prince harry meghan markle since pippa middleton wedding^prince harry drove miles get meghan markle pippa middleton wedding^this prince harry meghan markle since pippa middleton wedding^this prince harry meghan markle since pippa middleton wedding^c line dion poses naked vogue us^c line dion poses naked vogue us^michelle williams reportedly engaged andrew youmans^confirms secretly married last year^everything need know clare waight keller meghan markle wedding dress designer royalwedding^everything need know clare waight keller meghan markle wedding dress designer royalwedding,36,26,-10,62,0.5806451612903226,-0.16129032258064516,1
21217034,accessonline,5471,961258,5093,87081,0,0,41,21,celebrating seasons breaking entertainment news star-studded interviews hollywood hottest trends,jenniferlawrence reveals still loves ex darren aronofsky months split^it official confirms 'for sure love^living best life mykonos^despite falling kardashians looks like jenner amp kanye west keeping o^back scaring car time wearing mask^shares epic hilarious reaction longtime love stedman graham sparking presidency rumors^fergie josh duhamel putting family first split whatever takes make friendship work^so story a z victoria david beckham going anywhere the former spice girl addresses^princeharry happy introduce meghanmarkle aussie mini could n't help snap rare ro^it new era liam payne jokes still feels fragile split cheryl cole.^loves muse she shared sweetest video serenading hit lo^brad pitt fighting joint custody children divorce angelina jolie^summer lovin amp blast thevoice sweethearts best weekend ever hi^calling beliebers told us niece already got married to^no baby bump i love bagels def n't body^aw nicole kidman could n't help gush emmys speech see adorable reaction^ki ki love are riding and really the makeup mogul addressing rumors abo^obsessed man she missing apart one day^she starving biebs quick shoot dating rumors amp^honestly dakota johnson amp tilda swinton spooky new thriller looks *so* terrifying^a lesson if someone uses name calling bully ... n't defeat it can^kim kardashian upset fans reaction called anorexic^bringing heat mexico following recent breakup^this breakup lasted long kim first engagement ... ex younes bendjima already^shots fired near tekashi ix9ine kanye west music video shoot^another day another drama drama did katy perry reignite bad blood taylor swift swiftie auditione^this pretty woman busting break rumors julia roberts posts cuddly photo hubby amidst sp^no baby bump i love bagels def n't body^this pretty woman busting break rumors julia roberts posts cuddly photo hubby amidst sp^home sweet home bachelorinparadise stars amp officially moved together and^a special bachelorinparadise alum officiating jared wedding ceremony find w^did amp secretly tie knot watch^it getting serious prince harry meghan markle reportedly taking relationship next level and^says bff intrigued idea running president would want oprah presid^angelina jolie lawyer says brad pitt recent move child support battle blatant attempt ob^puts end feud rumors she fighting two female coaches al^puts end feud rumors she fighting two female coaches al^this drill twihards kristen stewart amp robert pattinson reportedly reunited one thing i abso^another day another drama drama did katy perry reignite bad blood taylor swift swiftie auditione^leaves little imagination tiny string chanel bikini ...^despite falling kardashians looks like jenner amp kanye west keeping o^a superhero screen reveals saved nephew life cpr.^will smith amp jada pinkett smith n't call married anymore relationship goes *way* deepe^confirms split nfl star danny amendola amp working getting breakup everybo^congrats engaged girlfriend cherry seaborn see cute announcement^yet another teenmom star faces legal trouble macibookout ex ryan edwards arrested heroin hou^jessica simpson confirms i 'm pregnant again^seth meyers ready to host the cfda fashion awards^nothing goals group from amp david beckham amp celeb^grammy predictions who will walk away a winner on music biggest night grammys^police say vince vaughn arrested suspicion dui^kimye paris kim kardashian returns paris first time since horrifying robbery^princeharry reveals 'wanted royal family could imagine monarchy without^yasss jennifer lawrence drunk alter ego named gail^kendall jenner admits little weird little sister kylie baby did.^we another royal wedding near future here everything know princess eugenie upcoming we^hang chrissy almost reveals pregnant ca n't wait h^contour game point still going knife eventually think^justintheroux ready publicly address life jenniferaniston first major interview since sp^let eat cake meghan markle amp prince harry reveal wedding cake details amp 're going big^meghanmarkle killin world favorite princess admits misses acting suits^ready scandal finale check cast talking huge episode watch gladiators,41,21,-20,62,0.6612903225806451,-0.3225806451612903,1
14294848,snopes,51,236463,4881,33086,55,3,3,0,the internet definitive factchecking resource,"fox star tucker carlson critical condition after head collision driving home^fact check fox star tucker carlson critical condition after head collision driving home full report^sarah palin calls boycott mall america because 'santa was always white bible^pence 'michelle obama is most vulgar first lady we 've ever had^fox sports cancels all nfl broadcasts until players respect flag^is jefferson davis statue replaced obama likeness^nfl fines pittsburgh steelers 1m each skipping national anthem^pat robertson gay people should wear specially colored clothes warn straight people^was texas church shooter atheist dnc payroll^was texas church shooter atheist dnc payroll^malia obama eelled harvard^liberal celebrities arrested conspiracy assassinate president trump^fact check did mike pence say allowing rape victims abortions lead women trying get raped f^fact check did mike pence say allowing rape victims abortions lead women trying get raped f^electoral college elector commits suicide avoid voting donald trump^snoop dogg arrested conspiracy after talking about murder trump video^was morgue employee cremated mistake while taking nap^morgue employee cremated mistake while taking nap^was morgue employee cremated mistake while taking nap^donald trump praises colonel sanders his service civil war^is snapchat shutting down^is snapchat shutting down end^more fake news jimmy carter say medical marijuana cured cancer^fact check tornado carries mobile home miles family inside unharmed read^fact check tornado carries mobile home miles family inside unharmed full report^tornado carries mobile home miles family inside unharmed^crew air force one refuses fly obama miles just play golf^australia becomes first country begin microchipping its public^fbi issues warrant obama arrest after confirming illegal trump tower wiretap^senate democrats demand supreme court nominee not be unduly influenced u.s. constitution^floyd mayweather jr. donates whopping sum money houston after hurricane^fact check will robert mueller forced resign affair nancy pelosi our story^fact check will robert mueller forced resign affair nancy pelosi our story^fact check will robert mueller forced resign affair nancy pelosi our story^did alabama state police arrest poll workers birmingham^did alabama state police arrest three poll workers birmingham voter fraud recent special election^did alabama state police arrest poll workers birmingham^was black hockey player fired for raising his fist during national anthem^fact check malia obama arrested gang thugs chicago full report^malia obama arrested gang thugs chicago^united airlines flight attendant slaps crying baby during flight^fact check was 'march our lives permit application made months parkland shooting full report^fact check was 'march our lives permit application made months parkland shooting full report^did melania hit donald trump shocking announcement he never saw coming^fact check did court order obama pay 400 million restitution full report^fact check did court order obama pay 400 million restitution full report^trump wants deport american indians india^the dea just raided united states senator dems panic^stephen bannon nobody can blame you beating your wife if it out love^fact check was nfl lawyer claimed super bowl rigged found dead our story^fact check was nfl lawyer claimed super bowl rigged found dead our story^fact check was nfl lawyer claimed super bowl rigged found dead our story^was white supremacist who killed protester democrat who visited obama oval office^fact check was white supremacist who killed protester democrat who visited obama oval office full report^cannibals arrested florida claim eating human flesh cures diabetes depression^overall million u.s. deaths nearly ,000 previous year ce^the discovery prompted public records requests liberal watchdog group american oversight executive dir^overall million u.s. deaths nearly ,000 previous year ce^neither brad pitt angelina jolie committed suicide^fact check dolly parton said california 'biblical disasters punishment 'embracing satan our story^fact check dolly parton said california 'biblical disasters punishment 'embracing satan our story",58,3,-55,61,0.9508196721311476,-0.9016393442622952,1
13850422,CNNPolitics,342,2909493,16118,160300,6,43,9,2,political news campaign stories washington coverage cnn political team,read the forecast harry enten cnn senior writer analyst harry enten it daily prediction of^read the forecast harry enten cnn senior writer analyst harry enten it daily prediction of^read the forecast harry enten cnn senior writer analyst harry enten it daily prediction of^the us house representatives set vote week bill give money security schools^breaking melania trump undergoes kidney surgery walter reed medical center eected remain hospitaliz^former president george h.w bush funeral train go texas a amp m university college station texas where^former us attorney preet bharara dictated donald trump jr. statement i think important thing tha^the georgia special election today high stakes battle president donald trump democrats^alabama high stakes senate election perfectly encapsulates age donald trump turned political logic^alabama high stakes senate election perfectly encapsulates age donald trump turned political logic^donald trump delivers weekly republican address^former vice president joe biden offer contrast president trump foreign policy speech london^former vice president joe biden offer contrast president trump foreign policy speech london^former vice president joe biden offer contrast president trump foreign policy speech london^just in rudy giuliani says president donald trump legal team responded special counsel robert mueller abo^rudy giuliani says special counsel robert mueller agreed narrow scope potential interview pres^sanders whether rudy giuliani harmed president trump former mayor interview fox news i bel^just in rudy giuliani says thinks president trump accepted ca n't wide ranging interview with^rudy giuliani says president donald trump legal team responded special counsel robert mueller poss^rudy giuliani says special counsel robert mueller agreed narrow scope potential interview pres^democratic sen. mazie hirono rudy giuliani negotiations potential trump interview special couns^the provocative lines rudy giuliani interview chris cuomo analysis cnn chris cillizza^rudy giuliani says president trump new legal team held lengthy preparations potential interview wit^vision the banking bill shows left divides sens elizabeth warren bernie sanders prep joint even^sen. bernie sanders campaign democratic candidates across country month planned e^vision the banking bill shows left divides sens elizabeth warren bernie sanders prep joint even^michael cohen resigns post republican national committee^michael cohen resigns post republican national committee^last interview sen. john mccain how want american people remember^a exclusive talks sen. john mccain first tv interview since return senate^watch key moments president donald trump first address joint session congress^french president emmanuel macron address joint session congress april part us visit^watch key moments president donald trump first address joint session congress^french president emmanuel macron address joint session congress april part us visit^the eye popping lines donald trump fox news sunday interview analysis cnn chris cillizza^the eye popping lines donald trump fox news sunday interview analysis cnn chris cillizza^the eye popping lines donald trump fox news sunday interview analysis cnn chris cillizza^the eye popping lines donald trump fox news sunday interview analysis cnn chris cillizza^the eye popping lines donald trump fox news sunday interview analysis cnn chris cillizza^last interview sen. john mccain how want american people remember^tune exit interview attorney general loretta lynch sen. john mccain^a exclusive talks sen. john mccain tomorrow first tv interview since return to^donald trump astonishing comments way g7 summit analysis cnn chris cillizza^donald trump astonishing comments way g7 summit analysis cnn chris cillizza^the life character john mccain words^the life character john mccain words^last interview sen. john mccain how want american people remember^the disappearing white house press briefing analysis cnn chris cillizza^peta plans sue us department agriculture animal welfare records^comedian leslie jones says america way president trump^comedian leslie jones says america way president trump^comedian leslie jones says america way president trump^of course oscars plenty political moments^of course oscars plenty political moments^the secret donald trump rudy giuliani know russia probe analysis cnn chris cillizza^the secret donald trump rudy giuliani know russia probe analysis cnn chris cillizza^gayle king says best friend oprah winfrey intrigued idea running president^caitlyn jenner latest celebrity float run political office^clueless actress stacey dash running congress california^clueless actress stacey dash running congress california,15,45,30,60,0.25,0.5,0
29721032,979WNCI,7303,20217,354,25141,0,0,29,31,columbus hit music station new music,robert pattinson on movie roles 'people are trying to put you in a box^sag awards nominations see full list of screen actors guild nominees^chris pratt files divorce from anna faris^sharon osbourne apologizes to justin bieber 'i was wrong to 'attack you^celebrities react trump withdraws steph curry white house invitation^beyonce not demanding silent delivery room despite report^celebrity reactions donald trump phoenix rally speech^katie couric said matt lauer pinched her on the ass on 'today back in^kendall jenner jealous ex^celebrities react to hurricane irma^katie holmes not pregnant and planning wedding with jamie foxx^sorry drake amp bella hadid are not 'secretly dating^kim kardashian sued for allegedly stealing lighting technique for selfies^kim kardashian sued for allegedly stealing lighting technique for selfies^celebrity reactions prince harry meghan markle engaged^hailee steinfeld responds to justin bieber dating rumors^robert pattinson amp katy perry are not dating^beyonce birth twins still hospital 'minor issue^did katy perry really diss taylor swift on american idol^meghan markle twins with kate middleton during outing with queen^joe jonas sophie turner 'already thinking of having kids is made up story^kim kardashian slams 'invasive surrogacy reports^jimmy fallon felt need to share 'heartfelt message about charlottesville^prince harry meghan markle royal wedding windsor castle many tender heartwarming moments^no zayn is not 'desperate to defend girlfriend gigi hadid^selena gomez reveals she had a kidney transplant amp her friend was her donor^did katy perry really diss taylor swift on american idol^obamas celebrate th anniversary after false split stories^mariah carey not dating both nick cannon and bryan tanaka despite report^here how help victims las vegas mass shooting^'woman year selena gomez talks kidney transplant justin bieber^ed sheeran is engaged longtime girlfriend cherry seaborn^million dollar listing fredrik eklund derek welcome twins^khlo kardashian makes her first public appearance since pregnancy news^the bachelor bekah m was on missing persons list until fan recognized her^'stranger things kids get big pay raise season^bachelor nick viall vanessa grimaldi split end engagement^rachel mcadams is reportedly pregnant with her first child^rachel mcadams is reportedly pregnant with her first child^hugh hefner cause death has been revealed^hugh hefner cause death revealed^alex rodriguez year old daughter sings for jennifer lopez photos^elle king skipped wedding go rock concert do blame though^'the jetsons is heading abc live action sitcom^jenny slate and chris evans break up again^taylor swift and joe alwyn photographed on a coffee date in nashville photo^justin timberlake announces 'the man of the woods tour see the dates^here what hocus pocus thackery binx looks like now^heidi montag is pregnant eecting first child with spencer pratt^star jones ex husband al reynolds comes out as bisexual in candid blog^kim kardashian shares first photo baby chicago west^bachelorette peter kraus reveals he suffered eating disorder^watch harry styles kiss james corden in christmas themed 'carpool karaoke^'storm chasers star joel taylor dead at^jennifer lawrence darren aronofsky split^camila cabello announces her 'never be the same tour see the dates^gigi hadid slams body shamers for calling her 'too skinny at nyfw^meryl streep joins big little lies season^khloe kardashian kylie jenner joke about having 'so many babies^chris pratt files divorce from anna faris,29,31,2,60,0.4833333333333333,0.03333333333333333,0
17469289,nypost,11770,1499076,18605,263870,0,9,39,11,breaking news features the new york post follow favorite sections,the maine centers disease control prevention says almost people infected norovirus swim^the centers disease control prevention received reports least confirmed cases states^rudy giuliani says robert mueller agreed narrow scope potential interview president trump^rudy giuliani gives new conditions trump interview mueller^ad firm sues cuny stiffing rebranding campaign^the maine centers disease control prevention says almost people infected norovirus swim^the centers disease control prevention received reports least confirmed cases states^the oak sapling spend least two years quarantine us department agriculture said^their son playing dog last year triggered trap us department agriculture place^jessica simpson shows baby bump day nyc^jessica simpson shows baby bump day nyc^how tina fey messed 'mean girls musical^caitlyn jenner still gets yeezy perks^exclusive pregnant khlo went ballistic found tristan cheating^the real reason jennifer aniston justin theroux split^jon bon jovi slams kim kardashian reality tv i think horrific live world^attention scott disick sofia richie kourtney kardashian post competing thirst traps^sofia richie kourtney kardashian posted couple competing thirst traps instagram^exclusive kelly ripa demands ryan seacrest cancel gma appearance^did lindsay lohan convert islam^katie couric finally opens matt lauer ouster today saying the whole thing painfu^katie couric breaks silence matt lauer today exit^the crown casted josh o connor play prince charles^princess eugenie ring double price meghan markle^mila kunis addresses 'upsetting divorce pregnancy rumors^inside the rock vin diesel furious feud^attention scott disick sofia richie kourtney kardashian post competing thirst traps^sofia richie kourtney kardashian posted couple competing thirst traps instagram^jessica simpson shows baby bump day nyc^jessica simpson shows baby bump day nyc^angelina jolie i n't enjoy single^bradley cooper says fell love lady gaga face amp eyes^she allegedly seen ripping caitlyn jenner new one^shots fired near tekashi ix9ine kanye west video shoot^janet jackson family still mad justin timberlake^mila kunis addresses 'upsetting divorce pregnancy rumors^gayle king says oprah intrigued idea running president adding she loves country woul^daniel craig rachel weisz parents together^daniel craig rachel weisz welcome baby girl^attention scott disick sofia richie kourtney kardashian post competing thirst traps^flip flop stars year old son hospitalized croup^attention scott disick sofia richie kourtney kardashian post competing thirst traps^sofia richie kourtney kardashian posted couple competing thirst traps instagram^attention scott disick sofia richie kourtney kardashian post competing thirst traps^sofia richie kourtney kardashian posted couple competing thirst traps instagram^did lindsay lohan convert islam^why selena gomez fired mom took clothes^modern family star julie bowen privately settled divorce^surprise enrique iglesias anna kournikova welcome twins^breaking anthony weiner sentenced months prison sexting minor^cara mund north dakota crowned miss america^jim carrey wrongful death lawsuit dismissed^kendall jenner hospitalized shortly appearing vanity fair oscar party^ouch howie mandel remember meghan markle deal no deal^who next die thewalkingdead^brooke burke files divorce david charvet^stranger things star david harbour reveals committed mental asylum^stormy daniels husband glendon crain files divorce^the whole harvey weinstein thing sad everybody involved said woody allen,39,20,-19,59,0.6610169491525424,-0.3220338983050847,1
19357548,1037theq,190,12690,221,99247,0,0,51,8,birmingham hit music station home justshowupshow,robert pattinson on movie roles 'people are trying to put you in a box^teen choice awards nominations first wave of nominees full list^american music awards nominations amas nominees full list^sharon osbourne apologizes to justin bieber 'i was wrong to 'attack you^celebrities react nelsan ellis dead at^ed sheeran did not 'break friendship code with taylor swift^'re play strip that down liam payne quavo^jamie foxx katie holmes finally out public as couple^celebrities react trump withdraws steph curry white house invitation^celebrity reaction jimmy kimmel monologue on las vegas shooting and guns^beyonce not demanding silent delivery room despite report^love pick we 're playing look what you made me do^celebrity reactions donald trump phoenix rally speech^jimmy kimmel talks donald trump harvey weinstein on 'gma^brad pitt gq divorce interview highlights on angelina jolie kids and drinking^selena gomez vogue cover story see interview highlights^jennifer garner ben affleck file for divorce amid false reconciliation rumor^kendall jenner jealous ex^celebrities react to hurricane irma^chris soules had no alcohol in system after crash negative for drugs^justin bieber one pursued selena gomez vice versa ...^no drake is n't 'lusting after rihanna despite new rumors^taylor swift wins countersuit against dj david mueller in groping trial^lady gaga taylor kinney not secretly dating despite late and wrong report^kim kardashian sued for allegedly stealing lighting technique for selfies^what do we think fam did amp get married already^kim kardashian not attending paris fashion week despite claims^halle berry not pregnant at despite reports^watch kim kardashian first interview since robbery on 'ellen degeneres show videos^hailee steinfeld responds to justin bieber dating rumors^robert pattinson amp katy perry are not dating^beyonce birth twins still hospital 'minor issue^watch back alessia cara candid interview ryan seacrest listen perform trust my^she kidding said makes dates take love language quiz watch back ryan^miley cyrus revealed ryan seacrest profound live lessons learned losing hou^ellie goulding back watch back interview ryan seacrest get details about^justin bieber did not attend vanity fair oscars after party^kanye west is not rebooting 'american idol^kim kardashian slams 'invasive surrogacy reports^fans react u2 cancels st. louis concert amid police protests^jimmy fallon felt need to share 'heartfelt message about charlottesville^watch back alessia cara candid interview ryan seacrest listen perform trust my^she kidding said makes dates take love language quiz watch back ryan^miley cyrus revealed ryan seacrest profound live lessons learned losing hou^ellie goulding back watch back interview ryan seacrest get details about^no zayn is not 'desperate to defend girlfriend gigi hadid^selena gomez reveals she had a kidney transplant amp her friend was her donor^robert pattinson amp charlie hunnam talk 'lost city of z on 'gma video^chris soules 'devastated after killing kenny mosher in fatal accident^obamas celebrate th anniversary after false split stories^mariah carey not dating both nick cannon and bryan tanaka despite report^harry styles announces intimate world tour see the dates^'dance moms abby lee miller sentenced to one year in prison^beyonc made surprise appearance present colin kaepernick sports illustrated muhammad ali legacy awar^khlo kardashian makes her first public appearance since pregnancy news^'happy days star erin moran dead at^what elle king skipped her wedding for a rock concert^tori kelly is engaged to german basketball player andre murillo^jamie lynn spears pregnant second child the singer actress shared news sweet ig post,51,8,-43,59,0.8644067796610171,-0.7288135593220338,1
19897138,IndiaToday,230,5278458,5504,660686,1,51,5,1,brings news breaks exclusive political entertainment sports insight unbiased-nonaligned download app,trump failed protect nation isis inspired bangladeshi origin man wrote facebook detonating a^omar abdullah pitches j amp k autonomy congress reacts statement to^sabarimalashowdown rss sponsoring sabarimala protests. bjp responds statement of^rahul puts rafale back headlines bjp demands apology statement says bjp should^bjp mla raja singh telangana controversial statement said shoot illegal migrants bangladesh.^rajinikanth statement instigated another political battle country will clean mess watch fu^noble laureate amartya sen speaks previous statement willing mr. modi as^shocking 'terror warning mehbooba mufti listen pdp spokesperson said defense j amp k^bulandshahrviolence former dgp up vikram singh talks conspiracy statement he says cons^afridistumpsimran shahid afridi delivers sane statement asks pakistan back plan acquiring ka^is desperate bid polarise telangana ahead elections watch debate theburningquestion^the debate worked better security front rising th anniversary /11 on same^what behind resignation nia judge delivered mecca masjid verdict watch debate newstoday^the debate laws kapil sankla flavia agnes gets interesting what happen court exactly betwee^nocrackerban what green fire crackers do even exist the issue becoming political catch t^sabarimalashowdown bjp says people across parties supporting people protesting streets k^congress bjp trade charges rahul gandhi raises issue rafaledeal debate on^bypollbattle sp spokesperson corners bjp non payment dues sugarcane farme^bjp calls cases mob lynching ocial malice debate peoplescourt stoplynchmobs l^raises issue religious conversion pak says debate indiafirst live^gst council reduces tax items including host daily products alongwith making gst filing process lot^major success martyr saleem khan killer killed kulgam encounter itvideo more videos^shocking possible hostage situation la itvideo more videos^arjun meghwal stays defiant regarding lynching anti modi conspiracy itvideo more videos^congress working committee authorises rahul form alliances lok sabha elections itvideo more video^alwar lynching case third accused ramesh sharma arrested police itvideo more videos^congress faces alliance hiccups sp favours bsp rahul gandhi party itvideo more videos^france deflates rahul gandhi rafale charge itvideo more videos^us slams pakistan hafiz saeed party members contesting general elections itvideo more videos^manish grover attacks rahul gandhi says immature itvideo more videos^rahul chairs first meeting recently constituted cwc calls eansion party base cong biggest task itvideo^strategic alliance save democracy sonia gandhi cwc meeting itvideo more videos^the curious case seyyadurai from goat seller son business tycoon here need know nagarj^top congress body meet national capital today itvideo more videos^encounter underway south kashmir kulgam terrorists believed trapped area itvideo more video^storey building collapses ghaziabad many feared trapped itvideo more videos^pakistan judge ees isi says isi wants sharif jail itvideo more videos^india today first channel reach hafiz saeed town watch ground report hafiz saeed son talha saeed ca^politics brew alwar lynching home minister rajnath singh admits fear law people itvideo m^abducted constable saleem khan martyred captivity terrorists itvideo more videos^sanitary pads exempted purview gst itvideo more videos^fresh fatwa issued nida khan cash reward chopping hair itvideo more videos^fatf wants put pakistan black list jud chief hafiz saeed itvideo more videos^details congress meeting sonia gandhi target modi government set goals itvideo more vid^hitting back sonia gandhi bjp spokesperson sambit patra says congress ran india reverse gear years.^here list products completely exempted gst itvideo more videos^alwar victim kin demand justice they revealed business milk itvideo more videos^two four priests involved kerala rape case arrested cctv footage showing one priest f^massive protest pakistan spy agency isi outside army headquarters rawalpindi itvideo more videos^tamil nadu bjp leader h raja stirs fresh row targets journalist itvideo more videos^unhappy shashi tharoor remark rahul says wo n't hesitate take action party leaders whose state^terrorists killed kulgam encounter ends itvideo more videos^kate middleton leaves hospital birth baby boy^kate middleton left hospital seven hours delivering baby boy^kate middleton left hospital seven hours delivering third child^india today accessed nirav modi hideout location london^pitt quit acting three years actor brad pitt says may quit acting turns^st annual daytime emmy awards complete list winners,6,52,46,58,0.10344827586206896,0.7931034482758621,0
95431448,BostonGlobe,1238,752387,10710,380630,4,31,8,15,boston new england leading source breaking news analysis coverage across world visit us,texas official sid miller calls hillary clinton sexually elicit derogatory term women deleted tweet^the embattled chaplain us house representatives job back hours sending scalding^facebook ceo mark zuckerberg prepared testimony us house representatives said facebook pro^watch live george w. bush says dad almost died twice young god answered pra^cnn anchor brooke baldwin reacted forcefully tuesday guest cnn newsroom uttered racial slur^the us centers disease control prevention found suicide rates went significa^in state union response said the state union hopeful resilient enduring stephen^president donald trump preferred congressional candidate tested battleground ohio season^spending anti shaheen ads already surpassed romney campaign spent ads nh primary^the latest results national assessment educational progress exams contain mostly good news students i^the latest results national assessment educational progress exams contain mostly good news students i^the latest results national assessment educational progress exams show massachusetts whole outp^rudy giuliani said sunday president trump may open interview special counsel robert mueller even i^rudy giuliani said sunday president trump could make decision week next whether sit int^president trump lawyers close making determination interview special counsel robert muelle^rudy giuliani said sunday president trump still weighing whether agree interview special coun^recent research data us department education indicate african american students taking g^donald trump campaign hired new hampshire ad firm called draper sterling really^yes donald trump campaign hired n.h. ad firm called draper sterling^governor charlie baker reaffirmed support public spending help massachusetts biotech industry a^former massachusetts governor deval patrick texas give address naacp convention san antonio o^read transcript former president obama speech illinois^you get rid ice going country going afraid walk house pres^nafta i could sign tomorrow i happy i want make fair ok president trump to^in former new york mayor rudy giuliani accused affair married new hampshi^president trump lawyer rudy giuliani speaking wednesday new hampshire said november midterm elections wi^the midterm election impeachment impeachment president trump said rudy giuliani pres^put shut president trump personal lawyer rudy giuliani said special counsel robert mueller probe^read transcript former president obama speech illinois^she knows options daughters limited refugee camp most women camp burdened househol^an early morning shooting left four men injured roxbury another shooting mattapan left one injured sa^boston mayor martin j. walsh urged witnesses early morning shooting left four men injured roxbury^china raises tariffs 60 billion us goods technology trade fight^the us china ended trade talks beijing sunday without announced deals chinese officials refu^the us imposed first duties 34 billion chinese goods friday launching trade war world t^mit professor neri oxman may moved brad pitt^president trump frequently used n word host reality television show celebrity apprenti^in interview tom brady good morning america monday host michael strahan recalled gisele b ndchen^alec baldwin apparently done president elect donald trump knocking saturday night live sketches^actor alec baldwin apparently done president elect donald trump knocking saturday night live sketches^beyonce paid tribute saturday historically black colleges universities also reunited destiny chil^singer joe jonas engaged game thrones star sophie turner^mit professor neri oxman she love project brad pitt dating^it story lovely home studio city the the brady bunch house sale 1.885 million.^brady bunch house sale nearly 1.9 million^prince charles walk meghan markle aisle tomorrow royal wedding^prince harry meghan markle requesting understanding respect markle father tmz reported^actress mindy kaling reportedly pregnant first child^did jetblue kick family plane birthday cake^prince harry says wanted british royal family^harvard hasty pudding theatricals named mila kunis woman year earlier week announced^britain royal officials say prince harry asked elder brother prince william best man wedding nex^it family affair britain royal officials say prince harry asked elder brother prince william best^prince harry best man prince william arrived st. george chapel royal wedding harry a^britain royal officials say prince harry asked elder brother prince william best man wedding nex^judge declares mistrial bill cosby sexual assault case^judge declares mistrial bill cosby sexual assault case^reports say kylie jenner pregnant first child,12,46,34,58,0.20689655172413796,0.5862068965517241,0
1027549756661358593,mnaEN,2,4139,25,57571,22,31,5,0,media news agency license number themnanews.com arabic videos instagram mnanews whats app +96594077900,"a bipartisan group lawmakers introduced bill us house representatives wednesday would stop^democrats seats needed take control us house representatives u.s. voters^the us house representatives leading lawmaker taxes suggested sunday new tax cut plan touted p^president donaldtrump wednesday forced attorney general jeffsessions day congressional elections^president donaldtrump wednesday vowed jettison attempt bipartisanship fight back new^in divided us congress democrats control house representatives senate republican^us house representatives democratic leader nancy pelosi friday drew tough line small band of^senate democrats reacted anger derision tuesday republican tax bill unveiled late monday night^canada particular concerns fate new continental trade deal us elections gave dem^us president donaldtrump insists republican party midterm congressional elections despite l^with party set control us house representatives tuesday congressional elections^the top republican lawmaker tax policy us house representatives said tuesday working w^when democrats take u.s house representatives three weeks first order business e^the us house representatives thursday approved two week stopgap spending bill would avert governmen^the u.s. house representatives thursday overwhelmingly passed resolution calling crimes committed by^democrats clear message party leaders take control us house representatives next ye^the top democrat us house representatives pledged new era congressional scrutiny president^now democrats control us house representatives need choose leader that^the democrats mantra seizing control us house representatives took shape within weeks president^twelve us republican senators wednesday urged president donaldtrump submit deal update north^democrats use new majority us house representatives reverse see hands off^us acting attorney general matthewwhitaker appear house representatives judiciary committee in^us crudeoil erts surged million barrels per day last week highest record based data going b^more americans turning forms complementary medicine yoga meditation chiropractors accor^there cases possible confirmed acute flaccid myelitis unitedstates year according^as people fall victim e scooter accidents specialists us centers disease control preven^homicides suicides involving guns increasing according new data us centers diseas^the first confirmed u.s.a. case andesvirus reported delaware hospital january us centers dis^the number cigarette smokers us hit lowest levels public health officials ever seen cente^the centers disease control prevention cdc warned u.s.a. canadian consumers eat^measles cases around world surged according new report jointly published the^more children diagnosed acute flaccidmyelitis polio like paralyzing illness according nu^as thanksgiving nears cases salmonella including death linked raw turkey products^there confirmed cases polio like illness known afm us year friday acc^us crudeoil erts surged million barrels per day last week highest record based data going b^the republican national committee announces hold convention late august charlotte^more americans turning forms complementary medicine yoga meditation chiropractors accor^there cases possible confirmed acute flaccid myelitis unitedstates year according^as people fall victim e scooter accidents specialists us centers disease control preven^homicides suicides involving guns increasing according new data us centers diseas^the first confirmed u.s.a. case andesvirus reported delaware hospital january us centers dis^the number cigarette smokers us hit lowest levels public health officials ever seen cente^measles cases around world surged according new report jointly published the^more children diagnosed acute flaccidmyelitis polio like paralyzing illness according nu^as thanksgiving nears cases salmonella including death linked raw turkey products^there confirmed cases polio like illness known afm us year friday acc^u.s. house representatives committee vote friday whether release dozens transcripts intervie^us crudeoil erts surged million barrels per day last week highest record based data going b^the us department agriculture terminated 240,000 purchase contract chinese owned smithfield foods that^amymacdonald kttunstall thanked ,000 people taking part mass sleepout raise money home^scientists identified four ghostly signals massive collisions outer space including one the^a new report says china cancelled trade talks us protest washington move slap fres^us business spending equipment appeared remained slow september goods trade deficit widened^meghanmarkle mother doria says 'very happy 'looking forward welcoming first grandchild after^princeharry meghanmarkle leaving west london moving bedroom home near windsorcastle t^the divorce custody battle bradpitt angelinajolie set go trial next month the^new exhibit featuring meghanmarkle princeharry outfits wedding day open at^princeharry wife meghanmarkle eecting first child spring around year after",27,31,4,58,0.4655172413793103,0.06896551724137931,0
38142380,standardnews,892,616121,4041,306445,1,2,29,25,breaking news updates top london stories newsdesk follow accounts,donald trump boasted 'very big win us midterm elections despite democrats seizing control h^meet pat cunnane former speechwriter barack obama^one four trains late day troubled south western railway^kim kardashian defends kylie jenner dictionary savaging^james bond shoes supplier crockett amp jones steps sales^the happy couple married st george chapel venue prince harry meghan markle wed back may^cheryl never date liam payne split^cheryl never date liam payne split^liam payne opens cheryl split first time hints she dumped saying i bit fragile^josh o connor tipped play young prince charles the crown^justin bieber confirms married hailey baldwin already^justin bieber confirms married hailey baldwin already^is caitlyn jenner mystery celebrity big brother housemate^is caitlyn jenner mystery celebrity big brother housemate^brad pitt cleared child abuse investigation angelina jolie admits relieved^caitlyn jenner misses birth daughter kylie baby girl^teri hatcher slams 'untrue reports broke homeless^teri hatcher slams 'untrue reports broke homeless^meghan markle half sister shares joy engagement prince harry moving personal message^kris jenner 'planning adopt child boyfriend corey gamble^kris jenner 'planning adopt child boyfriend corey gamble^teri hatcher slams 'untrue reports broke homeless^teri hatcher slams 'untrue reports broke homeless^selena gomez reveals kidney transplant summer^selena gomez reveals kidney transplant summer going battle lupus^'proud david beckham gushes victoria share kiss lfw^piers morgan slates david beckham new hair^'proud david beckham gushes victoria share kiss lfw^david beckham spoke candidly marriage revealing couple union 'more complicated y^david beckham spoke candidly marriage revealing couple union 'more complicated y^the iconic glasgow school art devastated fire overnight it undergoing multi million pound r^selena gomez reportedly undergoing treatment mental health following 'emotional breakdown^prince harry asks william best man royal wedding^bill cosby found guilty sexual assault retrial^prince harry meets us first lady melania trump ahead invictus games^prince harry meets us first lady melania trump ahead invictus games^heidi klum reveals 'very single ready mingle ellen degeneres chat^pippa middleton marries groom james matthews front royals family friends^kermit frog getting new voice years^kermit frog getting new voice years^meghan markle father will walk aisle royal wedding^who walk meghan aisle royal wedding father ca n't make^meghan markle father will walk aisle royal wedding^who walk meghan aisle royal wedding father ca n't make^meghan markle father will walk aisle royal wedding^meghan markle father will walk aisle royal wedding^justin theroux breaks social media silence visit puppy shelter jennifer aniston split^bradley cooper irina shayk welcome first child^michelle williams reportedly engaged andrew youmans^michelle williams reportedly engaged andrew youmans^michelle williams reportedly engaged andrew youmans^michelle williams reportedly engaged andrew youmans^jennifer aniston eemed fine since justin theroux split^weinstein company 'to file bankruptcy asset sale talks collapse^beyonc eminem the weeknd headline coachella^beyonc eminem the weeknd headline coachella^beyonc eminem the weeknd headline coachella,30,27,-3,57,0.5263157894736842,-0.05263157894736842,1
16824090,seventeen,2607,1344483,3988,120221,0,0,40,17,the ~totally official~ seventeen twitter follow us snapchat seventeenmag shop new fashion line,kourtney kardashian deletes instagram after unfollowing boyfriend younes bendjima^kourtney kardashian deletes instagram after unfollowing boyfriend younes bendjima^kim kardashian defends kylie jenner lips she did n't lie^kim kardashian defends kylie jenner after fans attack her over self made comments^if rode around helicopter tom cruise would one favorite things^a timeline miley cyrus liam hemsworth relationship^a timeline miley cyrus liam hemsworth relationship^a timeline miley cyrus liam hemsworth relationship^a definitive timeline miley cyrus liam hemsworth relationship^a timeline miley cyrus liam hemsworth relationship^a timeline miley cyrus liam hemsworth relationship^a definitive timeline miley cyrus liam hemsworth relationship^a timeline miley cyrus liam hemsworth relationship^a definitive timeline miley cyrus liam hemsworth relationship^a definitive timeline miley cyrus liam hemsworth relationship^a timeline miley cyrus liam hemsworth relationship^a definitive timeline prince harry meghan markle relationship^a definitive timeline prince harry meghan markle relationship^channing tatum jenna dewan tatum split after years marriage^icymi the real reason broke^the real reason justin bieber selena gomez did n't spend thanksgiving together^the real reason justin bieber selena gomez did n't spend thanksgiving together^reveals real reason n't listening new album^selena gomez justin bieber spotted making out after their concert date^lady gaga reveals heartbreaking reason she split taylor kinney^why i disagree with my dad cover has become meme^justin bieber feels guilty about selena gomez breakdown despite his marriage to hailey baldwin^taylor swift is countersuing just 1 her sexual assault trial^justin bieber is not over selena gomez despite being married hailey baldwin^hailee steinfeld shuts down justin bieber dating rumors^justin bieber probably not dating hailee steinfeld okay^channing tatum jenna dewan tatum split after years marriage^katy perry just threw major shade at taylor swift american idol^might have dropped the biggest hint she moving to the uk for prince harry^texted kris jenner ask about pregnancy live tv here what she wrote back^reveals she had kidney transplant her best friend was donor^kylie jenner no longer wants spotlight now that she mom^katy perry just threw major shade at taylor swift american idol^the internet thinks are getting ready makeup war^kendall jenner ben simmons so cute together^dance moms star abby lee miller sentenced one year prison^robert pattinson reveals he was nearly fired from twilight^here the most popular halloween candy of by state^here most popular candy your state this halloween^here everything we know about stranger things season so far^was this major sign that ariana grande mac miller were going break up^mac miller death may have led ariana grande pete davidson breakup^here schedule freeform nights halloween^here schedule freeform nights halloween^here schedule freeform nights halloween^dove cameron responds thomas doherty breakup rumors ''we are madly love ''^this riverdale actress says she getting death threats because bughead^selena gomez wears justin bieber jersey after attending his hockey game^selena gomez wears justin bieber jersey after attending his hockey game^selena gomez wears justin bieber jersey after attending his hockey game^everything know far reasonswhy season^here everything we know about reasons why season so far,40,17,-23,57,0.7017543859649122,-0.4035087719298245,1
13992132,IndieWire,3284,669083,7792,164295,0,3,31,22,the definitive outlet film tv news reviews industry analysis,state union rosamund pike chris o dowd lead nick hornby short form comedy^state union rosamund pike chris o dowd lead nick hornby short form comedy^ojsimpson first post trial interview 'll never see^donald trump jr suggests ron perlman knew about harvey weinstein sexual abuse calls him coward for being si^brad pitt allied wins brad pitt warmachine oscar race^dragged across concrete review vince vaughn mel gibson play bad cop worse cop venice^venice film festival must see films this year festival from bloody vince vaughn jeff goldblum l^'bone tomahawk director s. craig zahler teams vince vaughn draggedacrossconcrete promise^venice film festival must see films this year festival from bloody vince vaughn jeff goldblum l^venice film festival must see movies this year festival from bloody vince vaughn jeff goldblum a^matthew mcconaughey says it time for us to embrace donald trump^the behavior inexcusable meryl streep slams disgraceful harvey weinstein sexual abuse allegations^meryl streep slams disgraceful harvey weinstein sexual abuse allegations read official statement^meryl streep slams disgraceful harvey weinstein sexual abuse allegations read official statement^luca guadagnino teases suspiria sequel ideas responds sending dakota johnson therapy^thegoodplace barry star d'arcy carden favorite friends episode time celebrates th^thegoodplace barry star d'arcy carden favorite friends episode time celebrates th^some best films year cannes film festival headed nyff see main slate lineup which^bradley cooper lady gaga touched venezia75 world premiere a star is born here best photos^astarisborn review lady gaga shines bradley cooper cover enduring musical^astarisborn debuted bradley cooper breakout director these shots prove ton visu^woody allen rainy day new york starring timoth e chalamet selena gomez shelved indefinitely amazon^woody allen casts elle fanning timoth e chalamet selena gomez new amazon feature^selena gomez timoth e chalamet nyc shooting woody allen new film see pictures^woody allen rainy day new york starring timoth e chalamet selena gomez shelved indefinitely amazon^call me by your name breakout timoth e chalamet joins elle fanning selena gomez woody allen amazon feature^woody allen rainy day starring timoth e chalamet selena gomez shelved indefinitely amazon report^woody allen casts elle fanning timoth e chalamet selena gomez new amazon feature^woody allen casts elle fanning timoth e chalamet selena gomez new amazon feature^big stars julia roberts big returns murphy brown big follow ups sam esmail matthew weiner and^emma stone chose netflix maniac her first lead television role because her love jonah hill^more one film critic hailing missionimpossiblefallout best action movie since mad max fury road.^mindhunter season david fincher using same actor play charles manson quentin tarantino hollywood re^before cast charles manson quentin tarantino hollywood damon herriman reportedly shot scenes ma^if harvey weinstein invites private party ... go. courtney love warned women weinstein^according nypd harvey weinstein arrested processed charged rape criminal sex act sex abuse^jimmy kimmel returning host oscars^jimmy kimmel returning host oscars^another year peak tv another brilliant series add watch list from sharpobjects pose barry^another year peak tv another brilliant series add watch list from sharpobjects pose barry^julia louis dreyfus awarded mark twain prize american humor used time stage make p^sara gilbert roseanne cancellation i sad people lost jobs process however i d^rupaulsdragrace crowns season winner finale with more than few tricks up its sleeve^you power change behavior amber tamblyn pens open letter james woods^yikes the americanhorrorstory season title revealed elains election worst way^roger ailes former fox news ceo dead^rebel wilson accuses male star sexual harassment he asked me repeatedly stick my finger up his a s^pose first look photos from ryan murphy groundbreaking new drama^pose first look photos from ryan murphy groundbreaking new drama^reasonswhy renewed season netflix the show producer elains season necessary an^shia labeouf arrested again for disorderly conduct public drunkenness^shia labeouf offscreen antics continue dominate career he arrested public drunkenness^thesimpsons fires longtime composer alf clausen after years^thesimpsons fires longtime composer alf clausen after years^thesimpsons fires longtime composer alf clausen after years^the end batesmotel watch trailer monday series finale,31,25,-6,56,0.5535714285714286,-0.10714285714285714,1
22671321,1043MYfm,1290,25392,470,57251,0,0,36,20,more music more variety los angeles radio station,john mayer has been hospitalized emergency appendectomy^are kyliejenner travisscott secretly married kuwtk kardashians^chris pratt files divorce from anna faris^sharon osbourne apologizes to justin bieber 'i was wrong to 'attack you^kanyewest shares texts caitlynjenner read kuwtk^jimmy kimmel talks donald trump harvey weinstein on 'gma^celebrities react to hurricane irma^no drake is n't 'lusting after rihanna despite new rumors^taylor swift wins countersuit against dj david mueller in groping trial^katie holmes not pregnant and planning wedding with jamie foxx^kanyewest nickcannon squashed beef kimkardashian^justinbieber allegedly n't ex selenagomez beliebers selenators^celebrity reactions prince harry meghan markle engaged^robert pattinson amp katy perry are not dating^beyonce birth twins still hospital 'minor issue^beyonce birth twins still hospital 'minor issue^meghanmarkle princeharry told royalfamily baby news princesseugenie wedding should have^kanyewest reactivated twitter rand 'mind control^joe jonas sophie turner 'already thinking of having kids is made up story^chris brown urges fans to donate to year old boy 'new legs gofundme^are kyliejenner travisscott secretly married kuwtk kardashians^khloekardashian said tristanthompson 'lucky pregnant cheating scandal broke kuwtk^khloekardashian refers tristanthompson 'true dad kuwtk^kanyewest nickcannon squashed beef kimkardashian^iggy azalea blasts nick young after accidental dinner reunion^these strangerthings characters originally going die season we ca n't even imagine show continu^fans react u2 cancels st. louis concert amid police protests^princecharles revealed biggest fear meghanmarkle princeharry child royalfamily royalwedding^princeharry hoping baby girl meghanmarkle royalfamily royalwedding^princeharry gushed baby meghanmarkle invictus games royalfamily royalwedding^princeharry revealed asked father walk meghanmarkle aisle royalfamily royalwedding^no zayn is not 'desperate to defend girlfriend gigi hadid^selena gomez reveals kidney transplant^selena gomez reveals she had a kidney transplant amp her friend was her donor^faithhill performs 'what a friend we have arethafranklin funeral queenofsoul^check memorable moments arethafranklin funeral today queenofsoul arethafranklin faithhill^here how help victims las vegas mass shooting^khlo kardashian makes her first public appearance since pregnancy news^taylor swift teases new song 'gorgeous on instagram listen to a snippet^miss north dakota cara mund is crowned miss america^rachel mcadams is reportedly pregnant with her first child^alex rodriguez year old daughter sings for jennifer lopez photos^taylor swift teases new song 'gorgeous on instagram listen to a snippet^jenny slate and chris evans break up again^justin timberlake announces 'the man of the woods tour see the dates^star jones ex husband al reynolds comes out as bisexual in candid blog^'storm chasers star joel taylor dead at^icymi nickjonas priyankachopra engaged sorry guys gals market^aaron paul and wife lauren parsekian are eecting their first child^taylor swift announces new album 'reputation see the cover art^camila cabello announces her 'never be the same tour see the dates^gigi hadid slams body shamers for calling her 'too skinny at nyfw^'black panther is officially the most tweeted about movie of all time^demi lovato announces tour with dj khaled see the dates^incredibles trailer debuts during winter olympics^chris pratt files divorce from anna faris,36,20,-16,56,0.6428571428571429,-0.2857142857142857,1
3018111009,Real923LA,421,38053,189,63285,0,0,41,15,la new home hip hop 866 -8923 ig/fb/snap realstreetfest,tiffany haddish brad pitt getting married^karrueche tran granted five year restraining order against chris brown^american music awards nominations amas nominees full list^celebrities react nelsan ellis dead at^is khloe kardashian done tristan thompson bigboy^jamie foxx katie holmes finally out public as couple^celebrities react trump withdraws steph curry white house invitation^beyonce not demanding silent delivery room despite report^guess celeb without looking answer hint she dated robert kardashian bigboy^celebrities react to hurricane irma^chris brown slammed by judge for skipping karrueche tran court hearing^katherine jackson resigns as blanket guardian^no drake is n't 'lusting after rihanna despite new rumors^katie holmes not pregnant and planning wedding with jamie foxx^sorry drake amp bella hadid are not 'secretly dating^ryan lochte charge dropped in rio robbery case^speaks on hooking up with gt^kim kardashian speaks on hooking up with drake^celebrity reactions prince harry meghan markle engaged^halle berry not pregnant at despite reports^mariah carey amp french montana did not flirt in recording studio^kanye gushes over kim kardashian bikini body^watch kim kardashian first interview since robbery on 'ellen degeneres show videos^watch kim kardashian first interview since robbery on 'ellen degeneres show videos^beyonce birth twins still hospital 'minor issue^karrueche tran granted five year restraining order against chris brown^the weeknd split with selena gomez caused him to scrap an upbeat album^shots fired set ix9ine music video feat nicki minaj amp kanye west^mary j. blige hacked did not write kendu isaacs hate tweet^rob kardashian backfires now suing blac chyna for abuse^rob kardashian suing blac chyna for strangling him with iphone cord^rob kardashian suing blac chyna for strangling him with iphone cord^chris brown urges fans to donate to year old boy 'new legs gofundme^celebrities react nfl players kneel lock arms during national anthem^iggy azalea blasts nick young after accidental dinner reunion^kanye west reportedly opening restaurant calabasas^kim kardashian slams 'invasive surrogacy reports^selena gomez reveals she had a kidney transplant^kim kardashian amp kanye west are terrified^obamas celebrate th anniversary after false split stories^mariah carey not dating both nick cannon and bryan tanaka despite report^khloe kardashian says tristan is lucky she was pregnant when cheating scandal broke^eminem calls out jada pinkett smith justin bieber amp more in freestyle^tisha campbell martin files for divorce from husband duane^khlo kardashian makes her first public appearance since pregnancy news^tamar braxton files divorce from vincent herbert^donald trump star the hollywood walk fame has been vandalized again^nelly officially under criminal investigation sexual assault^alex rodriguez year old daughter sings for jennifer lopez photos^toronto raptors fans troll tristan thompson with khloe chant^here the complete list of bet awards winners^star jones ex husband al reynolds comes out as bisexual in candid blog^mother day sunday treat mom special day amazing spa package williams ge^jada pinkett smith reveals why she will never get divorced^is khloe kardashian finally over tristan thompson is she ready walk away^demi lovato announces tour with dj khaled see the dates,41,15,-26,56,0.7321428571428571,-0.4642857142857143,1
5864232,WGAL,193,128911,927,261661,2,8,12,33,wgal the susquehanna valley news team twitter,"melania trump undergoes kidney surgery walter reed medical center^people found dead ohio^most popular baby names every u.s. state^most popular baby names every u.s. state^most popular baby names every u.s. state^most popular baby names every u.s. state^us slaps 50 billion tariffs chinese goods escalating trade dispute^us slaps 50 billion tariffs chinese goods escalating trade dispute^us slaps 50 billion tariffs chinese goods escalating trade dispute^us slaps 50 billion tariffs chinese goods escalating trade dispute^what roseanne barr net worth^what roseanne barr net worth^what roseanne barr net worth^what roseanne barr net worth^megyn kelly weighs matt lauer fired 'today show^david cassidy fighting memory loss wants 'enjoy life^david cassidy fighting memory loss wants 'enjoy life^icymi david cassidy fighting memory loss wants 'enjoy life^george clooney makes 27,283 every hour thanks tequila^mariah carey new year eve performance 'they foiled^'free speech rally 'fight supremacy groups set converge boston common^caitlyn jenner latest celebrity float run office^koko gorilla knew sign language dies^koko gorilla knew sign language dies^james franco event canceled actor denies allegations sexual misconduct^playboy founder hugh hefner cause death revealed^playboy founder hugh hefner cause death revealed^playboy founder hugh hefner cause death revealed^playboy founder hugh hefner cause death revealed^mindy kaling reportedly pregnant first child^mindy kaling reportedly pregnant first child^mindy kaling reportedly pregnant first child^'clueless actress stacey dash running congress california^'clueless actress stacey dash running congress california^'clueless actress stacey dash running congress california^'clueless actress stacey dash running congress california^kaley cuoco marries karl cook intimate horse ranch wedding^kaley cuoco marries karl cook intimate horse ranch wedding^kaley cuoco marries karl cook intimate horse ranch wedding^kaley cuoco marries karl cook intimate horse ranch wedding^discovery channel 'storm chasers star joel taylor dead^discovery channel 'storm chasers star joel taylor dead^discovery channel 'storm chasers star joel taylor dead^discovery channel 'storm chasers star joel taylor dead^billboard music awards check complete list winners^everything need know 'this is us season^billboard music awards check complete list winners^netflix is reportedly reviving carmen sandiego with gina rodriguez^reese witherspoon confirms 'legally blonde happening^judge declares mistrial bill cosby sexual assault case^judge declares mistrial bill cosby sexual assault case^judge declares mistrial bill cosby sexual assault case^april giraffe pregnant^april giraffe pregnant^april giraffe pregnant",14,41,27,55,0.2545454545454545,0.4909090909090909,0
14833304,POPSUGAR,2022,198124,2786,220443,0,0,45,10,everything love one place,did soko throw major shade kristen stewart twitter via^jessica ashlee simpson sweet double date boys baby bump^jokes growing baby bump^kate middleton left hospital welcoming baby boy^why fergie josh duhamel split^why fergie josh duhamel split^why fergie josh duhamel split^why fergie josh duhamel split^thecrown found new prince charles queen mother season^thecrown found new prince charles queen mother season^perfect response breakup rumors^perfect response breakup rumors^angelina jolie brad pitt agree keep divorce private committed act united front^angelina jolie brad pitt agree keep divorce private committed act united front^brad pitt angelina jolie committed reaching divorce settlement via^aww we 're melting nicole kidman adorable anniversary posts^seacrest gets snubbed intentional breaking rules icymi ryan seacrest got denied brad pitt ange..^jessica ashlee simpson sweet double date boys baby bump^are katie holmes jamie foxx officially dating^who think play princess diana thecrown^who think play princess diana thecrown^who think play princess diana thecrown^who think play princess diana season thecrown^who think play princess diana thecrown^who think play princess diana thecrown^who think play princess diana thecrown^more shocking details emerge angelina jolie brad pitt divorce^nicole kidman aquaman character poster stunning^kourtney kardashian never ever getting back together scott disick via^anmer hall going busy christmas^anmer hall going busy christmas^anmer hall going busy christmas^anmer hall going busy christmas^anmer hall going busy christmas^sexy gifs kick girl crush overdrive^sexy gifs kick girl crush overdrive^sexy gifs kick girl crush overdrive^sexy gifs kick girl crush overdrive^sexy gifs kick girl crush overdrive^kate middleton breaking tiara^more shocking details emerge angelina jolie brad pitt divorce^we 're excited prince harry meghan markle^kris jenner new vending machine boozy beautiful words^selena gomez reveals kidney transplant^nicole kidman opens two miscarriages marriage tom cruise via^question is real creepily spot wax figure^ashley olsen bob saget candace cameron bure reunite nyc good cause^ashley olsen bob saget candace cameron bure reunite nyc good cause^ashley olsen bob saget candace cameron bure reunite nyc good cause^hugh hefner cause death revealed^hugh hefner cause death revealed^are nina dobrev glen powell dating the stars could friends^hottest newly engaged couple year^seth meyers reportedly set host golden globes^cheryl burke matthew lawrence engaged,45,10,-35,55,0.8181818181818182,-0.6363636363636364,1
29465136,Mediaite,3253,158856,5121,166425,1,43,8,2,the site news smart opinions print online broadcast media,rosie perez makes stirring plea for aid puerto rico 'we need wake up america^sarah palin cpac speech trashes establishment gop calls obama liar reality star full speech video^sarah palin cpac speech trashes establishment gop calls obama liar reality star full speech video^sarah palin cpac keynote 'time to drain the jacuzzi and throw the bums out with the bathwater full speech^sarah palin cpac speech trashes establishment gop calls obama liar reality star video of full speech^sarah palin cpac speech trashes gop and karl rove calls obama liar reality star video^mediaite q amp a fox news martha maccallum mike pence interview that helped tank noko summit^year old evicted millennial gives another cringeworthy interview fox news^chris wallace lands interview with vladimir putin fox news monday night^john dickerson face nation interview hillary disgrace cbs news here why^twitter skewers rudy giuliani after wild interview with chris cuomo 'one heck sh*tshow'^what is hofstra university host first presidential debate^paul krugman pompously insults ron paul and his supporters column by^paul krugman pompously insults ron paul and his supporters column by^paul krugman on the jobs report 'not news 'nothing to see here column by c rothman^paul krugman freaks over possibility that obama may compromise with gop column by c rothman^paul krugman freaks over possibility that obama may compromise with gop column by c rothman^in defense of false paul krugman bankruptcy story column^zombies on cnbc paul krugman appears on network then trashes it for 'zombie ideas column by^paul krugman in characteristic modesty 'i have been right about everything column by^forgive paul krugman for calling /11 'an occasion for shame column by jn^paul krugman concludes no such thing as 'a reasonable republican column by^paul krugman in characteristic modesty 'i have been right about everything column by^on fox news sunday ben cardin slams wh 'too much interference mueller probe^on fox news sunday newt gingrich rips saudis over khashoggi killing 'their elanation insultingly stupid'^pro trump nc republican labeled 'bigot by google search tells fox news sunday 'it not that surprising'^watch live vice president joe biden making statement from rose garden^john mccain begins interview with brutally honest assessment i freezing my ass off^watch live trump holds campaign rally las vegas^watch live donald trump holds campaign rally las vegas^watch donald trump holds campaign rally las vegas nv^gop strategist rick wilson mocks trump supporters offended by his comments cnn fragile insecure weak ass pun^cnn stelter trump comments migrant caravan show 'the fox news presidency work^cnn panel gets heated over kamala harris comments ice kkk 'did you just call me apologist '^obama spiraling job approval ratings complicate negotiations with congressional republicans column by^obama spiraling job approval ratings complicate negotiations with congressional republicans column by^rudy giuliani blasts president obama stutterer new hampshire speech therapy session video column jn^john kasich unleashes trump fiery screed 'he not capable being unifier video^watch live sarah huckabee sanders holds first white house press briefing since putin summit^watch live sarah sanders holds first white house press briefing since red hen controversy^cia says it false claim white house blocked gina haspel from briefing saudi arabia^dick durbin doubles down pompeo said ask white house why gina haspel didn attend saudi briefing^cnn panel rips white house after sanders briefing 'gaslighting perfect word use^watch live sarah sanders holds white house press briefing^no in touch megyn kelly not replacing matt lauer today^'epic fail celebrities react betsy devos being confirmed education secretary^'regression word that comes mind celebrities react donald trump inauguration^the national enquirer published fake death photo george michael^'why i disagree my dad ivanka trump featured us weekly cover face saving effort^oops cnn mistakes faith hill faith evans tweet^celebrities remember orlando pulse nightclub shooting victims one year later^nytimes public editor says larry david insensitive op ed my son the terrorist missed the mark^james franco denies sexual misconduct allegations the late show they not accurate^tavis smiley sues pbs for firing him over 'trumped up sexual misconduct allegations,9,45,36,54,0.16666666666666666,0.6666666666666666,0
15168829,WTAE,1461,130277,1286,304726,2,4,13,35,pittsburgh news weather sports wtae,"melania trump undergoes kidney surgery walter reed medical center^people found dead ohio^most popular baby names every u.s. state^most popular baby names every u.s. state^most popular baby names every u.s. state^us slaps 50 billion tariffs chinese goods escalating trade dispute^what roseanne barr net worth^megyn kelly weighs matt lauer fired 'today show^david cassidy fighting memory loss wants 'enjoy life^david cassidy fighting memory loss wants 'enjoy life^david cassidy fighting memory loss wants 'enjoy life^tonya harding made 'dancing with stars finale fans livid^tonya harding made 'dancing with stars finale fans livid^tonya harding made 'dancing with stars finale fans livid^tonya harding made 'dancing with stars finale fans livid^george clooney makes 27,283 every hour thanks tequila^mariah carey new year eve performance 'they foiled^'free speech rally 'fight supremacy groups set converge boston common^caitlyn jenner latest celebrity float run office^koko gorilla knew sign language dies^koko gorilla knew sign language dies^james franco event canceled actor denies allegations sexual misconduct^playboy founder hugh hefner cause death revealed^playboy founder hugh hefner cause death revealed^playboy found hugh hefner cause death revealed^mindy kaling reportedly pregnant first child^mindy kaling reportedly pregnant first child^mindy kaling reportedly pregnant first child^justin timberlake announces second stop pittsburgh man woods tour^justin timberlake announces second stop pittsburgh man woods tour^justin timberlake announces second stop pittsburgh man woods tour^'clueless actress stacey dash running congress california^'clueless actress stacey dash running congress california^'clueless actress stacey dash running congress california^'clueless actress stacey dash running congress california^kaley cuoco marries karl cook intimate horse ranch wedding^kaley cuoco marries karl cook intimate horse ranch wedding^kaley cuoco marries karl cook intimate horse ranch wedding^kaley cuoco marries karl cook intimate horse ranch wedding^discovery channel 'storm chasers star joel taylor dead^discovery channel 'storm chasers star joel taylor dead^discovery channel 'storm chasers star joel taylor dead^discovery channel 'storm chasers star joel taylor dead^billboard music awards check complete list winners^billboard music awards check complete list winners^netflix is reportedly reviving carmen sandiego with gina rodriguez^netflix is reportedly reviving carmen sandiego with gina rodriguez^netflix is reportedly reviving carmen sandiego with gina rodriguez^reese witherspoon confirms 'legally blonde happening^judge declares mistrial bill cosby sexual assault case^judge declares mistrial bill cosby sexual assault case^april giraffe pregnant^april giraffe pregnant^april giraffe pregnant",15,39,24,54,0.2777777777777778,0.4444444444444444,0
10433782,mercnews,1739,239580,3149,294864,0,0,45,9,latest silicon valley san francisco bay area news reporters columnists the mercury news,jennifer aniston short marriage justin theroux^after everything ben affleck wishes could win jennifer garner back new report says^after everything ben affleck wishes could win jennifer garner back new report says^jennifer lopez hired private detective check alex rodriguez cheating allegations report says^katie holmes trials fighting reports jamie foxx breakup tom cruise suri reunion^justin theroux friends never believed jennifer aniston would last^justin theroux friends never believed jennifer aniston would last^how meghan markle kate middleton get along serena williams wimbledon final^are ben affleck jennifer lopez getting back together^after everything ben affleck wishes could win jennifer garner back new report says^after everything ben affleck wishes could win jennifer garner back new report says^the meghan markle bridezilla report tiara demand annoys queen elizabeth^katie holmes quit jamie foxx despite publicly humiliating women^jennifer lopez hired private detective check alex rodriguez cheating allegations report says^alex rodriguez slams report threatening cut child support payments^katie holmes trials fighting reports jamie foxx breakup tom cruise suri reunion^katie holmes trials fighting reports jamie foxx breakup tom cruise suri reunion^ann curry katie couric different memories matt lauer today^breaking news the star report nicole kidman keith urban union results baby girl your..^brad pitt hurricane katrina homes falling apart residents say new report^kanye west tour postponed indefinitely^jennifer aniston short marriage justin theroux^ballistic khloe kardashian may early contractions family rushes cleveland^justin bieber hailey baldwin get marriage license or already married^why kanye west think kim kardashian might divorce^angelina jolie agrees temporary truce brad pitt divorce war makes unpopular hollywood^maybe katie holmes jamie foxx really dating^where world caitlyn jenner kardashians brody jenner wedding^kendall jenner blasts caitlyn jenner turning back family report says^meghan markle prince harry practically living together ready get engaged report says^angelina jolie parental choices must really worried judge overseeing brad pitt custody fight eerts say^angelina jolie parental choices must really worried judge overseeing brad pitt custody fight eerts say^they foiled mariah carey weighs disastrous new year eve performance^they foiled mariah carey weighs disastrous new year eve performance^julia roberts appears dismiss marital strife rumors posting rare photo husband^katie holmes trials fighting reports jamie foxx breakup tom cruise suri reunion^angelina jolie takes break nasty brad pitt divorce fight plead syrian refugees^brad pitt allow kids act angelina jolie maleficent sequel according report^brad pitt allow kids act angelina jolie maleficent sequel according report^kanye west way going american idol judge^selena gomez reveals kidney transplant deal lupus^cher says musical life want make gouge eyes that good right^robert pattinson gave charlie hunnam silent treatment lost city z shoot^after everything ben affleck wishes could win jennifer garner back new report says^after everything ben affleck wishes could win jennifer garner back new report says^was leah remini really wrong call jada pinkett smith scientologist^james franco denies sexual misconduct allegations stephen colbert controversy grows^beyonce changes email address every week ed sheeran says^brady bunch house closes sale 3.5 million almost twice asking price^brady bunch house southern california sale nearly 1.9 million^john dickerson replaces charlie rose cbs this morning^pippa middleton wedding even meghan markle steals spotlight^lady gaga announces las vegas residency^richard simmons hospitalized severe indigestion,45,9,-36,54,0.8333333333333334,-0.6666666666666666,1
2836421,MSNBC,649,2684126,22995,179815,0,50,2,1,the place in-depth analysis political commentary informed perspectives,new i job director nat'l intel coats says asked issued statement pr^after florida secretary state orders recount begin ron desantis releases video statement saying stil^breaking in statement khashoggi murder president trump stresses business military business relationships i^in latest statement white house press sec sanders says stand statement revocation journa^are going mention meddling meet russian president vladimir putin july th the pres.^icymi president trump lot say vladimir putin recent interview^senator jeff flake praises macron speech congress notes difference french president approach foreign^tune pm et tonight exclusive interview new documentary t^mayor giuliani negotiating mueller face face he trying hammer details inter^rudy giuliani says president could prepare possible interview special counsel mueller around sum^he says truth number reports including president 'frustrated with^roger stone says heard credible sources president trump frustrated rudy giuliani t^trump lawyer rudy giuliani reportedly said client would agree interview special counsel robert^new comments president trump attorney rudy giuliani cast doubt whether president intervi^president trump legal team use one year anniversary mueller probe raise stakes wrap the^will president trump speak special counsel robert mueller new reports indicate becoming less less^two thirds latinos favor democratic control congress according new // poll^president carter describes late sen. john mccain place american history memories late senat^new poll trump approval rating remains steady tumultuous week poll finds^democrats point advantage republicans generic congressional ballot according new^new democrats hold point advantage heading midterm elections poll finds^in new nbc news wall street journal poll democrats point advantage gop generic congre^democrats point advantage republicans generic congressional ballot according new^new democrats hold point advantage heading election day according new poll^with days midterms percent likely voters inclined vote democrats percen^more americans oppose nomination judge brett kavanaugh supreme court support according a^looks voter enthusiasm numbers latest nbc news/wall street journal poll^democrats point advantage republicans generic congressional ballot according new^the u.s. department education announced thursday would automatically cancel 150 million student loans con^in tweet rep. tulsi gabbard slams president trump saudi arabia bitch president statement^joe sarah huckabee sanders might well said neil armstrong n't walk moon watch joe^joe sarah huckabee sanders might well said neil armstrong n't walk moon watch joe^joe sarah huckabee sanders might well said neil armstrong n't walk moon watch joe^joe sarah huckabee sanders might well said neil armstrong n't walk moon watch joe^sen. claire mccaskill alleged russian hackers tried gain access office computer network using^president carter describes late sen. john mccain place american history memories late senat^i seen lot bad stuff years intelligence nothing like i think attacked pil^i seen lot bad stuff years intelligence nothing like i think attacked pil^makes campaign stop las vegas rally^poll finds congressional job approval rating^as close special coverage today listen john mccain words reflecting life pre^noted quoted msnbc hosts midterm elections thoughts prayers new acting attorney general^noted quoted msnbc hosts midterm elections thoughts prayers new acting attorney general^noted quoted hosts week former president george h.w bush president trump business dealings^president carter describes late sen. john mccain place american history memories late senat^icymi asked yesterday white house press briefing why president hav^on sec pompeo speaks white house briefing president trump meetings saudi^i found research whoever lost election sometimes would provoke duel win^the us imposed 150 billion dollars trade tariffs chinese goods suspended here th^just in in ongoing us china tit tat tariffs president trump directs us trade rep. identify 200b wo^prince harry meghan markle delighted able share happy news public^in grading president united states scale dignified respectful that was^just in us supreme court declines hear appeal brendan dassey whose murder conviction t,2,51,49,53,0.03773584905660377,0.9245283018867924,0
14268564,11AliveNews,2780,393788,2267,399017,9,3,9,32,welcome alive where atlanta speaks here find top stories news alive atlanta,verify is shutting thelatefeed verify^verify is snapchat shutting^verify is snapchat shutting morningrushatl^verify is snapchat shutting via^verify is snapchat shutting morningrushatl^verify is shutting thelatefeed verify^read attorney general sessions statement recusal^fox news shepard smith 'why lie lie lie russia meeting^fox news shepard smith 'why lie lie lie russia meeting^family man found dead kennesaw mountain national park releases statement via^breaking vice president make statement rose garden :10 p.m^alive talks meet press via^reports brad pitt accused child abuse investigation^the rock emily blunt fun filming 'jungle cruise^the rock emily blunt fun filming 'jungle cruise via^forbes magazine marta atlanta streetcar among best rapid transit systems usa^forbes magazine marta atlanta streetcar among best rapid transit systems usa via^emmy awards the winners list^channing tatum jenna dewan announce separation^channing tatum jenna dewan announce separation^channing tatum jenna dewan announce separation^koko gorilla knew sign language dies^koko gorilla knew sign language dies via^'glee alum lea michele engaged boyfriend zandy reich shows huge ring social media^'glee alum lea michele engaged boyfriend zandy reich shows huge ring social media^'glee alum lea michele engaged boyfriend zandy reich shows huge ring social media^walmart remove 'cosmopolitan magazine checkout lines amid me too movement^walmart remove 'cosmopolitan magazine checkout lines amid me too movement^walmart remove 'cosmopolitan magazine checkout lines amid me too movement^scott baio wife renee reveals microvascular brain disease diagnosis^scott baio wife renee reveals microvascular brain disease diagnosis^scott baio wife renee reveals microvascular brain disease diagnosis^xxxtentacion murder suspect arrested central georgia^report meghan markle dad longer attend royal wedding^'nypd blue creator steven bochco dead^'nypd blue creator steven bochco dead^'nypd blue creator steven bochco dead^reports priyanka chopra nick jonas engaged two months dating^priyanka chopra nick jonas engaged^priyanka chopra nick jonas engaged two months dating reports say^priyanka chopra nick jonas engaged two months dating reports say^lady gaga announces las vegas residency dates^wwe star vader dead age^wwe star vader dead age^wwe star vader dead age^coachella announces lineup beyonc the weeknd eminem headline^here emma stone gained pounds muscle 'battle sexes^prince william prince harry best man royal wedding^reports kyliejenner pregnant^reports jennifer garner ben affleck officially file divorce^april giraffe pregnant^april giraffe pregnant^april giraffe pregnant,18,35,17,53,0.33962264150943394,0.3207547169811321,0
19063323,NME,3006,905696,15667,190243,0,0,25,28,from underground follow team hunt,katy perry ends six year beef calvin harris^katy perry ends six year beef calvin harris^katy perry ends six year beef calvin harris^baftas see full winners list^is justin bieber starting church^hailey baldwin shoots rumours already married justin bieber^jamie foxx walks live interview asked katie holmes^jamie foxx walks live interview asked katie holmes^lena dunham jack antonoff split^lena dunham jack antonoff split^the spice girls reportedly set reunion new album^the spice girls reportedly set reunion new album^the spice girls reportedly set reunion new album^it looks like justin bieber selena gomez back together fans losing^justin bieber says religion set free bondage shame easter bunny^justin bieber fan arrested trespassing los angeles home^selena gomez talks the weeknd split reconnecting justin bieber^kanye west reveals new release date yandhi help kim kardashian^liam gallagher clarifies liam payne 'diss^liam gallagher clarifies liam payne 'diss^kanye west returns twitter rant mind control^kanye west returns twitter rant mind control^it looks like justin bieber selena gomez back together fans losing^jennifer lawrence says still feels terrified nude photo hack^ariana grande pete davidson a timeline relationship^second suspect arrested xxxtentacion murder case^kelly clarkson talks pressure lose weight when i really skinny i wanted kill myself^blake lively injured set new film 'the rhythm section^robert pattinson reveals nearly fired twilight^robert pattinson reveals nearly fired 'twilight^star wars director rian johnson reveals the last jedi believe spoiler^star wars director rian johnson reveals the last jedi believe spoiler^star wars director rian johnson reveals the last jedi believe spoiler^donald trump almost played president sharknado n't since busy becoming real president^jessica lange returning 'american horror story everything know season far^xxxtentacion murder suspect robert allen arrested georgia^second suspect arrested xxxtentacion murder case^david harbour says new season 'stranger things inspired chevy chase comedy 'fletch here everything we^jason bateman officially signed arrested development season five^and win break drops new single 'thank u next referencing mac miller pet^hugh hefner cause death revealed^hugh hefner cause death revealed^hugh hefner cause death revealed^american horror story season title revealed^kim kardashian shares first photo kanye west newborn daughter chicago^former 'the voice us contestant melanie martinez responds rape allegations^watch brilliant moment blue ivy shut beyonce jay z grammys big camila cabello fa^celine dion poses naked vogue^celine dion poses naked vogue^taylor swift stalker sentenced years probation^katy perry host mtv video music awards^enigma lady gaga announces start date ticket details las vegas residency^taylor swift leads mtv emas shortlist six nominations,25,28,3,53,0.4716981132075472,0.05660377358490566,0
378568025,ONTV_NIGERIA,65,22087,47,81992,0,0,43,10,nigeria watched entertainment television uhf41 lagos w/ content cutting across music movies fashion sports more| business.com,jennifer aniston upset over justin theroux and naomi watts embrace last year^baby on the way jessica simpson shows off possible baby bump in racy mini dress^baby gifts galore inside caitlyn desperate attempt to woo back kim amp see grandkids^alex rodriguez getting cold feet about marrying jennifer lopez says source^feuding over friends jen secretly despises justin creepy pals^blake wants out how gwen came between shelton amp the voice execs^paris jackson flakes out on dying mom to party with pals in hippie hideaway^ben who liam neeson taken with his ultimate dream woman jennifer garner^controlling jen driving justin nuts aniston absurd diet demands causes major rift^the claws are out mila kunis nasty bad moms feud with leslie mann elodes^baby to save marriage justin timberlake desperate for another child with wife jessica biel^ben affleck and jennifer garner have tense easter holiday reunion in hawaii^downward spiral ruby rose steps out with cane after horrific health crisis^selena gomez caught making out with justin bieber after rehab see the steamy photos^diet dilemma katie holmes demands jamie foxx give up junk food^rhobh blowout secrets from the ladies elosive reunion^kim rips bad dad kanye step up your parenting game^ultimate betrayal jennifer aniston bff is still hanging with justin theroux^gwen trapped in 35m sex house gavin won budge on price of home he cheated in^selena hell gomez goes to rehab as friends fear another drug relapse^desperate caitlyn begging kendall to let her back in the jenner family^miscarriage tragedy shatters gwen baby dreams amp puts wedding to blake in jeopardy^channing tatum amp jenna dewan force friends to pick a side as split gets ugly^gwen and blake make happy family after spring break getaway^brad pitt is absolutely smitten with rockstar mit professor neri oxman^honeymoon rihanna cozies up to billionaire boyfriend during romantic paris getaway^kim kardashian baby name shocker star fights with pregnant kylie over what to call daughter^baby on the way jessica simpson shows off possible baby bump in racy mini dress^big bang theory catfight inside kaley amp mayim icy backstage relationship^sleazy matt lauer dumped by longtime long island pals after shocking sex scandal^kanye west furious over kim kardashian treatment of chicago she isn into it^kourtney crashes justin amp selena church date^bad boy baby daddy travis scott pleads guilty to disorderly conduct^jen amp brad having intense talks prior to sudden split with justin^caitlyn skin cancer hell jenner terrified she will lose her nose^why she here mortified kendall jenner in tears over latest fan backlash^revenge body jennifer garner flaunts toned figure at gym see the photos^lesbian lovers inside drew barrymore amp kristen stewart flirt thon^katie holmes reignites friendship with james van der beek to make jamie jealous^selena hell gomez goes to rehab as friends fear another drug relapse^justin theroux ditches wedding ring amid jennifer aniston divorce drama^justin theroux hangs out with bff emma stone after jennifer aniston divorce^stick thin amp wasting away lb jim carrey dieting to death pals fear^mark salling cause of death revealed^it over lena dunham and jack antonoff break up after five years together^demi lovato awake family after apparent overdose rep says^ellen page marries longtime girlfriend emma portner^brooke burke files for divorce from david charvet after years of marriage^nick jonas priyanka chopra are reportedly engaged^7th heaven star jeremy london is arrested for alleged domestic violence^the best royal wedding dresses all time^tyler baltierra slams rumors he been cheating on depressed wife catelynn lowell^ready to pop khloe kardashian celebrates tristan thompson birthday,43,10,-33,53,0.8113207547169812,-0.6226415094339622,1
3911239745,ThePerezHilton,1009,131598,977,136719,0,1,49,3,this personal account perez hilton he proud dad founder one famous websites world follow,michael steele former republican national committee chairman this says lot^congratulations kylie jenner getting pregnant and happy brad pitt jennifer aniston reconci^gigi hadid fed speculation zayn zaynmalik^congratulations kylie jenner getting pregnant and happy brad pitt jennifer aniston reconci^does mean khloe kardashian done sensible thing dumped tristan thompson^i surprised gotten done yet khloekardashian^scott disick new girlfriend prominently background kourtney kardashian photo accident shade^justin selena end eloping within months i feel justinbieber selenagomez^this dude looks like liam hemsworth chris hemsworth wild usopen^i wishing long happy marriage ... meghan markle prince harry divorce would eve^girlfriend teenager anymore sofiarichie^kylie jenner may already pregnant travisscott^in case missed ... keeping kardashians vacation krisjenner kourtneykardashian^i love brad pitt standing ground fathers fighting kids angelinajolie^angelina jolie fighting dirty want brad pitt joint custody geesh^angelinajolie custody battle bradpitt turns nasty is kourtneykardashian getting back together with^now already married justin bieber hailey baldwin rush church ceremony^justin bieber may selena gomez hailey baldwin team sprung hyperdrive^girlfriend teenager anymore sofiarichie^in case missed ... keeping kardashians vacation krisjenner kourtneykardashian^first mentioning mom keith urban i 'm tears anyone else crying nicole kidman goldenglobes speech^khloekardashian cheated again nickiminaj new album flop drug overdose kyliejenner birthday part^next time upset husband imagine bullshit kim kardashian put till death^kanye mom would approve latest antic cardib got nickiminaj desperate attention bradpitt and^jenniferaniston justin theroux confirmed separating meanwhile bradpitt remains single i^brody jenner better his wedding guests already pay international travel and^i love ... songwriter well the shade watch here katyperry taylorswift americanidol^taylorswift plagiarizes torispelling broke clueless and today hottest topics watch video in^congratulations kylie jenner getting pregnant and happy brad pitt jennifer aniston reconci^i sure selena gomez timothee chalamet thrilled press woody allen film^i sure selena gomez timothee chalamet relieved press^what nasty thing i say either nothing^khloe getting revenge body back hard way right way khloekardashian^the latest arianagrande amp petedavidson plus justinbieber regrets marrying haileybaldwin a royal baby^should hailey baldwin worried selenagomez justinbieber^fill blank alessandra ambrosio hair^angelinajolie custody battle bradpitt turns nasty is kourtneykardashian getting back together with^bradpitt angelinajolie custody battle still bitter the exes heading court zaynmalik throwing j^kylie jenner fans bored^looks bored performance kylie is cancelled vmas^khloe define relationship tristan talks true dad.^people upset photo one many reasons donald trump got elected^beyonce insecure marriage biting culprit uncovered and today hottest topics watch video ful^should hailey baldwin worried selenagomez justinbieber^girlfriend teenager anymore sofiarichie^says wants family limits remember back dragged^will jenner kids always refer dad eventually switch mom^i love ... songwriter well the shade watch here katyperry taylorswift americanidol^i love honest dave bautista guardiansofthegalaxy jamesgunn disney marvel chrispratt^cue never ever getting back together^we know tristan thompson gon na cheat but hopefully avoid khloe kardashian pre^they got engaged joe jonas sophie turner nick jonas priyanka chopra getting married first^khloe kardashian sounds like ready make clean break tristanthompson,49,4,-45,53,0.9245283018867924,-0.8490566037735849,1
18812301,katiecouric,3574,1742686,12437,39550,0,3,50,0,journalist founder head katie couric media sign daily newsletter wake-up call hitting link bio,"nearly ,000 people united states died guns last year marking highest number gun deaths decad^lunch white house prepping interview david axelrod we sen. john mccain webcast tonight^nearly ,000 people united states died guns last year marking highest number gun deaths decad^what covfefe trump tweet unites bewildered nation the new york times^today mondaymotivation reminder remember women men came us endure^today announced reese witherspoon mahershala ali marlee matlin ken jeong many others join m^today national gun violence awareness day if listened podcast s^so excited talk good friend bill koenigsberg today next chapter new me^after texas school shooting houston police chief says 'hit rock bottom inaction gun control usa to^this tweet captures state health care america today via^it pleasure sit four incredible female leaders today myth busting panel about^important thousands women could forgo chemotherapy early stage breast cancer study says usa today^keeping watch today ...^had great time speaking morning excited rest witw events begin su^hey senator any comment today press conference helsinki the russians friends^judge rules trump administration wrongly detaining asylum seekers usa today^it thursday know means new podcast today talk author good mad the^in light news today i think important revisit gender revolution project i worked with^if looking something listen today check podcast she tells us the^on sept. th stream first kind digital show i thrilled part feat today top i^today i moderating panel talk educating supporting providing hope individuals and^if listened latest podcast check commute home today he share^starbucks closes more than ,000 stores today for racial bias training^special podcast today i spoke ceo national abt horrific tragedy pittsbu^you may say i 'm dreamer i 'm one i hope someday 'll join us world one.^my sister emily passed away yrs ago today emily running lt. gov va diagnosed pancr^looking forward talking today bloombergequality you watch on^on today podcast i talk abt personal connection cancer amp dr. bill nelson renowned phy^i spent time talking one women confronted elevator today capitol hill.^i knew job go meet people love them. remembering princessdiana today w^i went offices nyc today check protests talk one walkout organizers^quote conversation podcast today addressing attack tree life synag^words live john f. kennedy would today jfk^president trump cancels white house invitation super bowl champion eagles usa today^thought could use bit palette cleanser timeline today i love royals i love babies so^congrats friend new book imagine it forward today she incredible businesswo^hi twitter friends today new day fresh start do n't hold back mondaymorning mondaymotivaton^today worldenvironmentday here reasons passonplastic^you might find podcast interesting listen today browder one important a^today wednesdaywomen also happens fall worldmentalhealthday i wanted feature elyse fox founder of^omg such good memories flashbackfriday happybirthdayfriends^it one year since vegas shooting killed people left injured today i 'm thinking the^three years ago today supreme court legalized gay marriage i sat man hea^in honor intl wrongful conviction day join supporting chains powerful documentary i 'm exec producing^fun talk david solomon today talksatgs americainsideout^today nationalvoterregistrationday i 've teamed help get people registered^the numbers irrefutable judge rules trump administration wrongly detaining asylum seekers^it moving speak janekrakowski morning father struggle dementia today anno^did know almost votes cast early absentee ballot today powering fir^fun talk today americainsideout world podcasting you listen^trump blasts theresa may interview threatens overshadow visit britain usa today^today wednesdaywoman michelle lee librarian created dress up lending library work^watch morningjoe today i talking new podcast part docu series looking back",50,3,-47,53,0.9433962264150944,-0.8867924528301887,1
135676285,hypervocal,850,4834,280,220209,0,15,15,22,trending internet news purveyors vital viral tweets automated based headlines/links trending among category-based influencers,clinton lead over trump shrinks points new nbc news/wsj poll nbc news^donate today planned parenthood action center^donate today planned parenthood action center^gop lawmaker condemned inviting holocaust denier state union^trending rudy giuliani just revealed what donald trump would need get before agreeing interview with robe^donald trump featured new jihadist recruitment video the washington post^donald trump featured new jihadist recruitment video the washington post^donald trump featured new jihadist recruitment video the washington post^the democratic presidential debate st. anselm college new hampshire the atlantic^the democratic presidential debate st. anselm college new hampshire the atl ...^supreme court may soon lack protestant justices^gop lawmaker condemned inviting holocaust denier state union^read full text hillary clinton campaign launch speech^huckabee 'morning joe attacks trump are 'mosquito bite should be ignored^michelle obama calls 'forever first lady speech students^comedian leslie jones says america 'way trump^trending reese witherspoon mgm bringing the gang back for legally blonde^trending hillary clinton got standing ovation while supporting bette midler hello dolly return^trending meghan markle mom doria ragland is looking forward becoming grandmother i 'm 'very happy'^trending its b a n a n a s gwen stefani kicks off vegas residency show blake shelton hand^trending steven spielberg meryl streep trump news why 'the post had be made now everyone i know^trending the promise carrie fisher final 'star wars appearance^golden globes the complete list of nominees^trending emmy awards the winners list^trending telluride nicole kidman 'destroyer tour de force could return her oscar contention^trending nicole kidman bravely captures tarantula her horrified children look on 'get back mom '^trending courteney cox amp lisa kudrow have mini friends reunion before show th anniversary^trending courteney cox amp lisa kudrow have mini friends reunion before show th anniversary^trending jessica alba cash warren welcome son hayes alba see his adorable first photo^trending selena gomez is 'feeling empowered after continuing treatment anxiety amp depression source^trending laura prepon ben foster are married 'thank you all love^trending luann de lesseps accuses russell simmons groping her elevator 'he was just pig'^'jeopardy host alex trebek recovering surgery remove blood clots brain^trending vanderpump rules stars jax taylor brittany cartwright are engaged see ring^louis ck accused sexual misconduct five women^trending ashley judd sues harvey weinstein sexual harassment defamation^stan lee feeling great after brief hospitalization^trending read every romantic word prince harry meghan markle royal wedding vows^trending jt is back justin timberlake announces new album man woods sneak peek video^trending 'outlander renewed seasons starz^trending fuller house renewed for season by netflix^meghan mccain joins 'the view regular co host^trending surprise ariana grande pete davidson are engaged after dating few weeks^trending lady gaga announces las vegas residency 'i 'll leave my heart on stage every single night'^trending the second act kristen bell^trending liam payne niall horan have partial one direction reunion indiana concert^trending mickey mouse helps foster parents tell two kids theyre officially being adopted^trending serena williams withdraws australian open 'i 'm not where i want be after baby birth^trending justin timberlake wants have 'as many kids he can wife jessica biel^big little lies meryl streep joins season cast of hbo series^oscars the complete list winners nominees th academy awards^trending jennifer lawrence says she wants take break acting milk goats farm,15,37,22,52,0.28846153846153844,0.4230769230769231,0
25998954,wyffnews4,355,119991,949,295469,3,8,15,26,the official wyffnews4 twitter site,"melania trump undergoes kidney surgery walter reed medical center^people found dead ohio^people found dead ohio^president trump ended speech tuesday national federation independent business big bear^most popular baby names every u.s. state^most popular baby names every u.s. state^most popular baby names every u.s. state^most popular baby names every u.s. state^us slaps 50 billion tariffs chinese goods escalating trade dispute^us slaps 50 billion tariffs chinese goods escalating trade dispute^us slaps 50 billion tariffs chinese goods escalating trade dispute^what roseanne barr net worth^what roseanne barr net worth^what roseanne barr net worth^what roseanne barr net worth^megyn kelly weighs matt lauer fired 'today show^megyn kelly weighs matt lauer fired 'today show^david cassidy fighting memory loss wants 'enjoy life^david cassidy fighting memory loss wants 'enjoy life^george clooney makes 27,283 every hour thanks tequila^smooth moves two sc natives dance finalists 'live kelly ryan^smooth moves two sc natives dance finalists 'live kelly ryan^smooth moves two sc natives dance finalists 'live kelly ryan^mariah carey new year eve performance 'they foiled^'free speech rally 'fight supremacy groups set converge boston common^caitlyn jenner latest celebrity float run office^koko gorilla knew sign language dies^james franco event canceled actor denies allegations sexual misconduct^playboy founder hugh hefner cause death revealed^playboy founder hugh hefner cause death revealed^playboy founder hugh hefner cause death revealed^playboy founder hugh hefner cause death revealed^mindy kaling reportedly pregnant first child^mindy kaling reportedly pregnant first child^'clueless actress stacey dash running congress california^'clueless actress stacey dash running congress california^'clueless actress stacey dash running congress california^'clueless actress stacey dash running congress california^kaley cuoco marries karl cook intimate horse ranch wedding^kaley cuoco marries karl cook intimate horse ranch wedding^kaley cuoco marries karl cook intimate horse ranch wedding^discovery channel 'storm chasers star joel taylor dead^discovery channel 'storm chasers star joel taylor dead^discovery channel 'storm chasers star joel taylor dead^discovery channel 'storm chasers star joel taylor dead^billboard music awards check complete list winners^everything need know 'this is us season^billboard music awards check complete list winners^netflix is reportedly reviving carmen sandiego with gina rodriguez^netflix is reportedly reviving carmen sandiego with gina rodriguez^reese witherspoon confirms 'legally blonde happening^reese witherspoon confirms 'legally blonde happening",18,34,16,52,0.3461538461538461,0.3076923076923077,0
24216951,vulture,2984,477236,7904,172390,0,4,35,13,devouring culture ig subscribe new york vulture,progressive activist sexandthecity star cynthia nin coming vulturefestival la 'll discuss th^progressive activist sexandthecity star coming vulturefestival la 'll discuss th^progressive activist sexandthecity star cynthia nin coming vulturefestival la 'll discuss th^progressive activist sexandthecity star coming vulturefestival la 'll discuss th^blac chyna ca n't trademark angela kardashian even marries rob^amy schumer sent pretty frank note friend jennifer lawrence split director darren aronofsky^brad pitt accused child abuse reportedly investigation^brad pitt accused child abuse reportedly investigation^here everything know brad pitt plane incident^here everything know brad pitt plane incident^theinnocents recap harry proves love june sticking even discovering shapeshifting wa^as much dr. ben pretends center whole little shapeshifting world created three^katie couric reportedly disturbed distressed detailed accounts matt lauer alleged sexual misconduct^katie couric reportedly disturbed distressed detailed accounts matt lauer alleged sexual misconduct^katie couric slams today matt lauer completely unacceptable workplace harassment^katie couric slams today matt lauer completely unacceptable workplace harassment^thecrown found young prince charles maybe hot^thecrown found young prince charles maybe hot^thecrown found young prince charles maybe hot^ben affleck quitting batman might disaster dc superhero movies need^ben affleck quitting batman might disaster dc superhero movies need^ben affleck quitting batman might disaster dc superhero movies need^tessa thompson may romantic spaghetti thing justin theroux lady tramp remake^where justin timberlake performance rank list best superbowl halftime shows spoiler ve^where justin timberlake performance rank list best superbowl halftime shows spoiler ve^olivia wilde jason sudeikis are getting married^matthew mcconaughey says time us embrace president donald trump^matthew mcconaughey says time us embrace president donald trump^blake shelton new revenge song definitely came here forget miranda lambert listen^going play boyfriend new rom com get together^chlo grace moretz outraged marketing campaign movie red shoes amp dwarfs^chlo grace moretz outraged marketing campaign movie red shoes amp dwarfs^this new aquaman clip features nicole kidman destroying henchman impressive trident combat skills a^mariah carey believes botched new year performance sabotaged they foiled^mariah carey believes botched new year performance sabotaged they foiled^mandy moore talked thisisus jack death^tessa thompson may romantic spaghetti thing justin theroux lady tramp remake^made mexico like version keeping up with kardashians less family lifestyl^selena gomez psychiatric facility admitted last month suffering emotional breakdo^outlander caitriona balfe engaged sam heughan^outlander caitriona balfe engaged sam heughan^outlander caitriona balfe engaged sam heughan^taylor swift released new song gorgeous listen^alec baldwin pre declared victor trump choose run president^ariana grande adresses mac miller breakup i cared tried support sobriety prayed h^cynthia nin gets delayed subway way try fix subway^cynthia nin gets delayed subway way try fix subway^kathie lee gifford says still talks harvey weinstein bill cosby i judge^blac chyna granted temporary restraining order rob kardashian^blac chyna granted temporary restraining order rob kardashian^twin peaks makes return everything know^katharine mcphee david foster engaged,35,17,-18,52,0.6730769230769231,-0.3461538461538461,1
25451167,KTVZ,113,22698,510,102954,0,47,3,1,central oregon news leader ktvz newschannel bend oregon,"a multistate outbreak listeria traced houston manufacturer vietnamese ready eat pork products^a salmonella outbreak affected people states including one case oregon linked kellog^homicides suicides involving guns increasing according new data us centers disease c^always wash hands handling live poultry that reminder us centers disease control and^as thanksgiving nears cases salmonella including death linked raw turkey products acc^men work construction extraction highest rates suicide united states according r^just in the us centers disease control prevention warned us consumers tuesday eat romaine lettu^the us centers disease control prevention reported today patients investigation th^an outbreak e. coli linked romaine lettuce yuma arizona growing region spread four addition^abortion rates united states dropped lowest level years according report released^the strain e. coli causing current outbreak romaine lettuce found reservoir farm sa^the first confirmed us case andes virus reported delaware hospital january us centers disease^suicide rates increased across united states nearly two decades ending according resear^there confirmed cases polio like illness known afm states year us centers fo^eighty seven people sickened salmonella linked recalled beef products us centers di^measles cases around world surged according new report jointly published wor^the us centers disease control prevention escalated response illness struck children^an outbreak salmonella linked raw turkey products sickened least people across states including^cigarette use among american adults lowest since centers disease control prevention^retired adm. william mcraven today stood previous statement president trump attacks news media^the republican national committee picked charlotte north carolina host convention las vegas t^video the third final segment debate gov kate brown state rep. knute buehler tonight from^video the second segment debate deschutes county commission candidates amy lowes tony debone patt^retired adm. william mcraven today stood previous statement president trump attacks news media^program note nbc sunday night football broadcast game world series fox pre empt tonight p.m.^a multistate outbreak listeria traced houston manufacturer vietnamese ready eat pork products^homicides suicides involving guns increasing according new data us centers disease c^always wash hands handling live poultry that reminder us centers disease control and^as thanksgiving nears cases salmonella including death linked raw turkey products acc^men work construction extraction highest rates suicide united states according r^just in the us centers disease control prevention warned us consumers tuesday eat romaine lettu^the us centers disease control prevention reported today patients investigation th^abortion rates united states dropped lowest level years according report released^the strain e. coli causing current outbreak romaine lettuce found reservoir farm sa^the first confirmed us case andes virus reported delaware hospital january us centers disease^another people become ill eating lettuce contaminated e. coli us centers disease control^there confirmed cases polio like illness known afm states year us centers fo^eighty seven people sickened salmonella linked recalled beef products us centers di^measles cases around world surged according new report jointly published wor^the us centers disease control prevention escalated response illness struck children^cigarette use among american adults lowest since centers disease control prevention^update a police officer doctor pharmaceutical assistant dead shooting chicago mercy hosp^republican sen. cindy hyde smith win mississippi us senate runoff election cnn projects contest that^the oregon department agriculture seven oregon agribusinesses joining u.s. department agriculture^jbs tolleson inc. recalling million pounds raw beef products may tainted salmonell^more ,000 pounds hormel spam canned meat products recalled might contai^warm springs hotshots fight fires serve community one four elite crews nation administered b^update our ktvz sat today surrogate mother something special compensation^catherine duchess cambridge wife britain prince william given birth son royal family a^catherine duchess cambridge wife britain prince william given birth son royal family a^kelly ripa new live co host named ryan seacrest",3,48,45,51,0.05882352941176471,0.8823529411764706,0
17187236,12News,11927,210758,1740,367644,0,3,7,41,at news it matter facts we listen seek solve people arizona news tip connect.com a tegna company,people identify lgbtq greater risk sexual violence according centers disease control a^most popular baby names by state^most popular baby names by state^kim kardashian returns white house make case another convict release^emmy awards the winners list^emmy awards the winners list^channing tatum jenna dewan announce separation^channing tatum jenna dewan announce separation^channing tatum jenna dewan announce separation^channing tatum jenna dewan announce separation^koko gorilla knew sign language dies^koko gorilla knew sign language dies^koko gorilla knew sign language dies^ex 'dance moms star abby lee miller sentenced year prison^walmart remove 'cosmopolitan magazine checkout lines amid me too movement^walmart remove 'cosmopolitan magazine checkout lines amid me too movement^walmart remove 'cosmopolitan magazine checkout lines amid me too movement^walmart remove 'cosmopolitan magazine checkout lines amid me too movement^the best memorial day sales home appliances^scott baio wife renee reveals microvascular brain disease diagnosis^scott baio wife renee reveals microvascular brain disease diagnosis^scott baio wife renee reveals microvascular brain disease diagnosis^scott baio wife renee reveals microvascular brain disease diagnosis^'house cards teaser reveals fate kevin spacey frank underwood^'house cards teaser reveals fate kevin spacey frank underwood^'house cards teaser reveals fate kevin spacey frank underwood^report meghan markle dad longer attend royal wedding^meghan markle dad longer attend royal wedding^report meghan markle dad longer attend royal wedding^report meghan markle dad longer attend royal wedding^veep actress julia louis dreyfus diagnosed breast cancer^'nypd blue creator steven bochco dead^reports priyanka chopra nick jonas engaged two months dating^reports priyanka chopra nick jonas engaged two months dating^reports priyanka chopra nick jonas engaged two months dating^lady gaga announces las vegas residency dates^lady gaga announces las vegas residency dates^lady gaga announces las vegas residency dates^cardi b confirms secretly married offset september 'engaged^cardi b confirms secretly married offset september 'engaged^cardi b confirms secretly married offset september 'engaged^wwe star vader dead age^wwe star vader dead age^wwe star vader dead age^the black panther tweeted movie time^prince william prince harry best man royal wedding^prince william prince harry best man royal wedding^prince william prince harry best man royal wedding^april giraffe pregnant^april giraffe pregnant^april giraffe pregnant,7,44,37,51,0.13725490196078433,0.7254901960784313,0
23618466,wbaltv11,743,260698,1843,370145,2,8,14,27,wbal-tv news maryland live local latebreaking news leader fb/ig newstips -338-6501,"melania trump undergoes kidney surgery walter reed medical center^people found dead ohio^french president macron address joint session congress^most popular baby names every u.s. state^most popular baby names every u.s. state^most popular baby names every u.s. state^most popular baby names every u.s. state^ap white house vice president joe biden make statement rose garden^us slaps 50 billion tariffs chinese goods escalating trade dispute^us slaps 50 billion tariffs chinese goods escalating trade dispute^what roseanne barr net worth^what roseanne barr net worth^what roseanne barr net worth^what roseanne barr net worth^megyn kelly weighs matt lauer fired 'today show^megyn kelly weighs matt lauer fired 'today show^david cassidy fighting memory loss wants 'enjoy life^icymi david cassidy fighting memory loss wants 'enjoy life^david cassidy fighting memory loss wants 'enjoy life^george clooney makes 27,283 every hour thanks tequila^mariah carey new year eve performance 'they foiled^mariah carey new year eve performance 'they foiled^'free speech rally 'fight supremacy groups set converge boston common^caitlyn jenner latest celebrity float run office^koko gorilla knew sign language dies^koko gorilla knew sign language dies^james franco event canceled actor denies allegations sexual misconduct^playboy found hugh hefner cause death revealed^playboy founder hugh hefner cause death revealed^playboy founder hugh hefner cause death revealed^mindy kaling reportedly pregnant first child^mindy kaling reportedly pregnant first child^mindy kaling reportedly pregnant first child^'clueless actress stacey dash running congress california^'clueless actress stacey dash running congress california^'clueless actress stacey dash running congress california^'clueless actress stacey dash running congress california^kaley cuoco marries karl cook intimate horse ranch wedding^kaley cuoco marries karl cook intimate horse ranch wedding^discovery channel 'storm chasers star joel taylor dead^discovery channel 'storm chasers star joel taylor dead^discovery channel 'storm chasers star joel taylor dead^discovery channel 'storm chasers star joel taylor dead^billboard music awards check complete list winners^everything need know 'this is us season^billboard music awards check complete list winners^netflix is reportedly reviving carmen sandiego with gina rodriguez^reese witherspoon confirms 'legally blonde happening^april giraffe pregnant^april giraffe pregnant^april giraffe pregnant",16,35,19,51,0.3137254901960784,0.3725490196078432,0
20123224,Wonderwall,1942,75210,729,57931,0,0,29,22,get daily dose exclusive celebrity interviews breaking news gossip,bet jessica simpson wishes she gave birth weeks early look baby bump^could jenniferlopez amp benaffleck get back together jlo bff answers bennifer^selena gomez gets kidney transplant fergie josh duhamel split icymi news^check amp stay shape weekend here^gwen stefani convince blake shelton accept sexiest man title plus celeb news thursday nov.^adele not panicking entourage missing grammys contrary recent report^pregnant miranda kerr reportedly already spent 250k nursery^angelinajolie bradpitt still fighting custody plus news^kim kardashian west details fights husband kanye west instagram hangout time amp band aids^angelina jolie happy current custody deal brad pitt report^friends terrified possible reconciliation^who stylish celeb hollywood watch might kim kardashian/lauren conrad catfight ...^is fka twigs jealous kristen stewart^cnn mistakes faith hill faith evans^angelina jolie reveals i n't enjoy single amid new buzz brad pitt reconciling^gorgeous see dakota johnson cate blanchett lady gaga bradley cooper naomi watts benedict cumberbatch amp dozens^teresa giudice dating businessman report claims^pregnant miranda kerr reportedly already spent 250k nursery^live tv blooper giuliana julia roberts more importantly ... moving fans fell curb gate collapse yikes sagawards^will angelina jolie kate hudson golden globes showdown^is planning secret vegas wedding^khloe kardashian reacts tristan thompson cheating scandal finally airs 'kuwtk^khloe kardashian reacts tristan thompson cheating scandal finally airs kuwtk^kim kardashian west details fights husband kanye west instagram hangout time amp band aids^pacey amp joey potter aka joshua jackson amp katie holmes non dawson creek fans reunite^is blake shelton transforming gwen stefani country singer^kim kardashian west details fights husband kanye west instagram hangout time amp band aids^are biglittlelies stars reese witherspoon nicole kidman feuding^are reese witherspoon nicole kidman feuding^enrique iglesias anna kournikova secretly welcome twins^'this is us star justin hartley marries chrishell stause plus romance updates^'the mindy project star fortune feimster engaged^priyanka chopra nick jonas biggest fan brazil concert^lea michele engaged zandy reich check carat diamond ring^broke girls star beth behrs marries mad men alum michael gladis idaho plus celebrity weddings yea^howie mandel n't remember meghan markle 'deal no deal^meghan markle prince harry arrive windsor castle confirms dad wo n't attend royal wedding^former mtv vj jesse camp reported missing sister^kit harington rose leslie wedding date revealed^singer jason aldean wife brittany welcome first child together^kaley cuoco marries karl cook socal horse farm felicity jones weds director charles guard english castle pl^prince harry wanted royal family^david foster yolanda hadid officially divorced^like omg kim kardashian attends year high school reunion^karlie kloss amp joshua kushner engaged years dating john david duggar amp abbie grace burnett enga^well say third times charm ... i 'm going back treatment people weeks work trauma getti^did scott disick send flowers bella thorne kourtney kardashian day^from dress guests amp jewels kiss cake carriage amp little details prince har^mama june daughter lauryn 'pumpkin shannon pregnant^reclusive richard simmons hospitalized evere indigestion^is khloekardashian finally ready leave tristanthompson plus news,29,22,-7,51,0.5686274509803921,-0.13725490196078433,1
31516515,ClevverTV,416,199314,1339,49720,1,0,31,19,a smart news source things entertainment hosted mourad a subsidiary hearst magazines,an old tweet resurfaced relatable af meme^kylie jenner might 've dropped hint travis scott secretly married^kim kardashian defends kylie jenner self made billionaire cover backlash^chris pratt files for divorce from anna faris via^chris pratt files divorce anna faris months separation^bts shuts down amas selena gomez upset over justin bieber dhr via^the real reason selena gomez amp justin bieber did n't spend thanksgiving together via^justin bieber amp selena gomez confirm relationship with kiss via^justin bieber amp selena gomez caught making going date^kylie jenner amp khloe kardashian plan joint birth via^first justin bieber one falling onstage who better^selena gomez sued over rw taylor swift thinking marriage with joe dhr via^christina aguilera shows demi lovato love fallinline performance^taylor swift reputation tour in trouble due to demanding ticket prices via^kim kardashian eats human flesh for ritual rumor patrol via^ed sheeran weighs in on taylor swift feud with katy perry via^ed sheeran weighs in on taylor swift feud with katy perry via^selena gomez elains why she back with justin bieber amp split with the weeknd via^when abelena still thing the weeknd made 'upbeat 'beautiful album but split selena gome^do n't worry kourtney kardashian recent breakup think gon na juuusssttt fine^katy perry shades taylor swift after american idol contestant gushes over her via^katy perry seeking revenge on selena gomez with the weeknd rumor patrol via^kris jenner furious with travis scott for not being there for kylie via^travis scott pleads guilty disorderly conduct days stormi birth^blac chyna suing entire kardashian family for multiple reasons^blac chyna suing the entire kardashian family for this reason via^great big sister ... think 'd make cool mom one day we^jake paul ends daily vlogging is taylor swift hiding relationship with joe dhr via^kylie jenner might 've dropped hint travis scott secretly married^justin bieber ruins selena gomez reunion kendall jenner quits modeling rumor patrol via^kim kardashian terrified her kids being bullied on social media via^katy perry shades taylor swift after american idol contestant gushes over her via^jay z teases new album :44 amp adnis first listen via^kylie jenner unveils new baby stormi inspired cosmetics collection via^glee star charice pempengco changes name jake zyrus via^another weekend engagement darren criss engaged mia swier years dating^khloe kardashian makes first public appearance since pregnancy news via^ariana grande reacts to being named first ever honorary citizen of manchester via^khloe kardashian plans give birth cleveland via^kendall jenner hospitalized attending vanity fair oscar party vfoscars^ariana grande cancels vietnam concert due health problems via^things definitely going ~the way~ mac miller probs hoped right one week breakup a^rachel mcadams reportedly pregnant first child amp due soon^taylor swift teases futuristic ... ready for it music video via^taylor swift teases new song gorgeous with snippet via^taylor swift music video director claims beyonce copied bad blood via^demi lovato tour will include free therapy sessions amp workshops for fans via^iggy azalea responds to halsey calling her a f**king moron via^khloe kardashian very torn amp not ready to give up on tristan thompson via^chris pratt files for divorce from anna faris via^chris pratt files divorce anna faris months separation,32,19,-13,51,0.6274509803921569,-0.2549019607843137,1
31967458,cities97radio,357,17546,316,34442,0,2,34,15,cities uniquely twin cities cities971,the baby names most popular in each state^the most popular baby names by state^robert pattinson on movie roles 'people are trying to put you in a box^john mayer has been hospitalized emergency appendectomy^sag awards nominations see full list of screen actors guild nominees^chris pratt files divorce from anna faris^sharon osbourne apologizes to justin bieber 'i was wrong to 'attack you^jamie foxx katie holmes finally out public as couple^celebrities react trump withdraws steph curry white house invitation^celebrity reaction jimmy kimmel monologue on las vegas shooting and guns^celebrity reactions donald trump phoenix rally speech^jimmy kimmel talks donald trump harvey weinstein on 'gma^stars celebrate rosh hashanah see celebrity tweets about jewish new year^selena gomez vogue cover story see interview highlights^katie couric said matt lauer pinched her on the ass on 'today back in^kendall jenner jealous ex^celebrities react to hurricane irma^chris soules had no alcohol in system after crash negative for drugs^did jennifer lopez 'like a comment dissing mariah carey^katie holmes not pregnant and planning wedding with jamie foxx^lady gaga taylor kinney not secretly dating despite late and wrong report^lady gaga taylor kinney not secretly dating despite late and wrong report^sorry drake amp bella hadid are not 'secretly dating^kim kardashian sued for allegedly stealing lighting technique for selfies^ryan lochte charge dropped in rio robbery case^kim kardashian slams cocaine claim 'i do not play with rumors like this^celebrity reactions prince harry meghan markle engaged^robert pattinson amp katy perry are not dating^beyonce birth twins still hospital 'minor issue^justin bieber fan arrested trespassing at singer beverly hills home^joe jonas sophie turner 'already thinking of having kids is made up story^flo rida not performing at donald trump inauguration despite report^kim kardashian slams 'invasive surrogacy reports^jimmy fallon felt need to share 'heartfelt message about charlottesville^no zayn is not 'desperate to defend girlfriend gigi hadid^chris soules 'devastated after killing kenny mosher in fatal accident^here how help victims las vegas mass shooting^khlo kardashian makes her first public appearance since pregnancy news^april the giraffe finally gives birth to an audience million^the bachelor bekah m was on missing persons list until fan recognized her^rachel mcadams is reportedly pregnant with her first child^hugh hefner cause death has been revealed^hugh hefner cause death revealed^jenny slate and chris evans break up again^star jones ex husband al reynolds comes out as bisexual in candid blog^watch harry styles kiss james corden in christmas themed 'carpool karaoke^'storm chasers star joel taylor dead at^jennifer lawrence darren aronofsky split^gigi hadid slams body shamers for calling her 'too skinny at nyfw^'black panther is officially the most tweeted about movie of all time^chris pratt files divorce from anna faris,34,17,-17,51,0.6666666666666666,-0.3333333333333333,1
26318924,967kissfm,2176,9929,168,67330,0,0,34,17,austin hit music station home greg an station,john mayer has been hospitalized emergency appendectomy^sag awards nominations see full list of screen actors guild nominees^american music awards nominations amas nominees full list^ed sheeran did not 'break friendship code with taylor swift^beyonce not demanding silent delivery room despite report^are selena gomez amp the weeknd working on a movie together^jimmy kimmel talks donald trump harvey weinstein on 'gma^selena gomez vogue cover story see interview highlights^katie couric said matt lauer pinched her on the ass on 'today back in^chris soules had no alcohol in system after crash negative for drugs^did jennifer lopez 'like a comment dissing mariah carey^did jennifer lopez 'like a comment dissing mariah carey^kanye west concerts on hold indefinitely^katie holmes not pregnant and planning wedding with jamie foxx^lady gaga taylor kinney not secretly dating despite late and wrong report^sorry drake amp bella hadid are not 'secretly dating^celebrity reactions prince harry meghan markle engaged^watch kim kardashian first interview since robbery on 'ellen degeneres show videos^hailee steinfeld responds to justin bieber dating rumors^beyonce birth twins still hospital 'minor issue^is liam hemsworth mad at miley cyrus for texting nick jonas^justin bieber fan arrested trespassing at singer beverly hills home^split selena gomez amp the weeknd call it quits^is demi lovato upset about meghan trainor performing the 'smurfs movie song^twitter reacts zoe saldana says hollywood bullied donald trump^justin bieber did not attend vanity fair oscars after party^flo rida not performing at donald trump inauguration despite report^grammy awards see the full winners list^grammy awards see the full winners list^iggy azalea blasts nick young after accidental dinner reunion^fans react u2 cancels st. louis concert amid police protests^no zayn is not 'desperate to defend girlfriend gigi hadid^selena gomez reveals she had a kidney transplant amp her friend was her donor^mariah carey not dating both nick cannon and bryan tanaka despite report^harry styles announces intimate world tour see the dates^khlo kardashian makes her first public appearance since pregnancy news^the bachelor bekah m was on missing persons list until fan recognized her^taylor swift teases new song 'gorgeous on instagram listen to a snippet^rachel mcadams is reportedly pregnant with her first child^demi lovato reveals that she contemplated suicide at age^alex rodriguez year old daughter sings for jennifer lopez photos^taylor swift teases new song 'gorgeous on instagram listen to a snippet^jenny slate and chris evans break up again^justin timberlake announces 'the man of the woods tour see the dates^star jones ex husband al reynolds comes out as bisexual in candid blog^tori kelly is engaged to german basketball player andre murillo^'storm chasers star joel taylor dead at^jennifer lawrence darren aronofsky split^camila cabello announces her 'never be the same tour see the dates^gigi hadid slams body shamers for calling her 'too skinny at nyfw^demi lovato announces tour with dj khaled see the dates,34,17,-17,51,0.6666666666666666,-0.3333333333333333,1
17208738,heatworld,19627,369321,1854,174747,0,0,36,15,the hottest celebrity gossip latest trends tv news internet lols one place listen heat radio,is britney spears baby singer boyfriend 'is broody ready marriage^channing tatum jenna dewan split nearly years marriage^emma watson victoria beckham stars celebrate international women day happyinternationalwomensday^angelina jolie livid brad pitt mum buying shiloh girls clothes^miley cyrus 'calls wedding liam hemsworth shook^miley cyrus 'calls wedding liam hemsworth shook^miley cyrus 'calls wedding liam hemsworth shook^miley cyrus 'calls wedding liam hemsworth shook^miley cyrus 'calls wedding liam hemsworth shook^miley cyrus 'calls wedding liam hemsworth shook^did miley cyrus liam hemsworth secretly get married^did miley cyrus liam hemsworth secretly get married^did miley cyrus liam hemsworth secretly get married^did miley cyrus liam hemsworth secretly get married^did miley cyrus liam hemsworth secretly get married^game can beat keith lemon heat staring competition heatmakesyouhappy^nicole s tom d louis s miranda harry s keith lemon gary b morgana amp cast gazillions heat xmas double issue^did hear amal george clooney welcome twins^amal george clooney welcome twins congrats^the gc planning impress lord sugar new celebrity apprentice^is caitlyn jenner going celebrity big brother^caitlyn jenner offered 1million star celebrity big brother^kourtney kardashian mason jealous kim spending much time north celebnews^is caitlyn jenner going celebrity big brother^caitlyn jenner offered 1million star celebrity big brother^does khloe kardashian husband lamar odom feel betrayed possible x factor job celebnews^does khloe kardashian husband lamar odom feel betrayed possible x factor job celebnews^does khloe kardashian husband lamar odom feel betrayed possible x factor job celebnews^channing tatum jenna dewan split nearly years marriage^the spice girls reunion tour cancelled again and apparently posh spice ...^kim kardashian admits ridiculous selfie obsession took first self portrait^kate wright rio ferdinand a timeline super cute relationship^kate wright rio ferdinand a timeline adorbs relationship^selena gomez reveals kidney transplant instagram^kylie jenner taking six months spotlight amid pregnancy rumours^kylie jenner fuels pregnancy talk taking six months spotlight hmm suspicious ...^khloe kardashian makes first public appearance since pregnancy news^khloe kardashian makes first public appearance since pregnancy news^rachel mcadams reportedly pregnant first child^the american horror story season title revealed^the american horror story season title revealed^the american horror story season title revealed^the american horror story season title revealed^the american horror story season title revealed^the american horror story season title revealed^reese witherspoon confirms legally blonde happening^reese witherspoon confirms legally blonde happening^reese witherspoon confirms legally blonde happening^reese witherspoon confirms legally blonde happening^reese witherspoon confirms legally blonde happening^breaking reports coming kylie jenner pregnant first child more follow,36,15,-21,51,0.7058823529411765,-0.4117647058823529,1
15087120,CELEBUZZ,8786,825231,2882,108151,0,0,48,3,celebrity news photos features right amount shade,omg is katie holmes pregnant jamie foxx baby^omg is katie holmes pregnant jamie foxx baby^soulja boy backs apologizes chris brown feud karrueche tran^jenna bush hager apologizes 'hidden fences mistake golden globes^jenna bush hager apologizes 'hidden fences mistake golden globes^jenna bush hager apologizes 'hidden fences mistake golden globes^fergie dodges baby marriage questions days josh duhamel split via^celebrities react donald trump inauguration^did lindsay lohan convert islam^did lindsay lohan convert islam^did lindsay lohan convert islam^jennifer aniston angelia jolie make beautiful brides check wedding style showdown photos^little black dress style showdown jordin sparks vs jennifer aniston photos^angelina jolie jennifer aniston bikinis beyond style showdown photos^wedding white style showdown angelina jolie vs. jennifer aniston photos^did secretly get married^did secretly get married^justin bieber selena gomez ca n't stop making jamaican wedding via^happy move it monday says workout w/ pal share you stay shape w/ moveitwithcelebuzz^rumor brad pitt major body odor problems ...^angelina jolie reportedly fighting sole custody children brad pitt^queen lady gaga taylor kinney end engagement split five years together^rumor brad pitt dirt angelina jolie could hinder request custody^are rocks^now claudia jordan saying idea katie holmes jamie foxx dating^now claudia jordan saying idea katie holmes jamie foxx dating^angelina jolie brad pitt reportedly private divorce negotiations details^angelina jolie brad pitt reportedly private divorce negotiations details^are john mayer jennifer aniston back together these concertgoers think^take look inside 11 million home secretly listed^are secretly eecting baby number two^did get secretly married^watch break tears bruce jenner transition news^angelina jolie brad pitt reportedly private divorce negotiations details^angelina jolie brad pitt reportedly private divorce negotiations details^robert pattinson has not canceled his 'cosmopolis appearance says rep^did lindsay lohan convert islam^did lindsay lohan convert islam^did lindsay lohan convert islam^is angelina jolie having breakdown over brad pitt^is angelina jolie having breakdown over brad pitt^is angelina jolie having breakdown over brad pitt^kim kardashian terrified john legend eresses concern kanye west health^kim kardashian terrified john legend eresses concern kanye west health^brad pitt reportedly completely devastated angelina jolie divorce filing^brad pitt says wants quit acting three years^are kourtney kardashian scott disick really back together^are kourtney kardashian scott disick really back together^'superman star margot kidder dead via^glee creator shared first look show premiere featuring photo see^so cute beyonc debuts first photo twins sir rumi carter,48,3,-45,51,0.9411764705882352,-0.8823529411764706,1
14769365,brides,964,209487,2342,50296,0,0,10,40,endless inspiration wedding day beyond snapchat,"meghan markle prince harry a timeline their relationship^john krasinski travelled ,000 miles every weekend see emily blunt^justin bieber hailey baldwin are already married according new report^brody jenner is disappointed caitlyn jenner did not attend his wedding kaitlynn carter^*millionaire matchmaker* patti stanger reveals anna faris chris pratt are still living together^'bachelor in paradise stars jared haibon ashley iaconetti reveal their wedding officiant^prince harry meghan markle are moving out kensington palace new home windsor^this was prince harry meghan markle favorite moment their royal wedding^prince harry addressed meghan markle royal wedding aisle walking debacle^will meghan markle prince harry be honeymooning namibia^alicia vikander friends kidnapped her her bachelorette party^lea michele shares emma roberts darren criss reactions her engagement news^the crown matt smith got embarrassingly drunk james corden wedding^victoria secret model izabel goulart engaged soccer player kevin trapp^the mindy project fortune feimster is engaged and mindy is set officiate^matthew morrison wife renee puente welcome first child^john cena nikki bella celebrate their love weekend engagement party^meghan markle gets official royal aide ahead may wedding prince harry^quantico russell tovey is engaged steve brockman^dancing with stars pros emma slater sasha farber are married^icarly nathan kress welcomes first child^meghan markle has reportedly chosen a maid of honor royal wedding^it official prince charles will walk meghan markle down aisle royal wedding^rachel mcadams is reportedly pregnant with her first child^*melrose place* star josie bissett is married see photos outdoor ceremony^brittany cartwright jax taylor vanderpump rules are engaged^elle king just skipped out her own wedding wildest reasons^mindy kaling is pregnant with her first child^kendra duggar gives birth first child with joseph duggar^cardi b wants lit baby shower so we can only imagine what her bridal shower will be like^broke girls beth behrs celebrates bridal shower with bridesmaid kat dennings^jessica chastain joked that her italian in laws might hate her^demi lovato helps friend stage proposal her concert^bachelor paradise carly waddell evan bass reveal baby name^*arrow* katie cassidy is engaged matthew rodgers^meghan markle says her bachelorette party is already sorted^rose byrne bobby cannavale welcome baby no^meghan markle was n't allowed sit next prince harry pippa middleton wedding reception^game thrones kit harington rose leslie married see photos^bachelor paradise derek peth taylor nolan are engaged^michelle williams is officially engaged andrew youmans^matthew bellamy engaged model elle evans^katharine mcphee david foster are reportedly engaged^tom daley dustin lance black announce they 're eecting their first child^prince harry meghan markle ended valentine week with date see hamilton^prince harry meghan markle reveal all details their wedding cake^grey anatomy actress camilla luddington is engaged matthew alan^counting on josiah duggar lauren swanson married^counting on josiah duggar is engaged lauren swanson^prince harry meghan markle wedding florist flowers have been revealed",10,40,30,50,0.2,0.6,0
19673660,Z100Portland,1027,15286,456,163963,0,0,33,17,portland hit music station,john mayer has been hospitalized emergency appendectomy^american music awards nominations amas nominees full list^ed sheeran did not 'break friendship code with taylor swift^ed sheeran did not 'break friendship code with taylor swift^beyonce not demanding silent delivery room despite report^brad pitt and sienna miller caught flirting after movie premiere^selena gomez vogue cover story see interview highlights^selena gomez vogue cover story see interview highlights^chris brown slammed by judge for skipping karrueche tran court hearing^lorde sets record straight taylor swift friendship fiery letter^taylor swift wins countersuit against dj david mueller in groping trial^lady gaga taylor kinney not secretly dating despite late and wrong report^lady gaga taylor kinney not secretly dating despite late and wrong report^sorry drake amp bella hadid are not 'secretly dating^hailee steinfeld responds to justin bieber dating rumors^miley cyrus regrets nude wrecking ball video^beyonce birth twins still hospital 'minor issue^justin bieber fan arrested trespassing at singer beverly hills home^did katy perry diss taylor swift on 'american idol^is demi lovato upset about meghan trainor performing the 'smurfs movie song^justin bieber did not attend vanity fair oscars after party^justin bieber did not attend vanity fair oscars after party^are mariah carey amp joe jonas feuding^are mariah carey amp joe jonas feuding^joe jonas sophie turner 'already thinking of having kids is made up story^we 'll updating night grammy awards see the full winners list z100 portland grammys^iggy azalea blasts nick young after accidental dinner reunion^avril lavigne 'mildly amused by death conspiracy^kanye west is not rebooting 'american idol^justin bieber amp hailey baldwin a timeline their relationship^'the voice stars gwen stefani blake shelton told to show more pda on show^did katy perry diss taylor swift on 'american idol^mariah carey not dating both nick cannon and bryan tanaka despite report^here how help victims las vegas mass shooting^harry styles announces intimate world tour see the dates^taylor swift teases new song 'gorgeous on instagram listen to a snippet^taylor swift helped a homeless pregnant fan buy a house^new details regarding ariana grande breakup canceled engagement pete davidson suggest mac miller death^demi lovato reveals that she contemplated suicide at age^alex rodriguez year old daughter sings for jennifer lopez photos^taylor swift teases new song 'gorgeous on instagram listen to a snippet^justin timberlake announces 'the man of the woods tour see the dates^tori kelly is engaged to german basketball player andre murillo^watch harry styles kiss james corden in christmas themed 'carpool karaoke^demi lovato tour include free therapy fans^breaking jennifer hudson joins the voice season^billboard music awards nominations see full list of bbmas nominees^camila cabello announces her 'never be the same tour see the dates^heidi montag and spencer pratt are eecting and it is a baby boy^demi lovato announces tour with dj khaled see the dates,33,17,-16,50,0.66,-0.32,1
26820715,etalkCTV,2486,146021,1055,102263,0,0,36,14,canada entertainment show watch etalk weeknights ctv ctv2,"jenniferaniston justintheroux announced 're separating look back ado^jenniferaniston justintheroux announced 're separating look back ado^jenniferaniston justintheroux announced 're separating look back ado^exclusive royalwedding scoop according sources georgeclooney amp amalclooney taking i^inclusive fashion brand even caught eye^your comprehensive timeline princeharry meghanmarkle relationship gt gt gt etalk^your comprehensive timeline princeharry meghanmarkle relationship gt gt gt etalk^catch princeharry meghanmarkle relationship comprehensive timeline gt gt gt^stars celebrate international women day see posts gt gt gt etalk^the stars celebrate international women day watch here gt gt gt etalk^stars celebrate international women day see posts gt gt gt etalk^the stars celebrate international women day watch here gt gt gt etalk^congrats princeharry amp meghanmarkle happy news^ryanphillippe tweets false abuse accusations gt gt gt etalk^drake calls hijab remark concert 'fake media story gt gt gt etalk^drake calls hijab remark concert 'fake media story gt gt gt etalk^mmva throwback memorable red carpet looks years etalk^taylorswift kicks reputationtour calling social media bullies etalk^katyperry loves certain things taylorswift swears etalk americanidol^katyperry loves certain things taylorswift swears etalk americanidol^bradpitt angelinajolie reach pact keep divorce details private gt gt gt etalk^bradpitt angelinajolie reach pact keep divorce details private gt gt gt etalk^bradpitt angelinajolie reach pact keep divorce details private gt gt gt etalk^kanyewest elains hurt jayz beyonce failed attend kimkardashian wedding.^bradpitt angelinajolie reach pact keep divorce details private gt gt gt etalk^bradpitt angelinajolie reach pact keep divorce details private gt gt gt etalk^bradpitt angelinajolie reach pact keep divorce details private gt gt gt etalk^one naughty bunny easter etalk^one naughty bunny easter etalk mileycyrus^bradpitt wants bitter battle angelinajolie public view etalk^justintheroux jenniferaniston stun leftovers red carpet premiere gt gt gt etalk^justintheroux jenniferaniston stun leftovers red carpet premiere gt gt gt etalk^angelina jolie next phase 'i love directing i much prefer acting^brad pitt spending time fans outside princess wales theatre right etalktiff13^katyperry loves certain things taylorswift swears etalk americanidol^katyperry loves certain things taylorswift swears etalk americanidol^it official returning host oscars gt gt gt etalk^watch tonight girls series finale zosiamamet snotty mess end gt gt gt^matches georgeclooney 500,000 donation towards march our lives etalk^matches georgeclooney 500,000 donation towards march our lives etalk^matches georgeclooney 500,000 donation towards march our lives etalk^see dustin lance black tom daley gorgeous wedding photos gt gt gt^see dustin lance black tom daley gorgeous wedding photos gt gt gt^see dustin lance black tom daley gorgeous wedding photos gt gt gt^anna wintour newly engaged daughter bee shaffer elegant alongside beau francesco carrozzini.^george amal clooney donate 1 million fight hate groups gt gt gt etalk^george amal clooney donate 1 million fight hate groups gt gt gt etalk^george amal clooney donate 1 million fight hate groups gt gt gt etalk^finally the secret revealed announces new album 'reputation single details gt gt gt^prince william amp prince harry share special bond grown stronger since little royals.",36,14,-22,50,0.72,-0.44,1
20182089,WestWingReport,1005,378077,7029,112564,1,48,0,0,paul brandus keynote speaker presidential libraries fortune cos author books usatoday dowjones/marketwatch columnist ex russia nbc pbrandus,"on this day george h.w bush sent ,800 marines somalia part multinational force trying to^state u.s. infrastructure american society civil engineers gives overall grade d+ infrastructure stocks slipped year^the first state union day thomas jefferson mailed setting standard th^in came known monroe doctrine james monroe day told congress state^in ,000 word state union speech mailed congress theodore roosevelt day asked^the first presidential address radio made calvin coolidge day state of^in state union delivered day herbert hoover reassured americans worst re^building monroe doctrine theodore roosevelt made case u.s. military intervention abroad in sta^the tradition delivering state union person goes back woodrow wilson decided that^the first state union day thomas jefferson mailed setting standard th^in came known monroe doctrine james monroe day told congress state^in ,000 word state union speech mailed congress theodore roosevelt day asked^the first presidential address radio made calvin coolidge day state of^in state union delivered day herbert hoover reassured americans worst re^building monroe doctrine theodore roosevelt made case u.s. military intervention abroad in sta^the tradition delivering state union person goes back woodrow wilson decided that^president new afghanistan pakistan strategy n't work blindly stay course meantime major bombing near khyber pass^president awkward spot he 'd love come rose garden brag senate tax bill s^zero tariffs zero subsidies goal president european commission juncker say 're working^vice president to make statement in rose garden in ten minutes^evergreen tweet fill blanks president campaign rally las vegas last night featured numerous f^to warm crowd ahead tonight campaign rally las vegas president trump selected conspiracy theroris^president heads las vegas afternoon 'll hold another campaign rally evening he 'll spend night sin city^congressional approval ratings sunk along w/the president americans disapprove job congress approve^the first presidential address radio made calvin coolidge day state of^on this day andrew jackson said federal government debt free in state union a^on deck robert gibbs final briefing white house press secretary :30^three months reagan said opposed tougher handgun laws nearly assassinated later backed brady bill amp assault weapons ban^three months reagan said opposed tougher handgun laws nearly assassinated later backed brady bill amp assault weapons ban^reagan lifelong nra member later supported brady bill background checks gun buyers assault weapons ban^reagan backed assault weapons ban brady bill background checks amp '86 firearms act eanded gun rights banning^mr. reagan later supported brady bill named press secretary james brady shot head assault weapons ban^in addition supporting assault weapons ban prior tweet president reagan supported brady bill^president amp mrs. reagan changed attitude guns assassination attempt backing brady bill amp assault weapons ban^president reagan lifelong member nra later supported brady bill background checks gun buyers an^sarah brady reminds wwr reagan lifelong nra member backed brady bill background checks amp assault weapons ban^reagan lifelong member nra later supported brady bill background checks gun buyers assault weapons ban^reagan lifelong member nra later supported brady bill background checks gun buyers assault weapons ban^reagan lifelong member nra later supported brady bill background checks gun buyers assault weapons ban^reagan lifelong nra member later supported brady bill background checks gun buyers assault weapons ban^folks skeptical ronald reagan backed cap amp trade backed brady bill amp assault weapons ban call^the handgun used reagan would assassin john hinckley easily bought tennessee pawn shop reagan l^people forget reagan supported assault weapons ban amp brady bill passed no major legislation since^the handgun used hinckley shoot president reagan easily bought tennessee pawn shop reagan later bac^president monday labor day schedule travels cincinnati :15 addresses afl cio picnic returns white house^keep wondering might happened us white house reporters hillary clinton when first l^mini thread sometimes white house reporters think working briefing room sort birthright th^thread you probably hurt ways aware four front trade war^president tonight says ordered u.s. trade officials identify 200 billion worth chinese goods hit w",1,48,47,49,0.020408163265306117,0.9591836734693876,0
42921216,ksdknews,1598,235488,1950,226278,0,5,15,29,we on your side breaking news weather sports on-air online retweets endorsements beon5 tisl,transcript stormy daniels '60 minutes interview^transcript stormy daniels '60 minutes interview^transcript stormy daniels '60 minutes interview^years later war poverty new battle lines ksdk^josh hawley talks pre existing conditions repealing the affordable care act/obamacare working across aisle^kellyanne conway broke ethics rules 'go buy ivanka stuff message watchdogs say^reports brad pitt accused child abuse investigation^kevin hart wife eniko parrish welcome baby boy kenzo^channing tatum wife jenna dewan announce split we 'chosen separate couple^emmy awards the winners list^channing tatum jenna dewan announce separation^channing tatum jenna dewan announce separation^channing tatum jenna dewan announce separation^we ask londoners prince harry meghan markle their responses may surprise^we ask londoners prince harry meghan markle their responses may surprise^we ask londoners prince harry meghan markle their responses may surprise^kevin hart confesses cheating pregnant wife^kevin hart confesses cheating pregnant wife^kevin hart confesses cheating pregnant wife^julie bowen back new minutes^koko gorilla knew sign language dies^'this is us star justin hartley marries chrishell stause^'this is us star justin hartley marries chrishell stause^'this is us star justin hartley marries chrishell stause^star jones marries fianc ricardo lugo cruise ship^meghan trainor engaged 'spy kids star daryl sabara^meghan trainor engaged 'spy kids star daryl sabara^meghan trainor engaged 'spy kids star daryl sabara^'glee alum lea michele engaged boyfriend zandy reich shows huge ring social media^'glee alum lea michele engaged boyfriend zandy reich shows huge ring social media^'glee alum lea michele engaged boyfriend zandy reich shows huge ring social media^walmart remove 'cosmopolitan magazine checkout lines amid me too movement^walmart remove 'cosmopolitan magazine checkout lines amid me too movement^announces stops man woods tour^veep actress julia louis dreyfus diagnosed breast cancer^reports tv host brooke burke files divorce actor david charvet^reports tv host brooke burke files divorce actor david charvet^reports tv host brooke burke files divorce actor david charvet^'nypd blue creator steven bochco dead^'nypd blue creator steven bochco dead^'nypd blue creator steven bochco dead^reports priyanka chopra nick jonas engaged two months dating^reports priyanka chopra nick jonas engaged two months dating^wwe star vader dead age^wwe star vader dead age^leonardo dicaprio star quentin tarantino charles manson movie margot robbie^leonardo dicaprio star quentin tarantino charles manson movie margot robbie^april giraffe pregnant^april giraffe pregnant,15,34,19,49,0.30612244897959184,0.3877551020408163,0
19197110,106KMEL,3284,78135,608,83375,0,0,33,16,the bay for hip-hop r b instagram,karrueche tran granted five year restraining order against chris brown^karrueche tran granted five year restraining order against chris brown^karrueche tran granted five year restraining order against chris brown^american music awards nominations amas nominees full list^celebrities react nelsan ellis dead at^would like removed narrative^jamie foxx katie holmes finally out public as couple^celebrities react trump withdraws steph curry white house invitation^beyonce not demanding silent delivery room despite report^celebrities react to hurricane irma^chris brown slammed by judge for skipping karrueche tran court hearing^katherine jackson resigns as blanket guardian^no drake is n't 'lusting after rihanna despite new rumors^kylie jenner is pregnant with travis scott baby^katie holmes not pregnant and planning wedding with jamie foxx^sorry drake amp bella hadid are not 'secretly dating^kim kardashian slams cocaine claim 'i do not play with rumors like this^celebrity reactions prince harry meghan markle engaged^halle berry not pregnant at despite reports^mariah carey amp french montana did not flirt in recording studio^watch kim kardashian first interview since robbery on 'ellen degeneres show videos^beyonce birth twins still hospital 'minor issue^karrueche tran granted five year restraining order against chris brown^karrueche tran granted five year restraining order against chris brown^karrueche tran granted five year restraining order against chris brown^the weeknd split with selena gomez caused him to scrap an upbeat album^chris brown urges fans to donate to year old boy 'new legs gofundme^celebrities react nfl players kneel lock arms during national anthem^iggy azalea blasts nick young after accidental dinner reunion^kim kardashian slams 'invasive surrogacy reports^obamas celebrate th anniversary after false split stories^mariah carey not dating both nick cannon and bryan tanaka despite report^over weekend keeping up with the kardashians star husband gifted neon green merced^second suspect in xxxtentacion murder arrested justiceforxxx^tisha campbell martin files for divorce from husband duane^tisha campbell martin files for divorce from husband duane^khlo kardashian makes her first public appearance since pregnancy news^madonna files emergency order to stop tupac shakur letter auction^second suspect in xxxtentacion murder arrested justiceforxxx^tamar braxton files divorce from vincent herbert^nelly officially under criminal investigation sexual assault^prince charles will walk meghan markle down the aisle at royal wedding^alex rodriguez year old daughter sings for jennifer lopez photos^star jones ex husband al reynolds comes out as bisexual in candid blog^'black panther is officially the most tweeted about movie of all time^will smith just won ''in my feelings '' challenge and even drake agrees video^will smith just won ''in my feelings '' challenge and even drake agrees video^will smith just won ''in my feelings '' challenge and even drake agrees video^demi lovato announces tour with dj khaled see the dates,33,16,-17,49,0.6734693877551021,-0.3469387755102041,1
177249094,TheTalkCBS,610,536712,2079,64550,0,0,13,35,watch thetalk w/ cbs weekdays pm et pm pt/ct your tweets may appear tv,kate middleton leaves hospital soon giving birth do think women pressure bounce back quic^meghan markle criticized inappropriate shoulder dress queen birthday parade what think a^fresh stirring outrage snl kanye west calls abolish th amendment twitter meanwhile kim ka^released new spanish single el anillo ladies want man put ring but^family feud brody jenner says disappointed parent caitlyn jenner missed wedding his sisters kendall an^billy bush former colleague matt lauer firing there joy demise others. have ever fel^jennifer lopez shoots alex rodriguez engagement rumors do think jlo smart rush marriage^savannah guthrie talks blossoming friendship hoda kotb replaced matt lauer something rea^released new spanish single el anillo ladies want man put ring but^brad pitt feels custody trial w/ angelina jolie irresponsible damaging kids how think pub^khloe kardashian asks family act normal negativity delivery room tristan thompson chea^justin theroux spoke divorce jennifer aniston saying breakup amicable top talker radio^meghan markle dad speaks u.k. good morning britain prince harry missing daughter meghan royal wed^billboard woman year selena gomez elains back w/ justin bieber have ever rekindled o^justin bieber hits paparazzo truck outside church who think fault everybodytalks^justin bieber hits paparazzo truck outside church who think fault everybodytalks^drew barrymore spray painted ex boyfriend car have ever destroyed anyone else property everybodytalks^will smith jada pinkett smith n't call married we refer 'life partners y^adele lifts c line dion spirits amid health issues when sick lifts spirits adele celinedion^tiffany haddish claims drugged actress bit beyonc face. what craziest thing seen someb^lady gaga speaks mental health secrets keep sick i realize actually safer say i f^walmart remove cosmopolitan checkout lines says 'business decision do think checkout lines n^walmart remove cosmopolitan checkout lines says 'business decision do think checkout lines n^barbra streisand tells variety beloved dog samantha cloned what think would ever clone^nick jonas admits mom still laundry it really nice thing her. what something parents^gwyneth paltrow admits involved planning wedding i 'm probably least bridezilla person^the chainsmokers alex pall says miserable amid cheating allegations if someone cheated would w^meghan markle weds prince harry mesmerizing royal wedding ceremony the official wedding portraits revealed wha^wilmer valderrama spotted visiting demi lovato one day singer overdose fans question whether friends w^logan paul taking time reflect following suicide forest video controversy raises uncomfortable questions fo^roseanne star emma kenney enters treatment personal ''battles '' have ever sought help problem everybodytalks^o.j simpson shares hypothetical account nicole brown simpson ron goldman murders do think vid^maria shriver opens oprah winfrey raising kind ambitious children what eectations paren^mandy moore reveals hard knocks divorce gave newfound level confidence has going ha^oprah winfrey enthusiastically demonstrates clean dog poop stains what household chore really get everybodytalks^tyra banks discusses cellulite always hidden also demi lovato showcases cellulite stretch^kylie jenner covers forbes richest self made women issue newsweek says kylie self made according to^demi lovato gets emotional onstage celebrates years sobriety is area life you^zacefron jokes flirting w/ madonna i guess could say tapped did zac efron hook madonna everybodytalks^whitneyhouston 'can i be me documentary trailer shows dark side fame do u think whitney died broke^millie bobby brown denounces bullying quit twitter have ever felt bullied social media^serena williams withdraws australian open first event since giving birth have ever returned som^today everybodytalks topics khloe kardashian happy baby madonna vows keep fighting ageism sexism^madonna vows keep fighting ageism amp sexism it outdated patriarchal idea woman stop being^shawn mendes reacts surprise reel voice cracks stage james corden asks voice cha^gayle king reveals best gift oprah winfrey ever gave was live nanny what best gift ever^demi lovato hospitalized suffering apparent overdose we love demi addiction choice are^hugh grant says gotten married sooner what wish would done sooner everybodytalks,13,35,22,48,0.2708333333333333,0.4583333333333333,0
22632229,BANGShowbiz,3860,7056,128,30663,0,0,40,8,if celebrity story heard first we world best entertainment news agency check website info,kim kardashian west defends elf made kylie jenner kimkardashianwest kyliejenner^kris caitlyn jenner cordial daughters sake krisjenner caitlynjenner kendalljenner kyliejenner^fergie josh duhamel split fergie joshduhamel celebritybreakup^fergie josh duhamel talking baby plans split^duchess meghan mum 'very happy daughter baby news doriaragland duchessmeghan princeharry royalbaby^samantha markle happy meghan pregnancy meghanmarkle royalfamily royalbaby^liam payne feels closer loved ones since cheryl split liampayne cheryl cheryltweedy onedirection^liam payne 'fragile uneected cheryl split liampayne cheryl cheryltweedy onedirection^kim kardashian west 'embarrassed kanye west kimkardashianwest kanyewest^heidi klum mel b heidiklum melb agt americasgottalent^kylie jenner pregnancy brought closer kourtney kardashian^kendall jenner jealous ex kendalljenner^kim kardashian west kanye west argued plaster kimkardashianwest kanyewest kuwtk^kim kardashian west 'cried hysterically discovering caitlyn jenner dressed woman kimkardashianwest^kourtney kardashian pregnant baby number thinks kim may tad jealous^khloe kardashian cutting family tristan thompson confusion khloekardashian tristanthompson^the weeknd scrapped album selena gomez split theweeknd selenagomez^kris caitlyn jenner cordial daughters sake krisjenner caitlynjenner kendalljenner kyliejenner^justin bieber sanctioned judge justinbieber^nicole kidman embraced tough water scenes nicolekidman aquaman nopainnogain^kanye west advised date kim kardashian west kanyewest kimkardashianwest kimkardashian kkw kuwtk^kylie jenner daughter received 'nasty comments online kyliejenner stormiwebster^emma stone 'ca n't imagine life without ryan gosling emmastone ryangosling bff friendshipgoals lalaland^ben affleck looking family friendly role benaffleck familyfriendly ratedu^ben affleck looking family friendly role benaffleck familyfriendly^kim kardashian west admits sisters fight whilst watching show kimkardashianwest kourtneykardashian^kendall jenner got sauna siblings kendalljenner kardashians khloekardashian kimkardashianwest^khloe kardashian found watching tristan cheating episode 'uncomfortable khloekardashian tristanthompson^khloe kardashian heartfelt birthday tribute kris jenner khloekardashian krisjenner truethompson kuwtk^kim kardashian west n't think tristan thompson change kimkardashianwest tristanthompson^kim kourtney kardashian wore matching outfits ister date kimkardashianwest kourtneykardashian^kendall jenner got sauna siblings kendalljenner kardashians khloekardashian kimkardashianwest^kim kardashian west kanye west argued plaster kimkardashianwest kanyewest kuwtk^jennifer lawrence boozy night kris jenner jenniferlawrence krisjenner kuwtk^justin theroux stayed guest house splitting jennifer aniston divorce justintheroux jenniferaniston^sir billy connolly 'no longer recognises close friends billyconnolly^duchess meghan fun planning wedding prince charles duchessmeghan meghanmarkle princeharry^duke duchess sussex open wedding^jennifer lopez misses alex rodriguez day apart jenniferlopez alexrodriguez^are kourtney kardashian scott disick back together^anna faris files response divorce papers annafaris chrispratt^jada pinkett smith will smith n't call married jadapinkettsmith willsmith^rita ora kisses cardi b girls music video ritaora cardib charlixcx beberexha girls^hugh hefner cause death revealed ... hughhefner riphef riphughhefner^exclusive behind scenes secrets mamma mia here we go again mammamia2 herewegoagain behindthescenes^taylor swift announces new album newalbum music reputation taylorswiftreputation^she 's fine people jennifer aniston fine since justin theroux split jenniferaniston justintheroux split^harvey weinstein georgina chapman reach divorce settlement harveyweinstein georginachapman weinsteinscandal,40,8,-32,48,0.8333333333333334,-0.6666666666666666,1
86141342,ABCWorldNews,457,1363311,10609,154367,2,34,4,7,the official twitter account world news tonight,more federal complaint alleges suspect posted statement facebook page morning o^nyc bombing suspect wrote facebook alleged attack 'trump failed protect nation complai^sen. flake praises pompeo response possibility allowing kremlin question us officials that statement^pelosi says gop efforts impeach rosenstein make statement pres trump law the attack o^first lady feud first lady melania trump issued statement spokesperson publicly pushing remo^new pres trump joint statement european commission pres jean claude juncker we agree today first of^officials investigating cases possible acute flaccid myelitis afm condition polio like sym^abortions lowest rate since landmark case roe v. wade legalized woman right abortion in^the centers disease control prevention alerting public asian longhorned tick species of^officials investigating cases possible acute flaccid myelitis afm condition polio like sym^confronting putin pres dismissing calls democrats cancel high stakes summit w^stormy daniels attorney calls giuliani interview absolute unmitigat^synagogue massacre this truly horrific scene abc news reports pittsburgh the^new there number key inconsistencies story 're given says saudi a^new jpmorgan chase ceo jamie dimon tells understands still lot anger^new first lady melania trump plans visit another center housing migrants point week spokesperson^new republican national committee selects charlotte north carolina host convention we look forward s^fact checking president donald trump address joint session congress^president trump s pivot president trump held celebration america event white house disinviting^senate majority leader mitch mcconnell issues statement executive order signed pres trump i glad pr^pres trump hugged american flag conclusion remarks national federation independent busi^officials investigating cases possible acute flaccid myelitis afm condition polio like sym^abortions lowest rate since landmark case roe v. wade legalized woman right abortion in^the centers disease control prevention alerting public asian longhorned tick species of^officials investigating cases possible acute flaccid myelitis afm condition polio like sym^people evacuate hospital chicago police say multiple victims including police officer inj^latest chicago fire department spokesman says suspect hospital shooting dead three victims including a^alert news special report vice president biden makes statement rose garden^just in vice president biden deliver statement rose garden :10 pm est^in his own words amid outpouring support late john mccain family ma^while delivering keynote speech touting republican tax cuts cincinnati ohio vice president mike pence sa^one turkeys hoping pardon pres trump later today made appearance white house press bri^pardon a possibility trump says n't ruled pardon paul manafort manafort lawyer briefin^transcript former trump attorney michael cohen speaks one one exclusively^best friends one little boy savage minnesota new four legged best friend capturing hearts of^murdered family arrests four people facing murder charges killing eight family members case^royal wedding drama meghan markle mother met royal family kensington palace announced meghan father^katie couric breaks silence longtime former 'today co host matt lauer sexual misconduct alleg^trump administration politicians celebrities react sean spicer resignation^meghan markle father breaking silence daughter marriage prince harry missing roy^royal wedding drama meghan markle mother met royal family kensington palace announced meghan father^new supreme court declines hear appeal brendan dassey whose murder conviction subject netfli^geraldo rivera apologizes bette midler alleged groping incident^nina simone bon jovi moody blues among rock amp roll hall fame inductees^royal wedding prince harry arrives st. george chapel prince william brother best man ahead of^all details prince harry meghan markle wedding rings^'here go april giraffe whose last birth drew millions livestreaming followers pregnant again,6,41,35,47,0.1276595744680851,0.7446808510638298,0
16028382,WESH,342,208848,1946,362823,2,4,11,30,central florida local live late breaking news source,"melania trump undergoes kidney surgery walter reed medical center^people found dead ohio^most popular baby names every u.s. state^most popular baby names every u.s. state^george w. bush we 'll find him in interview larry king former president george w. bush says ...^us slaps 50 billion tariffs chinese goods escalating trade dispute^what roseanne barr net worth^megyn kelly weighs matt lauer fired 'today show^megyn kelly weighs matt lauer fired 'today show^david cassidy fighting memory loss wants 'enjoy life^icymi david cassidy fighting memory loss wants 'enjoy life^david cassidy fighting memory loss wants 'enjoy life^is kim kardashian pursuing music career^george clooney makes 27,283 every hour thanks tequila^mariah carey new year eve performance 'they foiled^caitlyn jenner latest celebrity float run office^brad pitt plans to quit acting in years actor brad pitt says plans stop acting three years ...^koko gorilla knew sign language dies^koko gorilla knew sign language dies^james franco event canceled actor denies allegations sexual misconduct^playboy founder hugh hefner cause death revealed^playboy founder hugh hefner cause death revealed^playboy founder hugh hefner cause death revealed^playboy founder hugh hefner cause death revealed^mindy kaling reportedly pregnant first child^mindy kaling reportedly pregnant first child^mindy kaling reportedly pregnant first child^'clueless actress stacey dash running congress california^'clueless actress stacey dash running congress california^'clueless actress stacey dash running congress california^'clueless actress stacey dash running congress california^kaley cuoco marries karl cook intimate horse ranch wedding^kaley cuoco marries karl cook intimate horse ranch wedding^kaley cuoco marries karl cook intimate horse ranch wedding^kaley cuoco marries karl cook intimate horse ranch wedding^discovery channel 'storm chasers star joel taylor dead^discovery channel 'storm chasers star joel taylor dead^discovery channel 'storm chasers star joel taylor dead^discovery channel 'storm chasers star joel taylor dead^billboard music awards check complete list winners^everything need know 'this is us season^everything need know 'this is us season^everything need know 'this is us season^billboard music awards check complete list winners^netflix is reportedly reviving carmen sandiego with gina rodriguez^reese witherspoon confirms 'legally blonde happening^april giraffe pregnant",13,34,21,47,0.2765957446808511,0.44680851063829785,0
15922073,WXII,1239,123824,950,332183,3,5,12,27,the triad news keeping community connected for breaking news download wxii news app wxii triad,"melania trump undergoes kidney surgery walter reed medical center^people found dead ohio^people found dead ohio^most popular baby names every u.s. state^most popular baby names every u.s. state^most popular baby names every u.s. state^most popular baby names every u.s. state^us slaps 50 billion tariffs chinese goods escalating trade dispute^what roseanne barr net worth^what roseanne barr net worth^what roseanne barr net worth^megyn kelly weighs matt lauer fired 'today show^megyn kelly weighs matt lauer fired 'today show^icymi david cassidy fighting memory loss wants 'enjoy life^david cassidy fighting memory loss wants 'enjoy life^david cassidy fighting memory loss wants 'enjoy life^george clooney makes 27,283 every hour thanks tequila^mariah carey new year eve performance 'they foiled^'free speech rally 'fight supremacy groups set converge boston common^caitlyn jenner latest celebrity float run office^james franco event canceled actor denies allegations sexual misconduct^playboy founder hugh hefner cause death revealed^playboy founder hugh hefner cause death revealed^playboy found hugh hefner cause death revealed^mindy kaling reportedly pregnant first child^mindy kaling reportedly pregnant first child^mindy kaling reportedly pregnant first child^'clueless actress stacey dash running congress california^'clueless actress stacey dash running congress california^'clueless actress stacey dash running congress california^'clueless actress stacey dash running congress california^kaley cuoco marries karl cook intimate horse ranch wedding^kaley cuoco marries karl cook intimate horse ranch wedding^kaley cuoco marries karl cook intimate horse ranch wedding^kaley cuoco marries karl cook intimate horse ranch wedding^discovery channel 'storm chasers star joel taylor dead^discovery channel 'storm chasers star joel taylor dead^discovery channel 'storm chasers star joel taylor dead^discovery channel 'storm chasers star joel taylor dead^billboard music awards check complete list winners^everything need know 'this is us season^billboard music awards check complete list winners^netflix is reportedly reviving carmen sandiego with gina rodriguez^reese witherspoon confirms 'legally blonde happening^april giraffe pregnant^april giraffe pregnant^april giraffe pregnant",15,32,17,47,0.3191489361702128,0.3617021276595745,0
1020058453,BuzzFeedNews,4785,1334418,12798,171698,3,17,15,12,sign daily newsletter free,the justice served act passed us house representatives would mandate money used^trump failed protect nation man accused yesterday nyc subway bombing wrote facebook befo^trump failed protect nation accused nyc subway bomber wrote facebook attack offic^criminal inquiry sought hillary clinton use email reports^full transcript of interview with president barack obama^after rudy giuliani second interview buzzfeed news hours clear trump new outs^rudy giuliani says decision made whether trump sit interview robert mueller unt^the ceo top progressive digital firm helped lead bernie sanders presidential campaign stepping^the progressive firm rose fame raising millions bernie sanders presidential campaign cr^the founder revolution messaging digital firm behind bernie sanders presidential campaign departi^the us department education eected unveil new title ix regulations colleges handle sexual^the us department education proposed rule would prevent people knowing religious colleges^candice jackson appointed acting head us department education office civil rights l^candice jackson appointed acting head us department education office civil rights l^a report hofstra university campus first presidential debate take place tonight^these victims chicago hospital shooting tamara o neal er doctor samuel jimenez c^the nypd laid first administrative charges one officers involved death eric garner^a cop involved eric garner death facing first disciplinary charges years later^the new york police department laid first administrative charges one officers involved th^officer daniel pantaleo filmed july using chokehold subdue garner stopped selling^these random couples gave birth time kate middleton walked straight paparazzi leaving h^comedian hannibal buress arrested disorderly intoxication attending art basel miami t^katie couric says still separating truth fiction allegations sexual harassment f^more month matt lauer suddenly dramatically fired today show sexual harassme^netflix revealed new faces appear the crown season including play prince charles qu^people trolling ivanka trump why i disagree with my dad cover story us weekly^icymi new royal baby way prince harry meghan markle eecting am2dm^brad pitt said committed fixing homes foundation built new orleans wake hurricane ka^brad pitt said committed fixing homes foundation built new orleans hurricane katrina aft^angelina jolie alleges estranged husband brad pitt n't paying meaningful child support t^do n't pretend n't hear gwen stefani voice every time say word bananas am2dm^do n't pretend n't hear gwen stefani voice every time say word bananas am2dm^meghan markle dad given first tv interview since missing royal wedding said prince harry to^taylor swift long awaited political commentary relieved fans polarized others^taylor swift fans relieved longer need defend far right conspiracies nazis claiming^a third suspect charged robbery murder shooting death rapper xxxtentacion arrested g^the fourth suspect charged robbery murder shooting death rapper xxxtentacion arrested i^prince charles walk meghan markle aisle saturday royal wedding father pulled^prince charles walk meghan markle aisle saturday royal wedding father pulled^former mtv vj jesse camp reported missing california members family unable make contact^simone biles says sexually abused former usa gymnastics doctor larry nassar over women made si^breaking a judge granted blac chyna request temporary restraining order rob kardashian^octavia spencer teared telling story jessica chastain fought get equal pay^game thrones stars rose leslie kit harington officially married^kanye west writing philosophy book twitter^with million tweets black panther officially tweeted movie time^the weinstein company set file bankruptcy last ditch negotiations sell company assets fell,18,29,11,47,0.3829787234042553,0.23404255319148934,0
219682445,hellogiggles,8701,166810,2203,117311,0,0,21,26,we friends,gabrielle union wants know nothing tristan thompson cheating khlo^busy philipps attempting dance like lindsay lohan gift never knew needed^posted cutest throwback photo husband baby bump^you probably missed tear jerker detail photos prince william kate middleton leaving hospital^whether got married weekend happy^people believe george clooney going run president^ready talk matt lauer firing today show say^broke silence matt lauer firing today^what margot robbie net worth hint it make pass^going play boyfriend new rom com this^hailee steinfeld cleared rumors dating justin bieber^cleared rumors dating^posted cutest throwback photo husband baby bump^twitter *begging* jennifer aniston brad pitt get back together^meghan markle nephew creating markle sparkle strain weed royal wedding^misses old hair asks us go back brown^reveals original boyfriend calvin harris lyric wrote gorgeous^emma stone says imagine life without ryan gosling^jennifer aniston justin theroux look like sexy spy couple the leftovers premiere^um eleven apparently supposed die things season^celebrity feuds oprah cent^meghan markle getting wax figure madame tussauds^prince harry left empty seat princess diana royal wedding ugly crying^friendly reminder stranger things still *officially* renewed season^laura prepon ben foster married gorgeous insta pic prove^anthony weiner sentenced months prison sexting minor^lea michele engaged zandy reich carat diamond ring blindingly beautiful^meet ines rau first transgender playmate^the ocean eleven trilogy coming netflix prayers finally answered^rachel mcadams pregnant first child know 'll cool mom regular mom^rachelmcadams pregnant first child know cool mom regular mom^pregnant first child great start^modern family julie bowen husband scott phillips separate years marriage^meghan markle confirmed dad attend royal wedding hearts^meghan markle dad reportedly attend royal wedding revealed staged photos^the first game thrones prequel series officially happening *female* writer^the narwhal frappuccino thing tastes like pink starburst^lily james takes us donna whirlwind romances bill harry sam exclusive behind scene^kim kardashian son saint west hospitalized pneumonia^the big bang theory jim parsons opened waited long get married^priyanka chopra nick jonas reportedly engaged everything know^justin theroux posted social media first time since split jennifer aniston involved pup^kirsten dunst ready mom saying it time babies chill^riverdale talk us prom dresses skin care tips steal e^says squad like friend specific allergies^lorde says taylor swift squad like friend specific allergies^april giraffe pregnant internet collectively said oof,21,26,5,47,0.44680851063829785,0.10638297872340426,0
2467791,washingtonpost,1643,14195105,91117,331854,4,16,22,5,breaking news analysis opinion founded our staff twitter,"george h.w bush got hear eulogy died his reaction priceless^george h.w bush got hear eulogy died his reaction priceless^a fake photo emma gonz lez went viral far right parkland teens villains^a fake photo emma gonz lez went viral far right parkland teens villains^transcript the post univision democratic debate annotated^the brooklyn democratic debate transcript annotated^analysis rudy giuliani revealing interview sean hannity annotated^the full transcript mike pence vs. tim kaine vice presidential debate^donald trump featured new jihadist recruitment video^donald trump featured new jihadist recruitment video^a russian firm spent 100,000 facebook ads trump spent 0 tv ads first days campaign^a russian firm spent 100,000 facebook ads trump spent 0 tv ads first days campaign^the brooklyn democratic debate transcript annotated^obama campaign going first radio ad targeting african americans^in interviews the washington post john mccain colleagues reflect long career service cou^in interviews the washington post john mccain colleagues reflect long career service cou^everything need know drone debate one faq^everything need know drone debate one faq^senators demand cia briefing khashoggi admonish white house ahead key saudi vote^fact checking clinton campaign claim trump would force schools allow guns classrooms^go buy ivanka stuff kellyanne conway said then first daughter fashion sales eloded^go buy ivanka stuff kellyanne conway said then first daughter fashion sales eloded^go buy ivanka stuff kellyanne conway said then first daughter fashion sales eloded^go buy ivanka stuff kellyanne conway said then first daughter fashion sales eloded^in final speech emotional michelle obama tells young people afraid^kylie jenner mystery pregnancy might confusing kardashian situation ever^meghan markle prince harry wedding drama faq all gossip really want know^meghan markle prince harry wedding drama faq all gossip really want know^for years george clooney claimed want kids now twins^bachelor chris soules arrested deadly crash killed iowa farmer^keeping kardashian pregnancy rumors a timeline^keeping kardashian pregnancy rumors a timeline^meghan markle prince harry wedding drama faq all gossip really want know^kylie jenner mystery pregnancy might confusing kardashian situation ever^nicole kidman trump we country need support whoever president^inside melania trump complicated white house life separate schedule different priorities^national enquirer claimed richard simmons transgender now suing^they foiled mariah carey weighs disastrous new year eve performance^they foiled mariah carey weighs disastrous new year eve performance^jennifer lawrence first nude scene since hacked photo leak from terrified empowered^analysis do need know much ben affleck^when prince harry meghan markle married one royal missing forgotten harry mother^ryan seacrest kelly ripa new live co host how much seacrest life^tony awards full list winners^bristol palin joins cast mtv teen mom og ten years pregnancy tripp^tavis smiley sues pbs firing sexual misconduct allegations^billboard music awards top moments drake celine dion complete list winners",26,21,-5,47,0.5531914893617021,-0.10638297872340426,1
20699981,1035KISSFM,1012,85364,716,62167,0,0,30,17,chicago hit music station mornings,reese witherspoon spills first details about 'legally blonde^john mayer has been hospitalized emergency appendectomy^report kim kardashian is having 'divorce docs drawn up is 'miserable with kanye west^chris pratt files divorce from anna faris^jamie foxx katie holmes finally out public as couple^celebrities react trump withdraws steph curry white house invitation^beyonce not demanding silent delivery room despite report^are selena gomez amp the weeknd working on a movie together^stars celebrate rosh hashanah see celebrity tweets about jewish new year^selena gomez vogue cover story see interview highlights^kendall jenner jealous ex^celebrities react to hurricane irma^kanye west concerts on hold indefinitely^lady gaga taylor kinney not secretly dating despite late and wrong report^mariah carey amp french montana did not flirt in recording studio^hailee steinfeld responds to justin bieber dating rumors^nope justin bieber is not dating hailee steinfeld^beyonce birth twins still hospital 'minor issue^is liam hemsworth mad at miley cyrus for texting nick jonas^justin bieber fan arrested trespassing at singer beverly hills home^is demi lovato upset about meghan trainor performing the 'smurfs movie song^justin bieber did not attend vanity fair oscars after party^are mariah carey amp joe jonas feuding^flo rida not performing at donald trump inauguration despite report^chris brown urges fans to donate to year old boy 'new legs gofundme^iggy azalea blasts nick young after accidental dinner reunion^kanye west is not rebooting 'american idol^kim kardashian slams 'invasive surrogacy reports^fans react u2 cancels st. louis concert amid police protests^mariah carey not dating both nick cannon and bryan tanaka despite report^harry styles announces intimate world tour see the dates^taylor swift teases new song 'gorgeous on instagram listen to a snippet^rachel mcadams is reportedly pregnant with her first child^hugh hefner cause death revealed^alex rodriguez year old daughter sings for jennifer lopez photos^taylor swift teases new song 'gorgeous on instagram listen to a snippet^jenny slate and chris evans break up again^justin timberlake announces 'the man of the woods tour see the dates^here what hocus pocus thackery binx looks like now^star jones ex husband al reynolds comes out as bisexual in candid blog^tori kelly is engaged to german basketball player andre murillo^'storm chasers star joel taylor dead at^meghan markle approves of priyanka chopra nick jonas engagement^billboard music awards nominations see full list of bbmas nominees^gigi hadid slams body shamers for calling her 'too skinny at nyfw^'black panther is officially the most tweeted about movie of all time^chris pratt files divorce from anna faris,30,17,-13,47,0.6382978723404256,-0.2765957446808511,1
846864187015888896,TheBlastNews,699,10625,144,16961,0,0,30,17,the new destination breaking news world celebrity entertainment first accurate always bringing real story,justintheroux war neighbor apartment wife jenniferaniston renovating^exes jennifer lawrence darren aronofsky reunited friends recent split^exes jennifer lawrence darren aronofsky reunited friends recent split^jessica simpson spotted showing growing baby bump nyc^justin bieber seen arriving church looking visibly upset hours news broke selena gomez checked int^justin bieber arrived church looking visibly upset hours news broke selena gomez checked m^kim kardashian says kanye west gave 1 million promoting brand social media^photos former today host matt lauer spotted participating paddle pink charity event^former today host matt lauer spotted participating paddle pink charity event^katie couric calls sexual misconduct allegations matt lauer 'disturbing 'distressing first^the woman responsible making sure kylie jenner khlo kardashian healthy pregnancy del^jessica simpson spotted showing growing baby bump nyc^a fan arrested trespassing house st time^caitlyn jenner missing brody jenner wedding weekend made time hang kim kardashian look ali^kourtney kardashian letting recent breakup get^exclusive beverly hills pd currently investigating multiple shots fired tekashi kanye west music video pro^angelina jolie took hike kids amid custody battle brad pitt^just thought jamie foxx katie holmes ready go public love foxx made very cle^no jennifer lopez not secretly wed get engaged alex rodriguez^oprah bff gayle king says stedman misunderstood question asked running president.^exclusive angelina jolie looking embarrass punish brad pitt custody battle^exclusive angelina jolie blood custody battle told wants embarrass punis^angelina jolie took hike kids amid custody battle brad pitt^angelina jolie looking embarrass punish brad pitt custody battle^exclusive brad pitt thinks angelina jolie harming children making child support battle public^exclusive brad pitt believes angelina jolie harming children making child support battle public^exclusive modern family star julie bowen ex husband reached settlement divorce^exclusive modern family star julie bowen ex husband scott phillips reached settlement their^exclusive modern family star julie bowen estranged husband settled divorce^exclusive modern family star julie bowen estranged husband scott phillips settled divorce^surprise laura prepon ben foster married^being woman woman meet ines rau first transgender playmate^host alex trebek recovering surgery remove blood clots brain^breaking news another suspect arrested murder xxxtentacion^farrah abraham arrested allegedly getting fight beverly hills hotel^ya girl hosting movie amp tv awards mtvawards get details^police made contact former mtv vj jesse camp hours reported missing^exclusive former mtv vj jesse camp found family reported missing^exes jennifer lawrence darren aronofsky reunited friends recent split^exes jennifer lawrence darren aronofsky reunited friends recent split^do i need british accent jokes upcoming interview prince harry^katharine mcphee david foster engaged^katharine mcphee david foster engaged^photos jennifer aniston made first red carpet appearance since split justin theroux back february^photos jennifer aniston made first red carpet appearance since split justin theroux back february^jennifer aniston seen first time since announcing split justin theroux^the weinstein company announced file bankruptcy talks sell company fall apart,30,17,-13,47,0.6382978723404256,-0.2765957446808511,1
19955482,Z100NewYork,847,390374,2588,103668,0,0,32,15,a-10a a-2p p-6p p-10p p-2a rome a-5a,kimkardashian reveals names chicagowest kanye considering^kimkardashian reveals names chicagowest kanye considering^kimkardashian reveals names chicagowest kanye considering^kimkardashian reveals names chicagowest kanye considering^kimkardashian reveals names chicagowest kanye considering^us labordayweekend^here liamhemsworth latest prank mileycyrus^here liamhemsworth latest prank mileycyrus^here liamhemsworth latest prank mileycyrus^here liamhemsworth latest prank mileycyrus^here liamhemsworth latest prank mileycyrus^here liamhemsworth latest prank mileycyrus^here liamhemsworth latest prank mileycyrus^here liamhemsworth latest prank mileycyrus^johnkrasinski ca n't stop gushing wife emilyblunt amp daughters^justinbieber ex selenagomez despite married haileybaldwin ...^justinbieber ex selenagomez despite married haileybaldwin ...^justinbieber ex selenagomez despite married haileybaldwin ...^haileesteinfeld addressed justinbieber dating rumors beliebers 'll want watch^haileesteinfeld addressed justinbieber dating rumors beliebers 'll want watch^haileesteinfeld addressed justinbieber dating rumors beliebers 'll want watch^lisakudrow reveals backstage friends secret^lisakudrow reveals backstage friends secret^lisakudrow reveals backstage friends secret^kimkardashian reveals kanye yandhi release date^kimkardashian reveals kanye yandhi release date^gives birth baby boy^my loves tell dreams what inspires i 'm nowblasting x^report jessica simpson pregnant trending via^back spotlight stormi check first pictures post pregnancy^back spotlight stormi check first pictures post pregnancy^back spotlight stormi check first pictures post pregnancy^heatherlocklear arrested battery attacking cop emt^rachel mcadams reportedly pregnant first childhttps //^rachel mcadams reportedly pregnant first childhttps //^rachel mcadams reportedly pregnant first childhttps //^demilovato reveals contemplated suicide age^demilovato reveals contemplated suicide age^kermitthefrog getting new voice years^kermitthefrog getting new voice years^kermitthefrog getting new voice years^netflix released new details upcoming reasonswhy season everything know^netflix released new details upcoming reasonswhy season everything know^netflix released new details upcoming reasonswhy season everything know^slams body shamers calling too skinny nyfw^slams body shamers calling too skinny nyfw^slams body shamers calling too skinny nyfw,32,15,-17,47,0.6808510638297872,-0.3617021276595745,1
69864648,OloriSupergal,7297,148473,559,425252,0,2,15,29,digital media strategist content creator influencermarketing ent lifestyle page hello.com +234 rts endorsement,mr. kay tells us god can bless anybody in new video featuring idahams do believe statement look list ...^mr. kay tells us god can bless anybody in new video featuring idahams do believe statement look list ...^duke and duchess of cambridge welcome baby boy the duke duchess cambridge welcomed third child s^its beyonce s birthday famous american singer performer actress beyonc knowles^its beyonce s birthday famous american singer performer actress beyonc knowles carter year older toda^kylie jenner reportedly pregnant travis scott baby^channing tatum and jenna dewan tatum announce separation celebrity couple actor channing^channing tatum and jenna dewan tatum announce separation celebrity couple actor channing tatum jenna dewan ta^channing tatum and jenna dewan tatum announce separation^terry crews speaks sexual assault eerience actor terry crews finally spoken sexual assault^kim kardashian kanye west plans baby no seven month welcoming daughter chicago celebrity co^new post jennifer lopez reveals met boyfriend alex rodriguez the ellen degeneres show video^new post miley cyrus regrets getting naked in wrecking ball music video miley cyrus initially embraced her^miley cyrus regrets getting naked in wrecking ball music video^hollywood actor brad pitt gives details of money spent ex angelina jolie kids following claims fai^hollywood actor brad pitt gives details of money spent ex angelina jolie kids following claims fai^taylor swift jake gyllenhaal are dating again^beyonce makes her first official appearance since giving birth rihanna diamond ball^american musician ed sheeran buys houses at once talented american musician ed sheeran started n^jamie foxx set to host bet awards popular academy award winning actor comedian jamie foxx set host^it boy jordin sparks reveals baby gender singer jordin sparks revealed gender baby ex^bill cosby finally found guilty of sexual assault in retrial renowned us comedian bill^bill cosby finally found guilty of sexual assault in retrial renowned us comedian bill cosby may spending^bill cosby finally found guilty of sexual assault in retrial^xxxtentacion murder third suspect arrested by us marshals out four suspects relation rapper xxxte^xxxtentacion murder third suspect arrested by us marshals out four suspects in^mtv reality star clay adler dead^new post mtv reality star clay adler dead reality tv star actor clay adler dead committing^legendary comedian don rickles dies at^new post legendary comedian don rickles dies at american stand comedian actor don rickles died^cardi b beyouce jay z leads nomination mtv video awards cardi b beyonce jay z lead nominees for^black ish star tracee ellis ross host american music awards^black ish star tracee ellis ross host american music awards tracee ellis ross announced h^queen elizabeth ii visits victims manchester arena attack hospital^new post queen elizabeth ii visits victims manchester arena attack hospital queen elizabeth ii is^meghan markle prince harry s fianc e deletes social media accounts meghan markle reportedly deleted faceb^meghan markle prince harry 's fianc e deletes social media accounts meghan markle reportedly deleted her^olympic swimmer ryan lochte receives month suspension for anti doping violation^olympic swimmer ryan lochte receives month suspension for anti doping violation the united states anti doping^olympic swimmer ryan lochte receives month suspension for anti doping violation the^avengers infinity war had the biggest opening weekend box office of all time new marvel super hero movie avenger^new post khloe kardashian ready say yes tristan thompson kids khloe kardashian feels like^khloe kardashian ready say yes tristan thompson kids^beyonce eminem and the weeknd rumored to headline coachella festival in california coachella festiva^new post celebrity couple jennifer garner and ben affleck officially file for divorce hollywood couple ben^celebrity couple jennifer garner and ben affleck officially file for divorce,15,31,16,46,0.32608695652173914,0.3478260869565217,0
21428385,Star1013,1372,7134,178,52339,0,1,16,29,more music more variety home morning show // 00.1013,most popular baby names state gt gt lt lt can guess ca popular baby name^is alex rodriguez already cheating on jennifer lopez^john mayer has been hospitalized emergency appendectomy^american music awards nominations amas nominees full list^chris pratt files divorce from anna faris^ed sheeran break friendship code taylor swift despite ridiculous report katy perry^ed sheeran break friendship code taylor swift despite ridiculous report katy perry^melissa mccarthy on why she 'roots for online trolls^did jennifer lopez like a comment dissing mariah carey^beyonce birth twins still hospital 'minor issue^justin bieber fan arrested trespassing for third time^chris martin and dakota johnson are totally dating^is demi lovato upset about meghan trainor performing the 'smurfs movie song^meghan markle twins with kate middleton during outing with queen^justin bieber not attend vanity fair oscars party ...^fans react u2 cancels st. louis concert amid police protests^selena gomez reveals she had a kidney transplant amp her friend was her donor^answers vogue questions^photo enrique iglesias anna kournikova welcome newborn twins^jennifer morrison is leaving 'once upon a time after season^harry styles announces his world tour dates^pink covers people beautiful issue with her two kids^ed sheeran is engaged longtime girlfriend cherry seaborn^ed sheeran is engaged longtime girlfriend cherry seaborn^million dollar listing fredrik eklund derek welcome twins^bachelor nick viall vanessa grimaldi split end engagement^rachel mcadams is reportedly pregnant with her first child^alex rodriguez year old daughter sings for jennifer lopez photos^ashley tisdale and lucas grabeel reunite to perform high school musical classic^here what hocus pocus thackery binx looks like now^the narwhal frappuccino is here it tastes like pink starburst^kim kardashian shares first photo baby chicago west^bachelorette peter kraus reveals he suffered eating disorder^watch harry styles kiss james corden in christmas themed 'carpool karaoke^britney spears announces final piece of me shows in las vegas^jennifer lawrence darren aronofsky split^snow white parody film under fire for body shaming^snow white parody film under fire for body shaming^bryan cranston does an impression of kevin hart freaking out^bryan cranston does an impression of kevin hart freaking out^james corden parodies 'a quiet place^josh gad ca n't stop talking like olaf from frozen^announces new album 'reputation see the cover art^camila cabello announces her 'never be the same tour see the dates^khloe kardashian kylie jenner joke about having 'so many babies^chris pratt files divorce from anna faris,16,30,14,46,0.3478260869565217,0.3043478260869565,0
27844479,BritishVogue,995,3609100,13112,326764,0,0,30,16,the official twitter page download latest issue subscribe,according selena gomez kendall jenner definitely single^according selena gomez kendall jenner definitely single^according selena gomez kendall jenner definitely single^according selena gomez kendall jenner definitely single^according selena gomez kendall jenner definitely single^according selena gomez kendall jenner definitely single^according selena gomez kendall jenner definitely single^everyone mick jagger duchess cambridge parties basil bar^everyone mick jagger duchess cambridge parties basil bar^everyone mick jagger duchess cambridge parties basil bar^the story behind epic wardrobe^the story behind epic wardrobe^amal george clooney welcome twins^amal george clooney welcome twins^amal george clooney welcome twins^amal george clooney welcome twins^amal george clooney welcome twins^angelina jolie i enjoy single^angelina jolie i enjoy single^angelina jolie i enjoy single^angelina jolie i enjoy single^who play role princess diana next series the crown^it difficult months angelina jolie breaks silence split brad pitt^it difficult months angelina jolie breaks silence split brad pitt^it difficult months angelina jolie breaks silence split brad pitt^it difficult months angelina jolie breaks silence split brad pitt^browse emma stone hair style file^normally would privately given gossip industry resist opportunity speculate^normally would privately given gossip industry resist opportunity speculate^marion cotillard addresses rumours involved breakdown brad pitt angelina jolie marriage^as prince harry meghan markle forthcoming nuptials confirmed read everything need know abou^ahead golden globes tonight look back best dresses time awards^as announces new album reputation read modern day media maverick^as announces new album reputation read modern day media maverick^as announces new album reputation read modern day media maverick^as announces new album reputation read modern day media maverick^as announces new album reputation read modern day media maverick^as announces new album reputation read modern day media maverick^as announces new album reputation read modern day media maverick^as announces new album reputation read modern day media maverick^as announces new album reputation read modern day media maverick^as announces new album reputation read modern day media maverick^as announces new album reputation read modern day media maverick^as announces new album reputation read modern day media maverick^as announces new album reputation read modern day media maverick^it time babies chill kirsten dunst parenthood,30,16,-14,46,0.6521739130434783,-0.3043478260869565,1
14662569,WMUR9,395,129216,1443,321620,1,4,16,24,news weather sports updates wmur news,"melania trump undergoes kidney surgery walter reed medical center^aka 'chach responds key line tv ad let make america america flags hi^clinton office hostage taker sues hospital the man took hostages one sen. hillary rodham clin..^most popular baby names every u.s. state^us slaps 50 billion tariffs chinese goods escalating trade dispute^what roseanne barr net worth^what roseanne barr net worth^what roseanne barr net worth^megyn kelly weighs matt lauer fired 'today show^megyn kelly weighs matt lauer fired 'today show^david cassidy fighting memory loss wants 'enjoy life^icymi david cassidy fighting memory loss wants 'enjoy life^david cassidy fighting memory loss wants 'enjoy life^tonya harding made 'dancing with stars finale fans livid^tonya harding made 'dancing with stars finale fans livid^tonya harding made 'dancing with stars finale fans livid^tonya harding made 'dancing with stars finale fans livid^george clooney makes 27,283 every hour thanks tequila^mariah carey new year eve performance 'they foiled^'free speech rally 'fight supremacy groups set converge boston common^caitlyn jenner latest celebrity float run office^koko gorilla knew sign language dies^koko gorilla knew sign language dies^james franco event canceled actor denies allegations sexual misconduct^playboy founder hugh hefner cause death revealed^playboy founder hugh hefner cause death revealed^playboy founder hugh hefner cause death revealed^playboy founder hugh hefner cause death revealed^mindy kaling reportedly pregnant first child^mindy kaling reportedly pregnant first child^mindy kaling reportedly pregnant first child^'clueless actress stacey dash running congress california^'clueless actress stacey dash running congress california^kaley cuoco marries karl cook intimate horse ranch wedding^discovery channel 'storm chasers star joel taylor dead^discovery channel 'storm chasers star joel taylor dead^discovery channel 'storm chasers star joel taylor dead^discovery channel 'storm chasers star joel taylor dead^billboard music awards check complete list winners^billboard music awards check complete list winners^netflix is reportedly reviving carmen sandiego with gina rodriguez^netflix is reportedly reviving carmen sandiego with gina rodriguez^reese witherspoon confirms 'legally blonde happening^april giraffe pregnant^april giraffe pregnant",17,28,11,45,0.37777777777777777,0.24444444444444444,0
87818409,guardian,1085,8005080,60342,551332,0,4,26,15,the need independent journalism never greater become guardian supporter,betting media firms offer fund addiction awareness ad campaign^friday us briefing khashoggi search widens white house shifts tone^revealed one four europeans vote populist^revealed one four europeans vote populist^rachel weisz 'my parents refugees brexit feels like death^rachel weisz 'my parents refugees brexit feels like death^rachel weisz 'my parents refugees brexit feels like death^rachel weisz 'my parents refugees brexit feels like death^no cinderella margo jefferson real meghan markle^julia roberts jim carrey emma stone hollywood stars takeover tv^vince vaughn mel gibson hollywood cops prove lives matter^vince vaughn mel gibson hollywood cops prove lives matter^vince vaughn mel gibson hollywood cops prove lives matter^no cinderella margo jefferson real meghan markle^baftas full list winners^brad pitt angelina jolie search perfect pr hollywood divorce^brad pitt angelina jolie search perfect pr hollywood divorce^actor terry crews i sexually assaulted hollywood executive^actor terry crews i sexually assaulted hollywood executive^julia roberts jim carrey emma stone hollywood stars takeover tv^golden globes full list winners^breathe review andrew garfield fronts poignant biopic wheelchair pioneer^danny boyle exit james bond throws franchise chaos^danny boyle exit james bond throws franchise chaos^danny boyle exit james bond throws franchise chaos^i miss old kanye happened rap complex star^'they foiled mariah carey blames production team new year disaster^i created character called katy perry i want katheryn hudson it scary^i created character called katy perry i want katheryn hudson it scary^charlie says review matt smith magnetic charles manson unpersuasive cult drama^prince harry asks william best man^pregnant serena williams poses nude vanity fair cover shoot^pregnant serena williams poses nude vanity fair cover shoot^pregnant serena williams poses nude vanity fair cover shoot^rapper nelly criminal investigation sexual assault^royal wedding meghan markle father walk aisle^royal wedding live elton john performs prince harry meghan markle reception latest news^louis ck accused five women sexual misconduct new report^louis ck accused five women sexual misconduct new report^louis ck accused five women sexual misconduct new report^don rickles legendary comedian master celebrity roasts dies aged^tom daley dustin lance black eecting first child^daniel craig confirms play james bond^daniel craig confirms play james bond^actor ving rhames says police held gunpoint home,26,19,-7,45,0.5777777777777777,-0.15555555555555556,1
16973333,Independent,1191,2870766,23429,903299,1,2,28,14,news comment features the independent try ad-free eerience access premium articles app,house representatives passes spending bill bring end us government shutdown^donald trump speech un betrayed little actually knows foreign policy^us department agriculture agency told 'avoid using term climate change^'go buy ivanka stuff kellyanne conway said then first daughter fashion sales eloded^kellyanne conway facing calls 'action telling people 'go buy ivanka stuff^a look inside relationship oprah winfrey stedman graham say avoiding marriage helped stay toge^a look inside relationship oprah winfrey stedman graham say avoiding marriage helped stay toge^keeping kardashian pregnancy rumors a timeline^keeping kardashian pregnancy rumors a timeline^keeping kardashian pregnancy rumors a timeline^keeping kardashian pregnancy rumors a timeline^keeping kardashian pregnancy rumors a timeline^this royal title duchess cambridge receive prince william becomes king^this royal title duchess cambridge receive prince william becomes king^the crown cast new prince charles queen mother^the crown cast new prince charles queen mother^ben affleck addressed rumours quitting batman role^brad pitt fighting angelina jolie courts custody six children^donald trump kicked one direction hotel refusing meet daughter^donald trump kicked one direction hotel refusing meet daughter^alec baldwin n't done playing donald trump snl yet^film reviews round wonder wheel sweet country walk like panther mom amp dad^meghan markle nephew sells new cannabis strain royal wedding^meghan markle nephew reveals developing special cannabis strain royal wedding^meghan markle nephew developing special cannabis strain royal wedding^meghan markle nephew sells new cannabis strain royal wedding^meghan markle nephew developing special cannabis strain royal wedding^i 'd lot excited meghan markle prince harry royal baby i knew going born an^stephen colbert responds donald trump calling 'filthy talent guy^stephen colbert responds donald trump calling 'filthy talent guy^prince harry meghan markle royal wedding outfits display^ariana grande 'moved named first ever honorary citizen manchester^justin bieber cancels remaining dates purpose world tour^justin bieber cancels remaining dates purpose world tour^new house cards trailer confirmed fate kevin spacey frank underwood^louis ck accused sexual misconduct five women^pirelli calendar stars gigi hadid misty copeland empowering women pursue dre^pirelli calendar stars gigi hadid misty copeland empowering women pursue dre^justin timberlake announces man woods world tour get tickets^spider man homecoming post credits scene elained^jay z admits marriage beyonce n't totally built truth^first look ryan murphy feud elores one hollywood famous rivalries^first look ryan murphy feud elores one hollywood famous rivalries^lewis hamilton says sorry telling nephew boys wear princess dresses^lewis hamilton says sorry deletes video telling nephew boys wear princess dresses,29,16,-13,45,0.6444444444444445,-0.2888888888888889,1
24700876,TheTorontoSun,521,301031,2041,186666,0,1,29,15,toronto best local news sports entertainment comment pictures video,these countermeasures apply goods originating us take effect july re^jennifer aniston denies brad pitt houlder cry justin theroux split^leslie jones calls fans give comedians pass insensitive old jokes saying job make ug^roseanne barr begs jerry seinfeld career comeback help^josh o connor play prince charles 'the crown^which royals secret social media accounts^which royals secret social media accounts^drake says claim insulted muslim woman concert fake media story^more evidence justin bieber hailey baldwin already married^nicole kidman trump 'we country need support whoever president^trump arnie you 'fired 'the new celebrity apprentice bad ratings^trump arnie you 'fired 'the new celebrity apprentice bad ratings^ben affleck jennifer garner settle divorce case report^snl recap dakota johnson interesting host shadesofgrey^caitlyn jenner skips son brody jenner wedding^angelina jolie breaks silence split brad pitt^'they foiled mariah carey weighs disastrous new year eve performance^teri hatcher i 'm broke homeless^teri hatcher i 'm broke homeless^breakingnews teri hatcher i broke i done well investing money i homeless i l^rachel weisz daniel craig welcome baby girl^angelina jolie switches lawyers ongoing divorce custody battle brad pitt^teri hatcher i 'm broke homeless^teri hatcher i 'm broke homeless^breakingnews teri hatcher i broke i done well investing money i homeless i l^are darren aronofsky suki waterhouse dating^d k dangerous jenniferlawrence swears sex terrified getting sexually transmitted infe^jennifer lawrence swears sex terrified get sti^selena gomez reveals kidney transplant^happening now crowd outside princess wales going wild brad pitt tiff13 suntiff13^surprise anna kournikova enrique iglesias welcome twins^surprise anna kournikova enrique iglesias welcome twins^amy schumer hospitalized horrible kidney infection^amy schumer hospitalized horrible kidney infection^summer phoenix files divorce casey affleck^rachel mcadams pregnant first child according multiple reports^ewan mcgregor daughter calls girlfriend mary elizabeth winstead piece trash^stan lee says 'feeling great brief hospitalization^steve martin martin short 'colonoscopy parties tom hanks^justin theroux breaks social media silence split jennifer aniston^the walking dead stuntman john bernecker dies fall set^bradley cooper girlfriend irina shayk welcome first child^bradley cooper girlfriend irina shayk welcome first child^taylor swift announces new album 'reputation november^taylor swift announces new album 'reputation november,29,16,-13,45,0.6444444444444445,-0.2888888888888889,1
8192222,Jezebel,14,321852,6704,100155,0,0,33,12,gender culture politics with teeth,blac chyna never name angela kardashian^blac chyna never name angela kardashian^it official gwen stefani caught bouquet blake shelton hairdresser wedding^oh god julia roberts danny moder might getting divorce^fuck kylie jenner pregnant travis scott baby^kelly ripa eat cuticles think taste like chicken live with kelly ry^tickets taylor reputation tour selling swiftly^tickets taylor reputation tour selling swiftly^donald trump kicked one direction hotel refusing meet daughter^donald trump kicked one direction hotel refusing meet daughter^claudia jordan completely denies knows jamie foxx katie holmes dating^claudia jordan backpedaled hard confirming jamie foxx katie holmes dating^do n't worry jamie foxx katie holmes still dating^does anyone care jamie foxx katie holmes dating all signs point^do n't worry jamie foxx katie holmes still dating^patti stanger claims anna faris chris pratt still living together^patti stanger claims anna faris chris pratt still living together^katy perry used new american idol platform shade sworn enemy taylor swift^katy perry used new american idol platform shade sworn enemy taylor swift^kylie kendall jenner sued tupac shakur photographer stupid shirts^kylie kendall jenner sued tupac shakur photographer stupid shirts^marion cotillard breaks silence wishes brad pitt angelina jolie 'peace^marion cotillard breaks silence wishes brad pitt angelina jolie 'peace^selena gomez elle fanning timoth e chalamet working woody allen^selena gomez elle fanning timoth e chalamet working woody allen^teresa giudice n't know broke law plea deal^this week in tabloids kate middleton faints from carrying imaginary royal twins^brad pitt reportedly thinks angelina jolie disgusting starting public divorce battle^brad pitt reportedly thinks angelina jolie disgusting starting public divorce battle^megyn kelly today today wasting away megynkellyville^megyn kelly today today wasting away megynkellyville^katy perry used new american idol platform shade sworn enemy taylor swift^katy perry used new american idol platform shade sworn enemy taylor swift^jason aldean cancels upcoming concerts las vegas shooting respect victims^jason aldean cancels upcoming concerts las vegas shooting respect victims^iggy azalea says lost lbs one week twerking^iggy azalea says lost lbs one week twerking^portia de rossi says steven seagal propositioned unzipped pants audition^portia de rossi says steven seagal propositioned unzipped pants audition^vanderpump rules jax taylor brittany cartwright engaged^vanderpump rules jax taylor brittany cartwright engaged^rose mcgowan arrested released bond warrant felony drug possession^rose mcgowan arrested released bond warrant felony drug possession^katie couric said matt lauer annoying habit pinches ass lot^kate beckinsale says harvey weinstein offered alcohol hotel room,33,12,-21,45,0.7333333333333333,-0.4666666666666667,1
240649814,TimesNow,390,9072152,4855,427523,1,34,5,4,times now india watched english news channel follow lightning fast breakingnews alerts,"nancy pelosi eected wednesday become democratic nominee speaker us house representati^'congress leader saifuddin soz statement former pakistan president parvez musharraf death pe^pm modi sco summit signing agreements joint statement underway qingdao china c takes you^abhimanyu murder the main accused arrested pfi released statement seems like justificatio^times now accesses statement man attacked delhi cm kejriwalattacked^is surender singh statement sabka saath watch counter hindurashtrapush^times now reports kolkata west bengal bjp president dilip ghosh booked statement op^we fighting development believe constitution india i appreciate statement mukh^home minister rajnath singh statement lok sabha mob lynching satisfactory this gam^the answer statement another statement answer statement threat actual conduct viol^i n't condemn statement union minister says lawyer conversation |^as far mr ansari concerned first time making kind statement^if ram mandir going taken issue bjp courage let amit shah pm modi make thi^congress said disowned statement soz senior journalist condemnpakproxies^i heard statement home minister india isis hands india dr dinesh varshney l^his statement shocking defence bjp spokesperson shocking it attack freedom ere^is surender singh statement sabka saath watch submission atharkhan hindurashtrapush^saifuddin soz statement people kashmir wanting self governance wrong untrue says pl punia c^the face congress open entire nation cong bjp two sides coin^watch as begins debate modivsall special edition pm^out power mufti eed ex cm glorifies terrorists 'more salahuddins warning terror comment riles india bj^first bjp cong ahead m.p polls netas forget issues shivraj makes babas mantri cong writes 'mahakaal'^turning point election sensational admission rahul general confesses 'need muslim vote win con^out power mufti eed ex cm glorifies terrorists 'more salahuddins warning terror comment riles india bj^cong led opposition shocks now undercuts 'sept op 'sept op one many strikes top army planners c^times now super exclusive newsbreak ahead lok sabha poll rahul pm ambition crashes standby big rev^'both us side debate says national spokesperson bjp^on th edition confront rs mp debates aimplb kamal faruqui rammandir2019push has sc^listen in as takes debate forward modivsall special edition pm^john theis david headley lawyer speaks times now the lawyer reveals headleyissafe and^a family alleged three four infants died lucknow king george medical university the^chicago based boeing calls top us erter delivered one every four jetliners ma^october first full month latest us tariffs chinese goods went effect sept. si^the us trade deficit goods china ballooned record 375.2 billion last year^the benchmark sensex 4 points 1 per cent ,532.21 early trade tuesday with us^chris pratt files divorce actress wife anna faris^selena gomez star alongside elle fanning timothee chalamet upcoming woody allen film^grammy awards here complete list winners^grammy awards here complete list winners grammys^grammy awards here complete list winners^grammy awards here complete list winners^grammy awards here complete list winners grammys^grammy awards here complete list winners^chris pratt files divorce actress wife anna faris",6,38,32,44,0.13636363636363635,0.7272727272727273,0
14980820,nbcwashington,1635,301629,3962,255591,1,14,8,21,your place breaking news weather investigations exclusive local stories washington d.c. area beyond working4you,former president george h.w bush carried train final resting place texas a amp m university the^the evidence could include video death emantic ej bradford jr. police initially said carried t^salmonella raw chicken made people sick across states including maryland virginia centers^six weeks midterm elections democrats hold point lead congressional preference among regis^msnbc announced hold democratic presidential debate thursday feb. new hampshire^president trump ignited eleventh hour confusion friday said interview fox amp friends he^watch live now french president emmanuel macron giving rare address joint session congress wednesday^the last foreign leader address joint session congress indian prime minister narendra modi june^salmonella raw chicken made people sick across states including maryland virginia centers^update three victims critically injured including police officer shooting mercy hospital chicago s^republican candidate u.s. senate corey stewart says hillary clinton reason running mate sen^president trump speaking rally moon township pennsylvania rick saccone state representative in^the calls harassment push trump supporter avoid public unacceptable sarah huckabee san^one u.s. special operations soldier killed four u.s. service members wounded enemy attack friday in^one four men charged killing two maryland teens night high school graduation sente^kellyanne conway counseled urged americans go buy ivanka stuff tv interview^the queen kate middleton stepped monochromatic blue ensembles long sleeves saturday official c^catherine duchess cambridge meghan duchess sussex left princes behind watch final wimbled^catherine duchess cambridge meghan duchess sussex left princes behind watch final wimbled^catherine duchess cambridge meghan duchess sussex left princes behind watch final wimbled^catherine duchess cambridge meghan duchess sussex left princes behind watch final wimbled^meghan duchess sussex prince harry duke sussex hit first trip married couple^meghan duchess sussex prince harry duke sussex spotted royal ascot prize ceremony yesterday.^tiffany haddish claims drugged actress bit beyonc face^behind scenes video featuring new footage star wars the last jedi footage debuts disney d23 e^singer meghan trainor engaged boyfriend spy kids star daryl sabara watch adorable proposal gt^kate middleton shows baby bump flowing dress bafta film awards^former glee star lea michele engaged boyfriend zandy reich^the truth days leading demi lovato overdose^this is us chrissy metz reveals surprising connection younger kate actress^jeopardy host alex trebek recovering surgery remove blood clots brain game show hiatus^u.s. first lady melania trump meets britain prince harry ahead start invictus games^a federal appeals court ordered making murderer subject brendan dassey remain prison appeal^janet jackson shares first photo baby boy eissa al mana gt^supermodel karlie kloss engaged joshua kushner younger brother white house senior advisor jared kushn^prince harry says wanted british royal family^bradley cooper irina shayk welcome first child^andy spade breaks silence wife kate spade death^happy birthday first lady michelle obama celebrating th birthday today^serena williams withdraws australian open saying ready return tournament tennis^serena williams withdraws australian open saying ready return tournament tennis^the people choice awards air nov. e^pyeongchang makes winter olympics history condoms given athletes^though beautiful look figure skating share issues the biggest scandals olympic figur,9,35,26,44,0.20454545454545456,0.5909090909090909,0
14335144,digitalspy,1873,178774,2507,201667,0,0,12,32,everything entertainment by fans fans ... we tweet tv movies soaps showbiz music tech ppa digital content team year,reese witherspoon big legally blonde update this going good^should ellen degeneres replace kim cattrall sex city sarah jessica parker says yes ...^once upon time cast remember meeting manchester terror attack victim georgina callander emotional tributes^here play prince charles queen mother the crown season^ben affleck heads meeting warner bros amid quitting batman rumours^original charmed star shannen doherty gives verdict controversial reboot^charmed shannen doherty urges fans kinder reboot negative response.^wonder woman wins best action movie critics choice awards here winners list full^calm people hailee steinfeld swears dating justin bieber^robert pattinson wanted punch director new film the lighthouse^daniel craig rachel weisz welcome first child together^billy connolly hits back michael parkinson claims health^kelly ripa new live co host ... ryan seacrest^katy perry announces new album 'witness release date us tour^ed sheeran says not engaged girlfriend cherry seaborn^ed sheeran says not engaged girlfriend cherry seaborn^rita ora cardi b kiss controversial girls music video bebe rexha^the complete list brit awards winners 're announced brits2018 brits^homeland end season claire danes says^rachel mcadams reportedly pregnant first child^meghan markle dad says heart surgery likely ca n't attend royal wedding^emma roberts returns cult american horror story season ahss7^ben affleck drops netflix movie triple frontier focus wellness family^adele unites cameron diaz jennifer lawrence women march los angeles^ed sheeran says not engaged girlfriend cherry seaborn^this everything know twin peaks return^andrew garfield i gay man right without physical act^game thrones kit harington rose leslie tipped getting married next month^game thrones kit harington rose leslie married ... amp so many co stars wedding^netflix chilling adventures sabrina finally premiere date^wonder woman london premiere cancelled wake manchester bombing^congrats tom daley dustin lance black announce 're eecting first child^on timetotalk day dwayne johnson reflects mother suicide attempt^ryan murphy shares first look connie britton dylan mcdermott return american horror story^ryan murphy groundbreaking new series pose reveals first look transgender cast^wwe stars john cena nikki bella split six years together^john cena nikki bella split six years together^that roswell reboot the cw officially happening^justin theroux posts savvy first instagram since split jennifer aniston^emilia clarke says daenerys final game thrones scene 'f**ked^reese witherspoon confirms legally blonde actually happening deets^here meghan markle written suits season finale^once upon time season release date cast spoilers everything need know^ncis star pauley perrette leaving show season years *sobs*,12,32,20,44,0.2727272727272727,0.4545454545454545,0
22970986,WLKY,369,119115,847,310947,2,4,10,28,hearst television inc. cbs affiliate,"melania trump undergoes kidney surgery walter reed medical center^people found dead ohio^most popular baby names every u.s. state^most popular baby names every u.s. state^most popular baby names every u.s. state^us slaps 50 billion tariffs chinese goods escalating trade dispute^what roseanne barr net worth^megyn kelly weighs matt lauer fired 'today show^megyn kelly weighs matt lauer fired 'today show^david cassidy fighting memory loss wants 'enjoy life^icymi david cassidy fighting memory loss wants 'enjoy life^david cassidy fighting memory loss wants 'enjoy life^george clooney makes 27,283 every hour thanks tequila^mariah carey new year eve performance 'they foiled^'free speech rally 'fight supremacy groups set converge boston common^caitlyn jenner latest celebrity float run office^koko gorilla knew sign language dies^james franco event canceled actor denies allegations sexual misconduct^playboy found hugh hefner cause death revealed^playboy founder hugh hefner cause death revealed^playboy founder hugh hefner cause death revealed^mindy kaling reportedly pregnant first child^mindy kaling reportedly pregnant first child^mindy kaling reportedly pregnant first child^'clueless actress stacey dash running congress california^'clueless actress stacey dash running congress california^'clueless actress stacey dash running congress california^'clueless actress stacey dash running congress california^kaley cuoco marries karl cook intimate horse ranch wedding^kaley cuoco marries karl cook intimate horse ranch wedding^kaley cuoco marries karl cook intimate horse ranch wedding^kaley cuoco marries karl cook intimate horse ranch wedding^discovery channel 'storm chasers star joel taylor dead^discovery channel 'storm chasers star joel taylor dead^discovery channel 'storm chasers star joel taylor dead^discovery channel 'storm chasers star joel taylor dead^billboard music awards check complete list winners^billboard music awards check complete list winners^netflix is reportedly reviving carmen sandiego with gina rodriguez^reese witherspoon confirms 'legally blonde happening^reese witherspoon confirms 'legally blonde happening^april giraffe pregnant^april giraffe pregnant^april giraffe pregnant",12,32,20,44,0.2727272727272727,0.4545454545454545,0
16012783,thedailybeast,980,1237314,24282,297038,1,19,19,5,independent intelligent influential send tips tips.com,breaking accused terrorist akayed ullah wrote facebook trump failed protect nation detona^in statement the daily beast apparently semi scripted interviews fox news channel spokesperson said^michael avenatti taking concrete steps behind scenes prep possible presidential run according^rudy giuliani said would prefer trump sits interview mueller^international brotherhood teamsters reached agreement govt end oversight keep mafia^cynthia nin picked major endorsement left specifically political organization spun from^harlan hill a bowtie sporting pro trump millennial often appears fox news claimed backed be^cummings chaffetz letter says conway statements appear violate federal ethics regulations.^the possibility howard schultz presidential run put spotlight debate within democratic party ab^the icing started homeland security secretary proposed asking un high commission refugees to^in multiple interviews fox amp friends pruitt essentially allowed dictate terms interview an^this morning invited congresswoman ann kirkpatrick appear fox amp friends first ... barbara l'italien did^bossie suspended weeks contributor gig fox news.^p. the first wave reportedly addressed george soros hillary clinton obama biden former ag eric ho^a black lives matter protester dragged campaign rally las vegas donald trump monday^new jared kushner weaved dodged questions khashoggi cnn citizen conference n't even mention^trump already articulated eansive view treason comes people called congressio^rudy giuliani tease new hampshire^the white house blocked gina haspel attending highly anticipated senate briefing saudi arabia yemen and^rick perry record full transcript interview w/ socialsecurity medicare immigration^angelina jolie amp brad pitt fortune worth hundreds millions dollars with 'iron clad pre nup place^prepare dvrs here 're new fall tv shows got see featuring jim carrey julia roberts murphy bro^did lindsay lohan convert islam^aretha franklin queen soul died we take look back look back performance natural w^after years fighting brad pitt angelina jolie reportedly making fresh effort restore civility t^there another royalbaby way meghan markle pregnant prince harry first child^in dragged across concrete mel gibson vince vaughn play pair abusive cops turn crime make end^channing tatum jenna dewan announce separation^prepare dvrs here 're new fall tv shows got see featuring jim carrey julia roberts murphy bro^trump problem network accused sitting access hollywood tapes sh^report kendall jenner rips caitlyn turning back family^kendall jenner reportedly seen ripping caitlyn new one tense argument nobu malibu^angelina jolie breaks silence divorce brad pitt^after several quiet months angelina jolie brad pitt divorce battle roared back headlines with^angelina jolie brad pitt divorce battle entering nastiest phase yet but fight cash two^charlie kirk fox amp friends look taylor swift i love music personally kanye west i 'm bigger fan of^did lindsay lohan convert islam^selena gomez reveals kidney transplant summer^robert pattinson twitter obsession it bizarre curiosity^there tv series made year and spoiler tops list best s^house cards star reg e. cathey dead^suspect rapper xxxtentacion murder arrested^new suspect arrested connection murder rapper xxxtentacion^kylie jenner lands cover forbes richest self made women issue the magazine says poised become,20,24,4,44,0.4545454545454545,0.09090909090909093,0
27646245,ottawasuncom,909,94601,1137,129390,0,0,28,16,news sports entertainment comment canada capital words photos video blogs chats forums,fergie josh duhamel split^the complete list winners golden globes^trump you 'fired 'the new celebrity apprentice bad ratings arnie hire 'fact checker'^beyonce reunite destiny child coachella report^beyonce reunite destiny child coachella report^brad pitt mom wants get back jennifer aniston^brad pitt mom wants get back jennifer aniston^you said it be afraid afraid carbon tax^you said it be afraid afraid carbon tax^hoda kotb replace matt lauer 'today^hoda kotb replace matt lauer 'today^meghan markle prince harry 'practically living together report^beyond thrilled quebec nurse donates taylor swift tickets michigan teen brain injury^angelina jolie brad pitt part bizarre plot capture warlord joseph kony report^robert pattinson spotted sneaking sienna miller home^robert pattinson spotted sneaking sienna miller home^meghan markle considered bond girl role royal engagement report^meghan markle considered bond girl role royal engagement report^meghan markle considered bond girl role royal engagement report^khloe kardashian tristan thompson cheating scandal plays kuwtk^khloe kardashian tristan thompson cheating scandal plays kuwtk^justin theroux breaks silence divorce jennifer aniston^justin theroux breaks silence divorce jennifer aniston^jennifer lawrence swears sex terrified getting sti^jennifer lawrence swears sex terrified getting sti^jennifer lawrence swears sex terrified getting sti^jennifer lawrence swears sex terrified getting sti^selena gomez reveals kidney transplant^swedish dj avicii found dead^julia louis dreyfus diagnosed breast cancer^julia louis dreyfus diagnosed breast cancer^michael fassbender alicia vikander reportedly married^'storm chasers star joel taylor dead^meghan markle makes pippa middleton wedding reception^bradley cooper girlfriend irina shayk welcome first child^taylor swift announces new album 'reputation november^taylor swift announces new album 'reputation november^the weinstein company file bankruptcy^the weinstein company file bankruptcy^jersey shores mike 'the situation sorrentino pleads guilty tax fraud case^actress anika noni rose reveals sexually assaulted plane^actress anika noni rose reveals sexually assaulted plane^actress anika noni rose reveals sexually assaulted plane^pauley perrette leaving ncis seasons,28,16,-12,44,0.6363636363636364,-0.2727272727272727,1
15279429,VanityFair,1204,4883248,19945,113755,0,2,33,9,in-depth reporting gripping narratives world-class photography plus heaping doses oscar-blogging royal-watching assorted guilty pleasures,michael moore upcoming documentary focuses trump divisive presidency features interviews figures l^tune week interview stormy daniels lawyer concern^watch kim kardashian support kanye west american idol audition^kim khloe kourtney *really* n't want blac chyna angela kardashian^for much know oprah relatively little known relationship partner stedman graham^what exactly katie holmes relationship tabloids^vanity fair responds angelina jolie comments related september cover story^kim kardashian west elains freaking metgala dress night^sarah jessica parker still imagine sex city without kim cattrall^dina lohan drops details lindsay upcoming reality show^tom hiddleston lock james bond bet anymore^the duchess sussex found ally royal family thanks duchess cambridge^the duchess sussex found ally royal family thanks duchess cambridge^make way make way thecrown cast new prince charles queen mother^sarah jessica parker still imagine sex city without kim cattrall^justin theroux reacts jennifer aniston dragged brad pitt angelina jolie divorce news^meryl streep hugged chris rock weeks ago still trouble getting^drake jennifer lopez alex rodriguez lopsided love triangle^vanity fair responds angelina jolie comments related september cover story^today know starting new chapter third hour show hoda kotb told viewer^gameofthrones star sophie turner engaged joe jonas^stephen colbert let billy bush hook^bradley cooper take story nearly old hollywood^hoda kotb officially replaced matt lauer^emma stone rachel weisz olivia colman shine film festival hit^in lead prince harry meghan markle big day revisit charles diana fairy tale royal wedding^in lead prince harry meghan markle big day revisit charles diana fairy tale royal wedding^meghan markle prince harry moving time new addition family^emma stone rachel weisz olivia colman shine film festival hit^taylor swift really committed laying low thing huh^today know starting new chapter third hour show hoda kotb told viewer^angelina jolie brad pitt prince william princess kate hung without^angelina jolie brad pitt prince william princess kate tea party friday^angelina jolie brad pitt prince william princess kate hung without^the queen soul biggest star day wide range luminaries arrived detroit pay r^donald trump almost played president sharknado^ariana grande named first ever honorary citizen manchester^everything know far stranger things season^jennifer lawrence darren aronofsky started dating filming split^jennifer lawrence darren aronofsky split year dating^rent fox next live musical^everything know reasons why season^exclusive first look jessica lange ryan murphy reunion long day journey night^after 500 million deal fell apart weinstein company decided file bankruptcy,33,11,-22,44,0.75,-0.5,1
56413858,FoxBusiness,398,810425,7821,201507,0,33,1,9,the official twitter page fox business network capitalism lives ask cable provider fox business neighborhood,members senate american people represent see president said last night tha^members senate american people represent see president said last night tha^the reality last two administrations economy grew less tune^i think proud country for heaven sake ... live greatest nati^mueller releases list potential witnesses manafort trial including chief strategist bernie sander^just in president trump speaks gop healthcare plan white house listening session^breakingnews arrives kansas city ahead speech veterans foreign wars convention^during address national federation independent business tuesday president donald j. trump touted^during address national federation independent business tuesday president donald j. trump touted^during address national federation independent business tuesday president donald j. trump touted^delivers remarks national federation independent business th anniversary celebration^we respect independence federal reserve tune in vice president mike pence joins^we respect independence federal reserve the president reflected personal opinion t^trade deals every country calling every day saying 'let make deal let ma^in exclusive interview says would probably ask supreme^in interview fox business former president george w. bush wife reflected life a^in interview fox business former president george w. bush wife reflected life a^watch live facebook ceo mark zuckerberg appears testimony house energy commerce committee^watch live facebook ceo mark zuckerberg appears testimony house energy commerce committee^watch live facebook ceo mark zuckerberg appears testimony house energy commerce committee^mike pence touted success economy trump administration speech tax cuts an^mike pence touted success economy trump administration speech tax cuts an^larry kudlow director national economic council gave news briefing white house wednesday di^responded monday white house press briefing canada retaliatory tariffs u.s. erts in^awaiting white house press briefing^watch live holds white house press briefing^responded monday white house press briefing canada retaliatory tariffs u.s. erts in^watch live holds press briefing white house^awaiting deliver remarks philadelphia^watch live delivers remarks economy tax reform annual convention national electri^reports planning impose tariffs chinese goods i believe r^secretary labor alex acosta discussed president trump directed u.s. trade representative office pre^reports planning impose tariffs chinese goods i believe r^tom petty dead musicians celebrities react^tom petty dead musicians celebrities react^prince harry asks big brother prince william best man wedding meghan markle^prince harry asks big brother prince william best man wedding meghan markle^prince harry asks big brother prince william best man wedding meghan markle^details alleged sexual misconduct allegations guess co founder paul marciano^kate upton details alleged sexual misconduct allegations guess co founder paul marciano^'nypd blue 'la law 'hill street blues creator steven bochco dead^the weinstein company file bankruptcy^the weinstein company file bankruptcy,1,42,41,43,0.02325581395348837,0.9534883720930232,0
28325821,961KISS,2919,93160,418,52605,0,0,23,20,kiss pittsburgh pa -937-9610 follow us,john mayer has been hospitalized emergency appendectomy^american music awards nominations amas nominees full list^chris pratt files divorce from anna faris^sharon osbourne apologizes to justin bieber 'i was wrong to 'attack you^no drake is n't 'lusting after rihanna despite new rumors^taylor swift wins countersuit against dj david mueller in groping trial^kylie jenner is pregnant with travis scott baby^sorry drake amp bella hadid are not 'secretly dating^hailee steinfeld responds to justin bieber dating rumors^robert pattinson amp katy perry are not dating^beyonce birth twins still hospital 'minor issue^beyonce birth twins still hospital 'minor issue^justin bieber fan arrested trespassing at singer beverly hills home^hiddleswift crushed^meghan markle twins with kate middleton during outing with queen^taylor swift will not be best woman at ed sheeran wedding^joe jonas sophie turner 'already thinking of having kids is made up story^fans react u2 cancels st. louis concert amid police protests^report months after baby ... jessica simpson is pregnant again via^no zayn is not 'desperate to defend girlfriend gigi hadid^selena gomez reveals she had a kidney transplant amp her friend was her donor^selena gomez reveals she had a kidney transplant amp her friend was her donor^mariah carey not dating both nick cannon and bryan tanaka despite report^harry styles announces intimate world tour see the dates^ed sheeran is engaged longtime girlfriend cherry seaborn^million dollar listing fredrik eklund derek welcome twins^taylor swift teases new song 'gorgeous on instagram listen to a snippet^bachelor nick viall vanessa grimaldi split end engagement^rachel mcadams is reportedly pregnant with her first child^demi lovato reveals that she contemplated suicide at age^taylor swift teases new song 'gorgeous on instagram listen to a snippet^justin timberlake announces 'the man of the woods tour see the dates^here what hocus pocus thackery binx looks like now^kim kardashian shares first photo baby chicago west^bachelorette peter kraus reveals he suffered eating disorder^tori kelly is engaged to german basketball player andre murillo^watch harry styles kiss james corden in christmas themed 'carpool karaoke^jennifer lawrence darren aronofsky split^camila cabello announces her 'never be the same tour see the dates^gigi hadid slams body shamers for calling her 'too skinny at nyfw^meryl streep joins season big little lies^demi lovato announces tour with dj khaled see the dates^chris pratt files divorce from anna faris,23,20,-3,43,0.5348837209302325,-0.06976744186046513,1
12700842,933FLZ,12291,43329,662,126064,0,0,28,15,tampa bay hit music channel,john mayer has been hospitalized emergency appendectomy^blac chyna will not be able to trademark her name as 'angela kardashian^karrueche tran granted five year restraining order against chris brown^american music awards nominations amas nominees full list^ed sheeran did not 'break friendship code with taylor swift news celebrity^celebrities react trump withdraws steph curry white house invitation^celebrity reaction jimmy kimmel monologue on las vegas shooting and guns^beyonce not demanding silent delivery room despite report^jimmy kimmel talks donald trump harvey weinstein on 'gma^chris brown slammed by judge for skipping karrueche tran court hearing^kanye west concerts on hold indefinitely news celebrity^sorry drake amp bella hadid are not 'secretly dating^halle berry not pregnant at despite reports^watch kim kardashian first interview since robbery on 'ellen degeneres show videos^beyonce birth twins still hospital 'minor issue^karrueche tran granted five year restraining order against chris brown^justin bieber fan arrested trespassing at singer beverly hills home^mary j. blige hacked did not write kendu isaacs hate tweet^joe jonas sophie turner 'already thinking of having kids is made up story^jessica simpson gives birth baby boy celebbuzz^celebrities react nfl players kneel lock arms during national anthem^oprah not running for president says gayle king^grammy awards see the full winners list news celebrity^iggy azalea blasts nick young after accidental dinner reunion^kanye west is not rebooting 'american idol^report jessica simpson pregnant celebbuzz^mariah carey not dating both nick cannon and bryan tanaka despite report^kourtney kardashian amp scott disick are back together news celebrity^here how help victims las vegas mass shooting^ed sheeran engaged to girlfriend cherry seaborn^taylor swift teases new song 'gorgeous on instagram listen to a snippet^demi lovato reveals that she contemplated suicide at age^hugh hefner cause death revealed^alex rodriguez year old daughter sings for jennifer lopez photos^taylor swift teases new song 'gorgeous on instagram listen to a snippet^justin timberlake announces 'the man of the woods tour see the dates^the narwhal frappuccino is here it tastes like pink starburst^tori kelly is engaged to german basketball player andre murillo^watch harry styles kiss james corden in christmas themed 'carpool karaoke^hollywood george and amal clooney donate 1 million fight hate groups^billboard music awards nominations see full list of bbmas nominees^camila cabello announces her 'never be the same tour see the dates^demi lovato announces tour with dj khaled see the dates,28,15,-13,43,0.6511627906976745,-0.3023255813953488,1
17133807,GraziaUK,2380,379513,3203,126395,0,0,29,14,the number one destination smart stylish women for daily edit things fashion beauty celeb head,prince harry meghan markle relationship timeline^not everyone in fiji is happy about prince harry and meghan markle visit^not everyone fiji happy prince harry meghan markle visit^not everyone in fiji is happy about prince harry and meghan markle visit^madonna katy perry star rather raunchy photo shoot v magazine^has the crown finally cast young prince charles we see resemblance ...^rumour the crown new prince charles^will josh o'connor the crown next prince charles^are sienna miller brad pitt secretly 'dating glastonbury^'why i disagree dad ivanka trump meme 've waiting ...^'why i disagree with my dad ivanka trump meme 've always wanted^'why i disagree dad ivanka trump meme 've waiting ...^what meghan markle cindy crawford and blake lively all have in common^what meghan markle cindy crawford and blake lively all have in common^what designerlunch today donutella versace henry hollandaise dolcelatte amp gabbana tweet us fashion food puns^angelina jolie 'i n't enjoy single^it official dakota johnson chris martin dating^angelina jolie breaks silence brad pitt child abuse investigation^it looks like meghan markle moving next door prince harry kickstart new royal role^is meghan markle moving next door prince harry it certainly looks way ...^it looks like meghan markle moving next door prince harry kickstart new royal role^rumours flying meghan markle moving next door prince harry^is meghan markle moving next door prince harry^are prince harry meghan markle moving cotswolds^justin theroux opened up about his divorce from jennifer aniston and introduced the gentle separation^people are obsessing over david beckham hair again^people are obsessing over david beckham hair again^new pics people are obsessing over david beckham hair again^kylie jenner evaded paps entire pregnancy ca n't stars manage shun spotlight^rachel mcadams welcomes first child boyfriend jamie linden^rachel mcadams welcomes first child boyfriend jamie linden^rachel mcadams pregnant first child^meghan markle thanksgiving plans revealed^is sarah paulson set play princess diana second season feud^which actress would perfect play princess diana ryan murphy feud^who play princess diana ryan murphy new show feud we consider potential actresses^jennifer lawrence darren aronofsky split one year dating^pippa middleton chooses 495 silk dress harry meghan wedding royalwedding^pippa middleton chooses 495 silk dress harry meghan wedding royalwedding^bradley cooper irina shayk welcome first child^bradley cooper irina shayk welcome first child^these beauty essentials 'll need pack festival season^recently engaged princess eugenie jack brooksbank moved next door harry meghan,29,14,-15,43,0.6744186046511628,-0.3488372093023256,1
1168472395,EveningStandard,188,103357,1211,99206,0,3,30,10,official account london evening standard tweeting best news arts sport follow accounts,"meet pat cunnane former speechwriter barack obama^meet pat cunnane former speechwriter barack obama^meet pat cunnane former speechwriter barack obama^kim kardashian defends kylie jenner dictionary savaging^kim kardashian defends kylie jenner dictionary savaging^kim kardashian defends kylie jenner dictionary savaging^kim kardashian revealed husband kanye west wrote cheque 1 million 769,000 bid stop pr^kim kardashian revealed husband kanye west wrote cheque 1 million 769,000 bid stop pr^kim kardashian revealed husband kanye west wrote cheque 1 million 769,000 bid stop pr^james bond shoes supplier crockett amp jones steps sales^fergie josh duhamel announce split eight years marriage^liam payne spoken split cheryl first time insisting feeling okay i^cheryl never date liam payne split^cheryl never date liam payne split^josh o connor tipped play young prince charles the crown^meghan markle prince harry announced royal baby way you read story^justin bieber confirms married hailey baldwin already^justin bieber confirms married hailey baldwin already^are justin bieber hailey baldwin already married^are justin bieber hailey baldwin already married^justin bieber confirms married hailey baldwin already^are justin bieber hailey baldwin already married^is caitlyn jenner mystery celebrity big brother housemate^is caitlyn jenner mystery celebrity big brother housemate^kim kardashian reveals new release date kanye west yandhi^kim kardashian reveals new release date kanye west yandhi^caitlyn jenner misses birth daughter kylie baby girl^teri hatcher slams 'untrue reports broke homeless^kris jenner 'planning adopt child boyfriend corey gamble^kris jenner 'planning adopt child boyfriend corey gamble^teri hatcher slams 'untrue reports broke homeless^'proud david beckham gushes victoria share kiss lfw^'proud david beckham gushes victoria share kiss lfw^prince harry meets us first lady melania trump ahead invictus games^heidi klum reveals 'very single ready mingle ellen degeneres chat^justin theroux breaks social media silence visit puppy shelter jennifer aniston split^princess eugenie jack brooksbank royal wedding this everything need know^michelle williams reportedly engaged andrew youmans^jennifer aniston eemed fine since justin theroux split^this week princess eugenie announced engaged jack brooksbank news captivated world me^weinstein company 'to file bankruptcy asset sale talks collapse^weinstein company 'to file bankruptcy asset sale talks collapse^beyonc eminem the weeknd headline coachella",30,13,-17,43,0.6976744186046512,-0.3953488372093023,1
102508723,Life_and_Style,1242,219781,798,43123,0,0,40,3,your ultimate source celebrity news fashion beauty trends juicy gossip,kim kardashian and kanye west are 'leading separate lives at this point exclusive^exclusive bradpitt calls angelinajolie phony following first post split interview^big baby news jenniferaniston justintheroux get exciting details gt^exclusive kimkardashian kanyewest trial separation lasted six weeks^exclusive selenagomez downward spiral justinbieber blame^copycat much sofia richie takes instagram show her bikini bod just like kourtney kardashian^exclusive mileycyrus calls wedding liamhemsworth fight this^canceled find mileycyrus liamhemsworth called wedding^the wedding off mileycyrus liamhemsworth get sad details^exclusive these a listers fighting newly single bradpitt details^uh did justin bieber hailey baldwin secretly get married already the evidence is pretty convincing^copycat much sofia richie takes instagram show her bikini bod just like kourtney kardashian^exclusive kylie jenner is literally ready to move to a private island^take a tour of kylie jenner lavish hidden hills home^kim kardashian just left a nsfw comment on kanye west instagram and we 're screaming^mileycyrus liamhemsworth not planning wedding relationship rocks^breaking bradpitt angelinajolie getting divorce get exclusive details^angelinajolie health downward spiral following divorce bradpitt get exclusive details^bradpitt angelinajolie planning adopt divorce details^exclusive bradpitt found glassy eyed angelinajolie divorce details^report bradpitt blindsided angelinajolie divorce get heartbreaking details^exclusive angelinajolie weight plummets following bradpitt divorce get sad details^kendalljenner survives detox tea raw veggies modeling more strict dangerous diet^baby no kylie jenner gushes over how much she misses being pregnant^breaking bradpitt angelinajolie getting divorce get exclusive details^angelinajolie health downward spiral following divorce bradpitt get exclusive details^bradpitt angelinajolie planning adopt divorce details^exclusive bradpitt found glassy eyed angelinajolie divorce details^report bradpitt blindsided angelinajolie divorce get heartbreaking details^exclusive angelinajolie weight plummets following bradpitt divorce get sad details^selena gomez is thriving without justin bieber she never been happier^exclusive boozy krisjenner thinks scottdisick drinking problem yep read right^exclusive kanyewest *this* close becoming americanidol judge diva demands got way^amal clooney is reportedly playing matchmaker for jennifer aniston following justin theroux divorce^justin theroux finally breaks his silence on 'heartbreaking jennifer aniston divorce^copycat much sofia richie takes instagram show her bikini bod just like kourtney kardashian^copycat much sofia richie takes instagram show her bikini bod just like kourtney kardashian^so sad kimkardashian says terrified husband kanyewest get details^sofia richie 'is convinced scott disick 'is still totally in love with kourtney kardashian source says^kylie jenner gets real about life in the spotlight i 've felt 'bullied by the whole world^khlo kardashian is reportedly 'terrified of getting pregnant amid new tristan thompson cheating scandal^gossipgirl star edwestwick accused sexual assault third woman ...^gossipgirl star denies raping actress kristina cohen details,40,3,-37,43,0.9302325581395348,-0.8604651162790697,1
9300262,politico,1456,3922723,39716,314933,1,37,3,1,nobody knows politics like politico got news tip us,former presidents walk fine line trump america via^a reporter asked sanders statement russian national accused trying infiltrate right wing america^full transcript donald trump nyc speech stakes election^politico demint tweets cash sen. jim demint posted first tweet linking fundraising ..^analysis democratic politicians progressive policy architects face harsh reality the path middle^cbs runs unscheduled romney interview bumping sandra day o'connor next week face nation^rudy giuliani said kim jong un meeting cancelation gives time spend president preparati^here full transcript first presidential debate getty^full transcript third presidential debate ap photo^full transcript third presidential debate ap photo^ahead kamala harris applying lessons drawn bernie sanders presidential campaign^ahead kamala harris applying lessons drawn bernie sanders presidential campaign^ahead kamala harris applying lessons drawn bernie sanders presidential campaign^opinion if democrats lose blame these guys via^not incumbent senate race reduces odds victory if democrats lose blame guys^the host committee democratic national convention owes nearly 8 million reports^michael cohen trump longtime personal attorney resigned republican national committee finance co^the republican national committee transferred 3.5 million apiece gop house senate campaign arms^we policeman world arm republican national committee business lobbyists dial bac^first name misspelled hofstra university presidential debate tickets^biden called trump comments last presidential debate threat democratic process.^the veterans foreign wars tuesday said organization disappointed heckled press du^mocked democratic women wearing white trump address joint session congress^here full transcript former president barack obama speech gave university illinois^president barack obama deliver statement :15 rose garden partial iran agreement^gop sen. chuck grassley wants subpoena former justice department officials james comey loretta lynch t^rudy giuliani still apparently sees door open new hampshire^here full transcript former president barack obama speech gave university illinois^how john mccain want remembered in words full story^trump calls democrats un american treasonous speech cincinnati^obama cleveland economy it still fear versus hope past versus future^president trump press secretary sarah huckabee sanders often upper hand cnn white house br^it starting feel like scared pulling back curtain the white house still held priva^a laundry list trump obsessions overshadowed substance remarks gop retreat philadelphia^a laundry list trump obsessions overshadowed substance remarks gop retreat philadelphia^a laundry list trump obsessions overshadowed substance remarks gop retreat philadelphia^china changed unfair discriminatory practices prompted president trump impose tariffs around^an additional percent tariff 34 billion worth chinese goods imposed midnight off^kim kardashian west back white house today talk criminal justice reform^kellyanne conway says politicizing shooting texas disrespectful dead^kellyanne conway says politicizing shooting texas disrespectful dead^joe co hosts engaged,4,38,34,42,0.09523809523809523,0.8095238095238095,0
15754281,USATODAY,606,3889933,33623,297331,1,15,14,12,the latest news interesting stories usa today news meant shared,breaking new york blast suspect taunted trump facebook igniting bomb 'you failed protect nation^according centers disease control prevention least million people united states get an^the centers disease control prevention says one three young women abused reach ye^the centers disease control prevention week reported cases acute flaccid myelitis since august^stephen stockman former u.s. representative texas convicted counts mail fraud making false s^constitutional law professor offers take rudy giuliani interview sean hannity t^russians also allegedly tried help sen. bernie sanders green party nominee jill stein presid^lester holt gig hofstra university monday evening wo n't first rodeo presidential debate moderator^after social media blew debate laurel vs. yanny recorded audio wo^according centers disease control prevention least million people united states get an^the centers disease control prevention says one three young women abused reach ye^the centers disease control prevention says largest e. coli outbreak decade appears to^the centers disease control prevention week reported cases acute flaccid myelitis since august^during sunday appearance meet the press alexandria ocasio cortez believes district situati^while incomes risen majority households since great recession parts united states^compounds derived coconut oil found repel insects better deet according u.s. depa^reports brad pitt accused child abuse investigation^zayn malik gigi hadid confirm split two years^prince harry meghan duchess sussex meet cast crew hamilton backstage wednesday night v^katie couric breaks silence former 'today show co host matt lauer firing^channing tatum wife jenna dewan announce split we 'chosen separate couple^prince harry meghan duchess sussex meet cast crew hamilton backstage wednesday night v^here biggest moments meghan markle prince harry fairy tale wedding^the divorce custody battle brad pitt angelina jolie set go trial next month they^justin theroux described divorce jennifer aniston heartbreaking gentle^we ask londoners prince harry meghan markle their responses may surprise^kevin hart confesses cheating pregnant wife that finest hour life^kevin hart confesses cheating pregnant wife^billy bush wife sydney davis separated months following release infamous access^brad pitt quit acting 'three years^former dance moms star abby lee miller sentenced year day prison^jimmy kimmel returning host oscars^beyonc made surprise appearance honor colin kaepernick muhammad ali legacy award spo^meghan trainor engaged 'spy kids star daryl sabara^tonya harding admits prior knowledge nancy kerrigan attack abc special^walmart remove 'cosmopolitan magazine checkout lines amid me too movement^roger ailes former chairman ceo fox news dead age his life pictures^prince harry says wanted british royal family photo ap^reports bradley cooper irina shayk welcome first child^leonardo dicaprio joins margot robbie star quentin tarantino charles manson movie^prince william prince harry best man royal wedding^pauley perrette leaving ncis season run,15,27,12,42,0.35714285714285715,0.2857142857142857,0
10222202,latimesent,1365,166606,2512,123642,0,1,15,26,entertainment news plus pop culture celebrity classic hollywood arts,nbcuniversal pulling trump controversial anti immigrant campaign ad hours spot ran sunday n^blac chyna wo n't trademarking 'angela kardashian name^gigi hadid 'not asking special treatment despite burden awesomely sexy body^perspective bruce springsteen aging fine broadway^good riddance celebrities react death charles manson^'good riddance celebrities react death charles manson^george clooney wife amal welcome twins ella alexander^george clooney wife amal welcome twins ella alexander^hoda kotb addressed megyn kelly show cancellation wake kelly blackface comments we starting a^claudia jordan says 'misspoke n't confirm jamie foxx katie holmes dating^video jessica simpson gives birth baby boy ace knute johnson^emma stone director yorgos lanthimos reinvent costume drama the favourite^report brad pitt angelina jolie take custody battle court they looking december court d^is jessica simpson pregnant report says yes^our review game show doc game changers its conventional approach allows alex trebek interviewee^katherine heigl josh kelley welcomed third child^ryan seacrest kelly ripa new co host 'live^ryan seacrest kelly ripa new co host live^amy schumer hospitalized days week due horrible kidney infection amp wo n't attending^tony awards the complete list nominations^tony awards the complete list nominations^after years kermit frog getting new voice^superstore star america ferrera pregnant first child^superstore star america ferrera pregnant first child^sam smith announces new album the thrill it all details world tour^kim kardashian west shares first photo daughter chicago^pippa middleton sets wedding date everything know far^tee okurrr squirrel friends rupaul gives stephen colbert lesson drag race vocabulary^get jealous nick jonas priyanka chopra reportedly engaged getty images^katy perry host mtv video music awards^katy perry host mtv video music awards^actress michelle williams reportedly engaged financier andrew youmans^months going public relationship katharine mcphee record mogul david foster engaged^first look fox new series 'glee tv scribe producer ryan murphy nip tuck popular created ne..^abc freeform air ariana grande manchester benefit concert u.s. audiences^abc freeform air ariana grande manchester benefit concert u.s. audiences^corinne olympios bachelor paradise scandal i really victim media^kylie jenner pregnant according reports^ben affleck jennifer garner officially file divorce without lawyers nearly two years split^ben affleck jennifer garner officially file divorce nearly two years split^joe scarborough mika brzezinski co hosts 'morning joe engaged^joe scarborough mika brzezinski co hosts morning joe engaged,15,27,12,42,0.35714285714285715,0.2857142857142857,0
19098792,KETV,3241,152149,1032,258763,3,4,12,23,omaha favorite source local news weather sports,"melania trump undergoes kidney surgery walter reed medical center^people found dead ohio^people found dead ohio^video chinh doan reports democratic response presidential debate^most popular baby names every u.s. state^us slaps 50 billion tariffs chinese goods escalating trade dispute^us slaps 50 billion tariffs chinese goods escalating trade dispute^what roseanne barr net worth^megyn kelly weighs matt lauer fired 'today show^icymi david cassidy fighting memory loss wants 'enjoy life^david cassidy fighting memory loss wants 'enjoy life^david cassidy fighting memory loss wants 'enjoy life^tonya harding made 'dancing with stars finale fans livid^tonya harding made 'dancing with stars finale fans livid^tonya harding made 'dancing with stars finale fans livid^george clooney makes 27,283 every hour thanks tequila^mariah carey new year eve performance 'they foiled^'free speech rally 'fight supremacy groups set converge boston common^caitlyn jenner latest celebrity float run office^koko gorilla knew sign language dies^koko gorilla knew sign language dies^james franco event canceled actor denies allegations sexual misconduct^playboy founder hugh hefner cause death revealed^playboy found hugh hefner cause death revealed^playboy founder hugh hefner cause death revealed^mindy kaling reportedly pregnant first child^mindy kaling reportedly pregnant first child^mindy kaling reportedly pregnant first child^'clueless actress stacey dash running congress california^'clueless actress stacey dash running congress california^kaley cuoco marries karl cook intimate horse ranch wedding^kaley cuoco marries karl cook intimate horse ranch wedding^kaley cuoco marries karl cook intimate horse ranch wedding^discovery channel 'storm chasers star joel taylor dead^discovery channel 'storm chasers star joel taylor dead^discovery channel 'storm chasers star joel taylor dead^billboard music awards check complete list winners^billboard music awards check complete list winners^reese witherspoon confirms 'legally blonde happening^reese witherspoon confirms 'legally blonde happening^april giraffe pregnant^april giraffe pregnant",15,27,12,42,0.35714285714285715,0.2857142857142857,0
22208192,HuffPostEnt,850,134026,3089,121927,1,0,17,24,movies tv shows celebrity news music comedy sports arts culture need help huffpost login membership tweet,miley cyrus calls donald trump f**king nightmare^gwen stefani perfectly mocks blake shelton split rumors^gwen stefani perfectly mocks blake shelton split rumors^sarah jessica parker says ellen play samantha sex city^britney spears terrified fan rushes onstage vegas show^the keeping up with kardashians star reveals app moniker family name kr^the keeping up with kardashians star reveals app moniker family name kr^jimmy fallon made fun president caught crosshairs one latest twitter tirades^jennifer garner denounces people magazine cover story divorce^melissa joan hart republicans hollywood these days i find^kylie jenner reveals hair destroyed^kylie jenner reveals hair destroyed^chrissy teigen complaint john legend marriage summed one tweet^british media say diss liam payne singing^matthew perry case mistaken identity^miley cyrus plan leave country era trump^selena gomez makes instagram official super cool justin bieber^kourtney kardashian scott disick never getting back together like ever^anna kournikova enrique iglesias welcome twins secret^styles announces world tour dates^will smith jada pinkett smith married years n't like call marr^dance moms star abby lee miller sentenced one year prison fraud^blake lively injured set the rhythm section halting production^sara gilbert opens roseanne cancellation it sad see end way i sad people who^portia de rossi says steven seagal unzipped pants audition^teen mom catelynn lowell heading home treatment suicidal thoughts^annabelle neilson ladies london star muse alexander mcqueen found dead^long island medium theresa caputo husband larry split^'aquaman trailer makes big splash comic con think wet^julia louis dreyfus kidding comes lucky diagnosed breast ca^julia louis dreyfus kidding comes lucky diagnosed breast ca^joel taylor star discovery channel torm chasers dead^mtv road rules star danny dias dead^beyhive rips taylor swift music video director saying beyonc copied bad blood^jennifer hudson set join the voice coach season^fergie josh duhamel split years marriage^your first look ryan murphy scream queens^katie couric said matt lauer pinches ass lot^meryl streep joins hbo big little lies season^richard simmons hospitalized severe indigestion^shia labeouf arrested disorderly conduct public drunkenness^actor ving rhames says police officers held gunpoint home santa monica neighbors r,18,24,6,42,0.42857142857142855,0.14285714285714285,0
22214972,WPBF25News,441,120500,885,213508,2,2,16,22,wpbf news no source news weather coverage palm beaches treasure coast,"people found dead ohio^people found dead ohio^most popular baby names every u.s. state^us slaps 50 billion tariffs chinese goods escalating trade dispute^what roseanne barr net worth^what roseanne barr net worth^what roseanne barr net worth^what roseanne barr net worth^megyn kelly weighs matt lauer fired 'today show^megyn kelly weighs matt lauer fired 'today show^david cassidy fighting memory loss wants 'enjoy life^david cassidy fighting memory loss wants 'enjoy life^icymi david cassidy fighting memory loss wants 'enjoy life^tonya harding made 'dancing with stars finale fans livid^tonya harding made 'dancing with stars finale fans livid^tonya harding made 'dancing with stars finale fans livid^george clooney makes 27,283 every hour thanks tequila^mariah carey new year eve performance 'they foiled^'free speech rally 'fight supremacy groups set converge boston common^caitlyn jenner latest celebrity float run office^james franco event canceled actor denies allegations sexual misconduct^playboy founder hugh hefner cause death revealed^playboy founder hugh hefner cause death revealed^playboy founder hugh hefner cause death revealed^playboy founder hugh hefner cause death revealed^mindy kaling reportedly pregnant first child^mindy kaling reportedly pregnant first child^mindy kaling reportedly pregnant first child^'clueless actress stacey dash running congress california^'clueless actress stacey dash running congress california^'clueless actress stacey dash running congress california^'clueless actress stacey dash running congress california^kaley cuoco marries karl cook intimate horse ranch wedding^kaley cuoco marries karl cook intimate horse ranch wedding^discovery channel 'storm chasers star joel taylor dead^discovery channel 'storm chasers star joel taylor dead^discovery channel 'storm chasers star joel taylor dead^discovery channel 'storm chasers star joel taylor dead^billboard music awards check complete list winners^billboard music awards check complete list winners^reese witherspoon confirms 'legally blonde happening^april giraffe pregnant",18,24,6,42,0.42857142857142855,0.14285714285714285,0
34243239,Lookmagazine,2353,182645,1250,190453,0,0,27,15,britain best-selling fashion weekly snapchat lookmagazineuk,why kate middleton left hospital just hours after giving birth^we may know real reason behind jennifer aniston justin theroux split^we may know real reason behind jennifer aniston justin theroux split^is this the real reason why jennifer aniston and justin theroux split^we may know real reason behind jennifer aniston justin theroux split^we may know real reason behind jennifer aniston justin theroux split^we may know real reason behind jennifer aniston justin theroux split^we may know real reason behind jennifer aniston justin theroux split^will drake heartbroken hears apparently hooking ...^will drake heartbroken hears apparently hooking ...^will drake heartbroken hears apparently hooking ...^will drake heartbroken hears apparently hooking ...^*shock* new details angelina jolie brad pitt divorce papers released ...^*shock* new details angelina jolie brad pitt divorce papers released ...^*shock* new details angelina jolie brad pitt divorce papers released ...^*shock* new details angelina jolie brad pitt divorce papers released ...^is there trouble in paradise for prince harry and meghan markle^*shock* new details angelina jolie brad pitt divorce papers released ...^*shock* new details angelina jolie brad pitt divorce papers released ...^*shock* new details angelina jolie brad pitt divorce papers released ...^*shock* new details angelina jolie brad pitt divorce papers released ...^angelina jolie reportedly new man very different brad pitt^after brad pitt split angelina jolie reportedly has a new man in her life^angelina jolie reportedly new man very different brad pitt^margot robbie is torn between her career and husband tom ackerley^um heidi klum bikini body fit fit fit words ...^um heidi klum bikini body fit fit fit words ...^we may know real reason behind jennifer aniston justin theroux split^we may know real reason behind jennifer aniston justin theroux split^we may know real reason behind jennifer aniston justin theroux split^we may know real reason behind jennifer aniston justin theroux split^we may know real reason behind jennifer aniston justin theroux split^we may know real reason behind jennifer aniston justin theroux split^meghan markle may upset part pippa middleton wedding ...^meghan markle may upset part pippa middleton wedding ...^meghan markle may upset part pippa middleton wedding ...^meghan markle may upset part pippa middleton wedding ...^meghan markle may upset part pippa middleton wedding ...^meghan markle may upset part pippa middleton wedding ...^meghan markle may upset part pippa middleton wedding ...^tom daley and dustin lance black announce they eecting their first child^jennifer aniston has seemed fine since split justin theroux,27,15,-12,42,0.6428571428571429,-0.2857142857142857,1
32466494,1061KISSFMDFW,735,40611,392,116821,0,0,29,13,dallas-ft. worth hit music station thanks home the kidd kraddick morning show,teen choice awards nominations first wave of nominees full list^john mayer has been hospitalized emergency appendectomy^karrueche tran granted five year restraining order against chris brown^sharon osbourne apologizes to justin bieber 'i was wrong to 'attack you^celebrities react nelsan ellis dead at^beyonce not demanding silent delivery room despite report^selena gomez vogue cover story see interview highlights^lady gaga taylor kinney not secretly dating despite late and wrong report^kristen stewart on dating robert pattinson 'the public were the enemy^kim kardashian not attending paris fashion week despite claims^halle berry not pregnant at despite reports^watch kim kardashian first interview since robbery on 'ellen degeneres show videos^hailee steinfeld responds to justin bieber dating rumors^robert pattinson amp katy perry are not dating^beyonce birth twins still hospital 'minor issue^beyonce birth twins still hospital 'minor issue^karrueche tran granted five year restraining order against chris brown^tony awards nominations see full tonys nominees list^chloe grace moretz apologizes for 'red shoes marketing^is demi lovato upset about meghan trainor performing the 'smurfs movie song^justin bieber did not attend vanity fair oscars after party^are mariah carey amp joe jonas feuding^chris brown urges fans to donate to year old boy 'new legs gofundme^iggy azalea blasts nick young after accidental dinner reunion^justin bieber amp hailey baldwin a timeline their relationship^chris soules 'devastated after killing kenny mosher in fatal accident^mariah carey not dating both nick cannon and bryan tanaka despite report^mariah carey not dating both nick cannon and bryan tanaka despite report^michael strahan 'looking forward to working with alex rodriguez at abc^harry styles announces intimate world tour see the dates^'dance moms abby lee miller sentenced to one year in prison^alex rodriguez year old daughter sings for jennifer lopez photos^justin timberlake announces 'the man of the woods tour see the dates^charlie puth says his selena gomez fling messed him up^watch harry styles kiss james corden in christmas themed 'carpool karaoke^kelly clarkson reveals secret behind her pound weight loss^meghan markle approves of priyanka chopra nick jonas engagement^billboard music awards nominations see full list of bbmas nominees^billboard music awards nominations see full list of bbmas nominees^camila cabello announces her 'never be the same tour see the dates^gigi hadid slams body shamers for calling her 'too skinny at nyfw^miley cyrus defends selena gomez after stefano gabbana calls her 'ugly,29,13,-16,42,0.6904761904761905,-0.3809523809523809,1
16664681,latimes,6924,3437293,32051,243639,0,14,11,16,bringing l.a. world world l.a subscribe,after steadily declining two decades deadly shootings rising across country according a^in interview fox news sunday trump also said decided skip listening vicious terri^in weekly gop address donald trump calls help electing republican majority congress^federal election commission cites five california candidates filing report^transcript the important exchanges presidential debate^transcript here important exchanges last night presidential debate^transcript the nasty horrifying interesting parts last night presidential debate annotated^transcript we annotated important parts last night vice presidential debate^transcript the important exchanges vice presidential debate^transcript these important exchanges vice presidential debate^after steadily declining two decades deadly shootings rising across country according a^the u.s. department agriculture said unit brazil jbs recalling total millio^republican rep. jeff denham lost lead democrat josh harder one california four unresolved cong^record imports drove u.s. trade deficit third straight month august the deficit trade of^blac chyna wo n't trademarking angela kardashian name^good riddance celebrities react death murderous cult leader charles manson^the nominations golden globes revealed morning here complete list nominees^a landlord longer vince vaughn deals income property hollywood hills west^channing tatum wife jenna dewan tatum announce nicest separation ever years marriage love^grammys the complete list winners nominees^prince william catherine duchess cambridge christened third born child prince louis monday the^britain prince william catherine duchess cambridge christened third born child prince louis m^prince william catherine duchess cambridge christened third born child prince louis monday the^britain prince william catherine duchess cambridge christened third born child prince louis m^a star is born richard gere turns today^koko gorilla whose sign language abilities changed view animal intelligence dies^ryan seacrest kelly ripa new co host 'live^neil diamond retires touring parkinson disease diagnosis^pro golfer bill haas actor luke wilson involved fatal car crash involving ferrari pacific palisade^donald trump star hollywood walk fame vandalized^emmys laura dern wins supporting actress limited series big little lies^after years kermit frog getting new voice^kim kardashian west shares first photo daughter chicago^pippa middleton wedding date set here everything know far^rupaul gives stephen colbert lesson drag race vocabulary^conservative commentator clueless star stacey dash running congress california^actress michelle williams reportedly engaged financier andrew youmans^corinne olympios bachelor paradise scandal i really victim media^kylie jenner pregnant according reports^ben affleck jennifer garner officially file divorce nearly two years split^co hosts morning joe joe scarborough mika brzezinski engaged,11,30,19,41,0.2682926829268293,0.4634146341463415,0
15535860,nbcsandiego,4329,238898,2876,190081,3,13,13,12,breaking news exclusive stories weather conversation,dignitaries family paid tribute late former president george h.w bush died late friday home^dignitaries family paid tribute late former president george h.w bush died late friday home^dignitaries family paid tribute late former president george h.w bush died late friday home^a salmonella outbreak linked live poultry sickened people states centers disease control and^the fda centers disease control prevention cautioned people eat romaine lettuce t^salmonella raw chicken made people sick across states centers disease control preventio^the u.s. food drug administration centers disease control prevention investigating multi^the u.s. food drug administration centers disease control prevention investigating multi^a salmonella outbreak sickened people states linked backyard chickens cente^each year united states women die result pregnancy delivery issues according c^president donald trump growing increasingly irritated lawyer rudy giuliani frequently message media b^the u.s. department education said thursday cancelling 150 million students loans connected pro^watch live pres trump speaks national federation independent business th anniversary celebration c^the fda centers disease control prevention cautioned people eat romaine lettuce t^salmonella raw chicken made people sick across states centers disease control preventio^a salmonella outbreak sickened people states linked backyard chickens cente^president trump defends beautiful confederate statues^katie couric matt lauer today co host several years broke silence saturday sexual miscondu^katie couric matt lauer today co host several years broke silence saturday sexual miscondu^a royal baby way the duchess sussex meghan markle prince harry eecting first child^a royal baby way the duchess sussex meghan markle prince harry eecting first child^shots fired set tekashi ix9ine kanye west upcoming video^we 've talking morning newsroom think britain prince william catherine^we name prince william catherine duchess cambridge named third child details fi^we 've talking morning newsroom think britain prince william catherine^we name prince william catherine duchess cambridge named third child details fi^angelina jolie brad pitt headed court early next month estranged movie stars battle ov^in case missed relive sweetest touching moments royalwedding prince harry^in case missed relive sweetest touching moments royalwedding prince harry^chrissy teigen kristen bell offer pay olympic gymnast mckayla maroney 100k fine breaking nda testi^host alex trebek recovering surgery remove blood clots brain suspended th^an emotional moment jury found bill cosby guilty counts sexual assault retrial women came o^an emotional moment jury found bill cosby guilty counts sexual assault retrial women came o^arie luyendyk jr. loss america gain it official becca kufrin next star the bachelorette^the discovery channel reality series storm chasers star joel taylor dead age^the discovery channel reality series storm chasers star joel taylor dead age^kanye west mysteriously deletes twitter instagram accounts^kylie jenner youngest woman forbes list america richest self made women earning spot the^how cardi b stylist hid baby bump months^it family affair britain royal officials say prince harry asked elder brother prince william bes^kylie jenner pregnant according reports,16,25,9,41,0.3902439024390244,0.2195121951219512,0
222880091,HITS961,5434,19553,300,92628,0,0,22,19,we charlotte home all the hits listen anytime,robert pattinson on movie roles 'people are trying to put you in a box^john mayer has been hospitalized emergency appendectomy^chris pratt files divorce from anna faris^sharon osbourne apologizes to justin bieber 'i was wrong to 'attack you^celebrities react nelsan ellis dead at^celebrity reactions donald trump phoenix rally speech^kendall jenner jealous ex^no drake is n't 'lusting after rihanna despite new rumors^taylor swift wins countersuit against dj david mueller in groping trial^sorry drake amp bella hadid are not 'secretly dating^kim kardashian sued for allegedly stealing lighting technique for selfies^ryan lochte charge dropped in rio robbery case^kim kardashian slams cocaine claim 'i do not play with rumors like this^robert pattinson amp katy perry are not dating^justin bieber fan arrested trespassing at singer beverly hills home^meghan markle twins with kate middleton during outing with queen^joe jonas sophie turner 'already thinking of having kids is made up story^chris brown urges fans to donate to year old boy 'new legs gofundme^iggy azalea blasts nick young after accidental dinner reunion^jimmy fallon felt need to share 'heartfelt message about charlottesville^no zayn is not 'desperate to defend girlfriend gigi hadid^selena gomez reveals she had a kidney transplant amp her friend was her donor^ed sheeran is engaged longtime girlfriend cherry seaborn^ed sheeran engaged to girlfriend cherry seaborn^million dollar listing fredrik eklund derek welcome twins^taylor swift teases new song 'gorgeous on instagram listen to a snippet^bachelor nick viall vanessa grimaldi split end engagement^bachelor nick viall vanessa grimaldi split end engagement^rachel mcadams is reportedly pregnant with her first child^demi lovato reveals that she contemplated suicide at age^'happy days star erin moran dead at^taylor swift teases new song 'gorgeous on instagram listen to a snippet^justin timberlake announces 'the man of the woods tour see the dates^here what hocus pocus thackery binx looks like now^kim kardashian shares first photo baby chicago west^bachelorette peter kraus reveals he suffered eating disorder^watch harry styles kiss james corden in christmas themed 'carpool karaoke^jennifer lawrence darren aronofsky split^camila cabello announces her 'never be the same tour see the dates^demi lovato announces tour with dj khaled see the dates^chris pratt files divorce from anna faris,22,19,-3,41,0.5365853658536586,-0.07317073170731707,1
133027929,B2Community,3317,82053,4666,210026,12,0,26,3,our open community contributors covers breaking news top trends social media digital marketing content marketing social selling more,texas church shooter being identified as an atheist on the dnc payroll is fake news^malia obama eelled from harvard for drug violation with marijuana is fake news^st. lucian morgue employee cremated by mistake while taking a nap on a stretcher is fake^florida passing bill legalizing recreational use of marijuana is fake news^roy moore accuser arrested and charged with falsification of sexual misconduct claim is^nancy pelosi to resign after new revelations of sexual harassment is fake news^snapchat shutting down by end is a viral hoax^robert mueller being forced to resign over affair with nancy pelosi is fake news^malia obama gang thugs arrested in chicago drugs dogfighting is fake news^pope francis saying jesus is metaphorical not literal during mass is a fake quote^hillary clinton killed in monster truck mishap at chappaqua motor speedway is fake news^donald trump wins international man of the year award barack obama never could is fake news^dancing stars social media reacts vanessa lachey maks chmerkovskiy s^dancing stars vanessa lachey maks chmerkovskiy dance smash inspired^dancing stars vanessa lachey maks chmerkovskiy dance empowering cha cha to^dancing stars vanessa lachey maks chmerkovskiy dance elegant foxtrot hit^dancing stars vanessa lachey maks chmerkovskiy dance spicy salsa to^dancing stars vanessa lachey maks chmerkovskiy dance zombie themed paso doble^dancing stars vanessa lachey maks chmerkovskiy dance charming waltz un^dancing stars vanessa lachey maks chmerkovskiy dance affecting rumba to^kim kardashian defends kylie jenner new lips^macaulay culkin claiming satanic hollywood executives ritually murder child actors is^macaulay culkin saying satanic hollywood executives wear shoes made from dead children is^angelina jolie and jennifer aniston having a golden globes after party showdown is fake^meghan markle wild past being erased by mi5 agents ahead of marriage to prince harry is^queen elizabeth ii giving michelle obama royal beatdown over failed attempt get^jim carrey claiming illuminati brainwashing children worshipping satan is^jim carrey claiming illuminati is brainwashing children worshipping satan is^miley cyrus telling fans worship satan if they want be successful in music^luke bryan officiating blake shelton gwen stefani summer wedding is fake news^trevor noah being shot dead while greeting fans after a concert is a celebrity death hoax^kim kardashian west surrogate not invited to family christmas party is fake news^u2 bono saying donald trump is destroying america we must stop him is fake news^kim kardashian kanye west struggling over second pregnancy^kevin bacon saying we are blessed to have donald trump as our president is fake news^matt damon in hiding following sexual misconduct comments about harvey weinstein is false^alex rodriguez picking out million engagement ring for jennifer lopez is fake news^ellen degeneres being labeled as boss from hell is fake news^selena gomez justin bieber are good terms but not back together just yet^dancing stars jordan fisher lindsay arnold win season mirrorball trophy^donald trump mocks low oscar ratings we don have stars anymore except your president,38,3,-35,41,0.9268292682926829,-0.8536585365853658,1
15922892,4029news,979,67092,673,247056,3,4,9,24,breaking news weather northwest arkansas river valley news,"melania trump undergoes kidney surgery walter reed medical center^people found dead ohio^people found dead ohio^most popular baby names every u.s. state^president obama deliver statement iran :15 ct rose garden breaking^many questions today white house press briefing pres trump response question ab^us slaps 50 billion tariffs chinese goods escalating trade dispute^what roseanne barr net worth^david cassidy fighting memory loss wants 'enjoy life^tonya harding made 'dancing with stars finale fans livid^tonya harding made 'dancing with stars finale fans livid^george clooney makes 27,283 every hour thanks tequila^mariah carey new year eve performance 'they foiled^rapper travis scott pleads guilty disorderly conduct^caitlyn jenner latest celebrity float run office^brad pitt plans to quit acting in years actor brad pitt says plans stop acting three years he ...^koko gorilla knew sign language dies^koko gorilla knew sign language dies^james franco event canceled actor denies allegations sexual misconduct^april giraffe gives birth baby front million people^playboy founder hugh hefner cause death revealed^playboy founder hugh hefner cause death revealed^playboy founder hugh hefner cause death revealed^playboy founder hugh hefner cause death revealed^mindy kaling reportedly pregnant first child^mindy kaling reportedly pregnant first child^'clueless actress stacey dash running congress california^'clueless actress stacey dash running congress california^'clueless actress stacey dash running congress california^'clueless actress stacey dash running congress california^kaley cuoco marries karl cook intimate horse ranch wedding^discovery channel 'storm chasers star joel taylor dead^discovery channel 'storm chasers star joel taylor dead^discovery channel 'storm chasers star joel taylor dead^discovery channel 'storm chasers star joel taylor dead^billboard music awards check complete list winners^billboard music awards check complete list winners^netflix is reportedly reviving carmen sandiego with gina rodriguez^reese witherspoon confirms 'legally blonde happening^april giraffe pregnant",12,28,16,40,0.3,0.4,0
17781837,WJCLNews,764,28785,462,164721,0,5,12,23,news sports weather entertainment coastal georgia south carolina news tips photos videos share news.com,"most popular baby names every u.s. state^most popular baby names every u.s. state^most popular baby names every u.s. state^most popular baby names every u.s. state^us slaps 50 billion tariffs chinese goods escalating trade dispute^what roseanne barr net worth^megyn kelly weighs matt lauer fired 'today show^megyn kelly weighs matt lauer fired 'today show^david cassidy fighting memory loss wants 'enjoy life^david cassidy fighting memory loss wants 'enjoy life^icymi david cassidy fighting memory loss wants 'enjoy life^tonya harding made 'dancing with stars finale fans livid^george clooney makes 27,283 every hour thanks tequila^mariah carey new year eve performance 'they foiled^mariah carey new year eve performance 'they foiled^'free speech rally 'fight supremacy groups set converge boston common^caitlyn jenner latest celebrity float run office^james franco event canceled actor denies allegations sexual misconduct^playboy found hugh hefner cause death revealed^playboy founder hugh hefner cause death revealed^playboy founder hugh hefner cause death revealed^mindy kaling reportedly pregnant first child^mindy kaling reportedly pregnant first child^mindy kaling reportedly pregnant first child^'clueless actress stacey dash running congress california^'clueless actress stacey dash running congress california^'clueless actress stacey dash running congress california^kaley cuoco marries karl cook intimate horse ranch wedding^kaley cuoco marries karl cook intimate horse ranch wedding^discovery channel 'storm chasers star joel taylor dead^discovery channel 'storm chasers star joel taylor dead^discovery channel 'storm chasers star joel taylor dead^discovery channel 'storm chasers star joel taylor dead^billboard music awards check complete list winners^billboard music awards check complete list winners^netflix is reportedly reviving carmen sandiego with gina rodriguez^netflix is reportedly reviving carmen sandiego with gina rodriguez^reese witherspoon confirms 'legally blonde happening^april giraffe pregnant^april giraffe pregnant",12,28,16,40,0.3,0.4,0
14511951,HuffPost,5699,11471219,84417,544043,1,12,13,14,know real need help huffpost login membership tweet,miley cyrus calls donald trump f**king nightmare^sarah palin cpac speech might well next dr. seuss book^now face much stiffer test upsetting republican gov larry hogan public opinion polls indicate one^amid national debate civility politics republican national committee attacking left new^fox amp friends even sent pruitt team script ahead interview show^i n't know matt whitaker trump told reporters friday but kellyanne conway told fox news su^i n't know matt whitaker trump told reporters friday but kellyanne conway told fox news su^brad listi obama vs. mccain preview live blogging third presidential debate ** los angeles ..^these popular baby names state last year^these popular baby names state last year^richard kirsch ten things know john mccains health care plan mccain ta..^rudy giuliani baffled fox news hosts attempted clarify comments made cnn earlier day about^the daily briefing got heated reporters challenged sarah huckabee sanders white house positions fr^olympians johnny g. weir tara lipinski got formation comedian leslie jones winter olympics t^gwen stefani perfectly mocks blake shelton split rumors^jessica simpson tweets photo baby bump^jessica simpson baby bump fully blossomed^bette midler pretty excited hillary clinton showed watch hello dolly broadway^britney spears terrified fan rushes onstage vegas show^who katie holmes mystery man^who katie holmes 'mystery man^kylie jenner reveals hair destroyed^katy perry appeared take shot taylor swift forever feud american idol^john mayer jennifer aniston back together^gayle king says oprah intrigued idea running president^katy perry appeared take shot taylor swift forever feud american idol^anna kournikova enrique iglesias welcome twins secret^will smith jada pinkett smith married years n't like call marr^anthony weiner sentenced months prison sexting minor^sara gilbert opens roseanne cancellation it sad see end way i sad people who^portia de rossi says steven seagal unzipped pants audition^annabelle neilson ladies london star muse alexander mcqueen found dead^beyhive rips taylor swift music video director saying beyonc copied bad blood^katie couric said matt lauer pinches ass lot^meryl streep joins hbo big little lies season^richard simmons hospitalized severe indigestion^weinstein company file bankruptcy collapse last ditch sale talks^shia labeouf arrested disorderly conduct public drunkenness^actor ving rhames says police officers held gunpoint home santa monica neighbors r^'morning joe co hosts joe scarborough mika brzezinski get engaged,14,26,12,40,0.35,0.3,0
9651842,CBS21NEWS,1085,63260,729,246211,1,23,8,7,your station news sports weather central pennsylvania,update people found dead ohio town^the u.s. energy information administration forecasts percent increase spending heating oil mod^the energy information administration said thursday u.s. produced million barrels day in^the centers disease control prevention cdc named fentanyl america deadliest drug according a^on average people die nationally day opioid overdoses according centers disea^the life eectancy u.s. declined slightly last year according new data centers disease con^centers disease control prevention officials investigating multi state outbreak salmonella linked^trump wide ranging interview aired fox news sunday praised kelly work ethic much he^i know i know character pence said taped interview aired sunday cbs face nation^the u.s. energy information administration forecasts percent increase spending heating oil mod^the energy information administration said thursday u.s. produced million barrels day in^today join yourvoiceyourfuture discussion president trump st address joint session congress pm^take look president trump concluded speech tuesday washington dc he speaking t^trump wide ranging interview aired fox news sunday praised kelly work ethic much he^the centers disease control prevention cdc named fentanyl america deadliest drug according a^on average people die nationally day opioid overdoses according centers disea^a new report centers disease control prevention finds diseases mosquitos ticks fleas are^the life eectancy u.s. declined slightly last year according new data centers disease con^the u.s. energy information administration forecasts percent increase spending heating oil mod^the energy information administration said thursday u.s. produced million barrels day in^mrs. trump join president briefing fema headquarters wednesday first appearance outside the^much credibility discussion hinge rapid movement implementation chinese commitme^hosting thanksgiving year the u.s. department agriculture tips prepare safe thanksgiv^hosting thanksgiving year the u.s. department agriculture tips prepare safe thanksgiv^trump warns north korea 'fire fury attack guam threatened^report ryan phillippe 'devastated 'false allegations domestic violence^jennifer lopez introduces new boyfriend alex rodriguez mother^angelina jolie split brad pitt 'i n't enjoy single^meghan markle impending nuptials prince harry inspired royal hybrid strain cannabis developed by^mariah carey new year eve performance 'they foiled^mariah carey new year eve performance 'they foiled^former miss utah trump accuser holding press conference salt lake city^kensington palace says prince charles walk meghan markle aisle royal wedding^meghan markle dad reportedly wo n't attend royal wedding staging photos^former fox news ceo roger ailes dead^former fox news ceo roger ailes dead^richard simmons hospitalized severe indigestion^oscars the complete list nominations winners^reports kylie jenner pregnant,9,30,21,39,0.2307692307692308,0.5384615384615384,0
380648579,AFP,668,1662788,21062,209266,7,25,3,4,top news features afp reporters around world elsewhere twitter,nancy pelosi highest ranking woman history us politics easily elected wednesday lead cong^after bi partisan uproar 'forced ouster speaker ryan chaplain us house representative^are us citizen doj request put citizenship question census sparks row the census results will^a three term republican congressman conceded defeat thursday close race california giving democrats^breaking us house representatives passes spending bill ends government shutdown^president donald trump urged democrats wednesday put partisanship aside bluntly warned u^us president donald trump speaks reporters white house democrats win control house representati^amber hunters quest jurassic park style discovery dinosaur remains sift mounds preci^video 'amber hunters quest jurassic park style discovery dinosaur remains sift mounds th^a total people fallen ill states according us centers disease control prevention^afp graphic showing countries girls women undergone female genital mutilation whi^afp graphic former controversial cia interrogation techniques outlined memo released us justice depa^despite trump overwhelming presence us midterm election driven unprecedented democratic enthusiasm re^americans react fiery first us presidential debate republican candidate donald trump democra^hillary clinton donald trump clash first presidential debate hofstra university^despite trump overwhelming presence us midterm election driven unprecedented democratic enthusiasm re^americans react fiery first us presidential debate republican candidate donald trump democra^afp graphic showing countries girls women undergone female genital mutilation whi^in las vegas nevada womensmarch rally aimed start national campaign register voters increase support^video twenty five years visit pope john paul ii pope francis begins tour baltic countries s^twenty five years visit pope john paul ii pope francis begins tour baltic countries starting^video french president emmanuel macron meets pope francis vatican city named first only hono^sean spicer received poor reviews brief stint white house spokesman new memoir the briefing^two key us senators said briefing cia director zero doubt saudi arabia crown pr^us president donald trump holds briefing hurricane michael oval office white house^one person gored four others injured saturday first running bulls year san fermi^by inflicting tariffs steel aluminum allies tens billions dollars goods fro^update us escalates trade war china threatening fresh tariffs another 200bn chinese goods soon a^update china prime minister warns winners trade war hours new us tariffs chi^update china warns us deals reached ongoing trade talks void washington goes ahead^by inflicting tariffs steel aluminum allies tens billions dollars goods fro^the us economy may roaring ahead american consumers face prospect paying everyday goods du^prince william catherine duchess cambridge give world first look new son^prince william catherine duchess cambridge give world first look new son^andersen royal fans watch wedding britain prince harry duke sussex^update ivanka trump announced closing eponymous fashion brand following firestorm criticism^ed sheeran become engaged girlfriend cherry seaborn british singer songwriter announces^us popstar becomes first person reach million twitter followers lovekaty^queen elizabeth ii prince philip celebrate years marriage becoming britain first reigning couple m,10,29,19,39,0.2564102564102564,0.4871794871794872,0
11350892,TVGuide,3889,1084289,9198,105261,0,0,10,29,tv guide official page tv news recaps live event coverage ig,will challenge lip sobriety next season shameless^please please please n't let new character screw lip sobriety shameless^confused rules shapeshifting mythology theinnocents here elanation^katie couric finally speaks matt lauer today firing^katie couric finally responded matt lauer firing today this matt knew^thecrown found new prince charles queen mother season^will challenge lip sobriety next season shameless^please please please n't let new character screw lip sobriety shameless^men timeline kimye^report pregnant are surprised^colton haynes joins cast americanhorrorstory season^strangerthings officially renewed season^strangerthings officially renewed season^stranger things officially renewed season^abc renewed modern family sixth season^the walking dead promotes lauren cohan series regular season amc^the walking dead promotes chad coleman sonequa martin green series regular season amc^american horror story season everything know far ahs ahs8^will new called ahsradioactive everything know season far^thecrown casts outlander tobias menzies new prince philip replacing matt smith^everything know strangerthings season far^everything know strangerthings season far^everything know strangerthings season far^everything know strangerthings season far^who win gameofthrones based hair^who die next thewalkingdead^who next die thewalkingdead^the cw set fall premiere dates supergirl return theflash^young restless cleaned daytime emmy awards steve harvey see complete winners list^theoriginals end season^your first look ryan murphy^first look ryan murphy psychosexual thriller americanhorrorstory it glee^your first look ryan murphy^reasonswhy renewed season^netflix making murderer best bet binge watch holiday^here everything know reasonswhy season far^morningjoe co hosts joe scarborough mika brzezinski officially engaged^morningjoe co hosts officially engaged^pauley perrette leaving ncis seasons,10,29,19,39,0.2564102564102564,0.4871794871794872,0
769253749743169537,real983fm,814,863,10,11095,0,0,31,8,naptown new home hiphop n r b home most dangerous morning show thebreakfastclub linaj -3 dj louivee -7 tone -12 line -239-0983,amber rose i did not laugh at molestation victim^karrueche tran granted five year restraining order against chris brown^american music awards nominations amas nominees full list^celebrities react nelsan ellis dead at^jamie foxx katie holmes finally out public as couple^celebrities react trump withdraws steph curry white house invitation^beyonce not demanding silent delivery room despite report^are selena gomez amp the weeknd working on a movie together^celebrities react to hurricane irma^chris brown slammed by judge for skipping karrueche tran court hearing^did jennifer lopez 'like a comment dissing mariah carey^kanye west concerts on hold indefinitely^no drake is n't 'lusting after rihanna despite new rumors^kylie jenner is pregnant with travis scott baby^sorry drake amp bella hadid are not 'secretly dating^kim kardashian slams cocaine claim 'i do not play with rumors like this^halle berry not pregnant at despite reports^mariah carey amp french montana did not flirt in recording studio^watch kim kardashian first interview since robbery on 'ellen degeneres show videos^watch kim kardashian first interview since robbery on 'ellen degeneres show videos^beyonce birth twins still hospital 'minor issue^karrueche tran granted five year restraining order against chris brown^mary j. blige hacked did not write kendu isaacs hate tweet^chris brown urges fans to donate to year old boy 'new legs gofundme^celebrities react nfl players kneel lock arms during national anthem^iggy azalea blasts nick young after accidental dinner reunion^kanye west is not rebooting 'american idol^kanye west headed american idol^celebrities thank barack obama on last day as president^obamas celebrate th anniversary after false split stories^mariah carey not dating both nick cannon and bryan tanaka despite report^eminem calls out jada pinkett smith justin bieber amp more in new freestyle^madonna files emergency order to stop tupac shakur letter auction^tamar braxton files divorce from vincent herbert^nelly officially under criminal investigation sexual assault^alex rodriguez year old daughter sings for jennifer lopez photos^here the complete list of bet awards winners^billboard music awards nominations see full list of bbmas nominees^demi lovato announces tour with dj khaled see the dates,31,8,-23,39,0.7948717948717948,-0.5897435897435898,1
16807528,MTVUK,11430,2487173,4246,99766,0,0,32,7,the official twitter account mtv uk snapchat mtvuk,did jennifer aniston confront selena gomez relationship justin theroux gt gt gt^fights back tears opens kidney transplant first time gt gt gt^fights back tears opens kidney transplant first time gt gt gt^did jennifer aniston confront selena gomez relationship justin theroux gt gt gt^kim kardashian supposed 'irritated hot sister khloe crazy they look amaze^this apparently real reason behind latest split gt gt gt^so tristan thompson family vacay dreams baby true rn gt gt gt^oh wow amp look unreal raunchy shoot ...^so tristan thompson family vacay dreams baby true rn gt gt gt^liam hemsworth reportedly called wedding second time gt gt gt^miley cyrus liam hemsworth reportedly called wedding second time gt gt gt^baftas see full winners list gt gt^a definitive list best super bowl halftime show outfits ever warning may hurt eyes^winter n't going stop wearing itsy bitsy teeny weeny yellow bikini jealous^selena gomez praises justin bieber performance one love manchester concert^does prove already got married secret gt gt gt^baby bump steals show hits catwalk^left hella sexual comment instagram pic gt gt gt^umm amp reportedly cancelled bora bora honeymoon^mystery of katie holmes new man solved^says hair 'destroyed bleaching^fans n't thrilled radio greg james told take shower gt gt gt^yikes taylor swift fans n't thrilled radio greg james told take shower gt gt gt^baby bump steals show hits catwalk^rob kardashian reportedly suing blac chyna assault tried trangle iphone cable gt gt^confirmed know ... selfie obsession ridiculous^confirmed know ... selfie obsession ridiculous^selena gomez reveals kidney transplant summer thanked friend 'ultimate gift gt gt gt^understandably 'terrified hospitalisation earlier week gt gt gt^understandably 'terrified hospitalisation earlier week gt gt gt^jelena official shouted instagram birthday gt gt gt^does mean kendall jenner anwar hadid back gt gt gt^ryan reynolds reveals saved nephew life gt gt gt^it turns ryan reynolds real life hero reveals saved nephew life using cpr gt gt gt^meet new reasons why actors joining cast season hit show gt gt gt^is taylor swift ... ready for it joe alwyn harry styles someone else entirely^fangirls jennifer lawrence love kuwtk much us gt gt^fangirls jennifer lawrence love kuwtk much us gt gt gt^pregnant facing reports travis scott ended relationship gt gt gt,32,7,-25,39,0.8205128205128205,-0.6410256410256411,1
130771057,ToggleSG,93,49334,233,65023,0,0,33,6,toggle favourite place entertainment email enquiry.sg encounter technical difficulties,jennifer lawrence opens split director darren aronofsky^despite difficult split kris caitlyn jenner stayed cordial sake daughters.^khloe kardashian done first session trainer since giving birth daughter month ago^justin bieber said extremely upset following news selena gomez seeking treatment emo^fergie josh duhamel talking baby plans split^fergie josh duhamel thought another baby split^fergie josh duhamel split eight years marriage shocking fans family news.^kim kardashian west embarrassed kanye west recent pro trump rant^prince harry meghan duchess sussex named new pet pup oz^maroon frontman adam levine could taking year 'the voice^kylie jenner reportedly pregnant partner travis scott baby^brad pitt committed making marriage work n't know angelina already given it.^prince harry meghan duchess sussex named new pet pup oz^kristen stewart slams ex robert pattinson new romance fka twigs^the weeknd scrapped whole album wrote split selena gomez^chris pratt anna faris still living together following split^chris martin dakota johnson dating several sources told us weekly magazine^catherine duchess cambridge newborn son left hospital seven hours gave birth.^catherine duchess cambridge newborn son left hospital seven hours gave birth.^kylie jenner removes daughter pictures social media critics posted nasty comments tot.^emma stone ca n't even imagine life without ryan gosling^kourtney kardashian scott disick together always family^rachel weisz daniel craig welcomed baby girl^angelina jolie remaining focused healing family divorce battle brad pitt continues.^jennifer lopez confessed divorce marc anthony left completely devastated^jennifer aniston casually dating^jennifer aniston casually dating following split husband justin theroux^kanye west silenced speculation joining 'american idol^jennifer aniston made difficult decision divorce husband justin theroux incred^kim kardashian west terrified raising children around social media^brad pitt left completely devastated divorce^justin bieber said extremely upset following news selena gomez seeking treatment emo^justin bieber sympathetic selena gomez struggle seeks treatment emotional br^'gossip girl actor ed westwick accused sexual assault third woman^gigi hadid zayn malik reportedly giving things second chance much better place spe^jay z admits marriage beyonce n't totally built per cent truth^kate winslet leonardo dicaprio still quote 'titanic lines years released^lorde calls taylor swift dear friend amp clarifies earlier comments member star quad^beyonc eminem the weeknd confirmed headline coachella valley music arts festival,33,6,-27,39,0.8461538461538461,-0.6923076923076923,1
16834659,SkyNewsAust,15665,422430,4296,243609,2,35,1,0,sky news channels sky news win channels listen,us midterm elections the democrats favourites take back control house repre^us midterms from seems like thing tightening while looks though democrats^killoran banking royal commission it really things start getting high level scrutiny^anne aly every time terror attack call islamic leaders something every time islam^nz the fundamental thing n't want surprising partner head renegot^government considering scheme height weight kids would gathered teach t^boys boys pyjamas pulled peter alexander stores how controversial stateme^a possible hostage situation underway trader joe california the suspect crashed vehicle before^business leaders stressing needs greater economic^my health record the people system utility system more^joyce n't shut whole industry tiny minority sheep mistreated mor^withdrawing campaigning ahead longman election i think really signi^joyce says 'd love one day resume role deputy prime minister more^sudanese gang violence melbourne it much example sorts issues coun^joyce need get together come decisive package help nsw^lnp senate candidate susan mcdonald regional australia desperate bigger workforce more^business leaders nt crying migrant workers settle area more^my health record i think personal health records intimate personal information h^discusses likely see night patrol tonight tennant creek more^liberal mp the uluru statement set new direction debate constitutional recognition ho^killoran polling showing labor would rule election battles leader it al^company tax cuts the average person street see tax cuts tha^spoke children tennant creek alcohol affecting community more^mike sudanese gang violence melbourne simply saying there nothing see let move^polling showing labor would rule election battles leader is^my health record it really hard sort innovation health easy mou^lnp senate candidate susan mcdonald australians ick lefties talking gender fluidity liv^australia migration system could face overhaul scott morrison flagging government intention lowe^bourke street attack this game changer a lot victorians angry ha^tonight kennyonsunday the debate live erts budget commonwealth heads government meetin^murder eurydice din i 've felt fear understand debate but i also understan^liberal mp the uluru statement set new direction debate constitutional recognition ho^peta credlin there lot sideshows week malcolm turnbull taayer funded bali trip went^i think colleagues want get involved privacy joyce personal life wh^john howard says optimistic liberal party prospects that comment like shot of^john howard says optimistic liberal party prospects the liberals make hash o^breheny wentworth campaign the strongest campaign move past days j^the sun newspaper editors wo n't know put front page meghan harry image,3,35,32,38,0.07894736842105263,0.8421052631578947,0
67653749,wsbradio,201,43045,828,314868,0,27,3,8,wsb atlanta news talk,"nearly million americans living hepatitis c according centers disease control prevent^suicide rates among american workers according new report centers disease control pr^a panel eerts put together centers disease control prevention atlanta look into^there confirmed reports acute flaccid myelitis afm illness similar polio across state^new numbers centers disease control prevention wonder database shows gun related deaths rea^the centers disease control prevention issued food safety alert days thanksgiving ha^the centers disease control prevention investigating multistate infestation asian longhorned ticks^the atlanta based centers disease control prevention reports number people investigation a^senate seats house seats gubernatorial races ,000 state local races decided^the 'war poverty years later the winners losers the herman cain show :00 am news wsb^here transcript third presidential debate^our workers cheated companies cheated president said speech vfw conventio^president trump nfl players kneel 'maybe country more interview with^nearly million americans living hepatitis c according centers disease control prevent^suicide rates among american workers according new report centers disease control pr^a panel eerts put together centers disease control prevention atlanta look into^america witnessing troubling increase deaths among children teens according new mortality rep^there confirmed reports acute flaccid myelitis afm illness similar polio across state^a salmonella outbreak five midwestern states linked pre cut melon sold walmart kroger sto^new numbers centers disease control prevention wonder database shows gun related deaths rea^between october may children died flu according new numbers released friday centers^the centers disease control prevention issued food safety alert days thanksgiving ha^the centers disease control prevention investigating multistate infestation asian longhorned ticks^the atlanta based centers disease control prevention reports number people investigation a^what know victims chicago mercy hospital shooting^a recall jimmy dean frozen pork poultry sausage issued u.s. department agriculture^trade war growing us amp china trump administration threatens additional 200b tariffs goods import^latest trump warns north korea 'fire fury nuke threat worsens^angelina jolie brad pitt say keep details divorce confidential using private judge^angelina jolie brad pitt say keep details divorce confidential using private judge^photos miss north dakota cara mund crowned miss america^matt damon apologizes comments sexual misconduct^'superman star margot kidder dead^meghan markle confirms dad attend royal wedding^video celine dion donates concert proceeds victims las vegas shooting^man inspired als ice bucket challenge dead^kylie jenner pregnant according reports^ncis fan favorite pauley perrette leaving show seasons",3,35,32,38,0.07894736842105263,0.8421052631578947,0
15164565,Slate,655,1786288,32752,419881,0,7,4,27,a daily magazine web,macron speech congress rousing rebuke trump foreign policy^macron speech congress rousing rebuke trump foreign policy^macron speech congress rousing rebuke trump foreign policy^the popular baby names state map^multiple victims reported gunman opens fire mass shooting chicago mercy hospital^multiple victims reported gunman opens fire mass shooting chicago mercy hospital^multiple victims reported gunman opens fire mass shooting chicago mercy hospital^the new dragon tattoo movie reduces lisbeth salander goth james bond^the new dragon tattoo movie reduces lisbeth salander goth james bond^hoda kotb permanently replace matt lauer nbc today^hoda kotb permanently replace matt lauer nbc today^jada pinkett smith calls all eyez me depiction friendship tupac deeply hurtful^jada pinkett smith calls all eyez me depiction friendship tupac deeply hurtful^jada pinkett smith calls all eyez me depiction friendship tupac deeply hurtful^jada pinkett smith calls all eyez me depiction friendship w/tupac deeply hurtful^jada pinkett smith calls all eyez me depiction friendship tupac deeply hurtful^jada pinkett smith calls all eyez me depiction friendship tupac deeply hurtful^jada pinkett smith calls all eyez me depiction friendship tupac deeply hurtful^jada pinkett smith calls all eyez me depiction friendship tupac deeply hurtful^jada pinkett smith calls all eyez me depiction friendship tupac deeply hurtful^jada pinkett smith calls all eyez me depiction friendship tupac deeply hurtful^jada pinkett smith calls all eyez me depiction friendship tupac deeply hurtful^jada pinkett smith calls all eyez me depiction friendship tupac deeply hurtful^jada pinkett smith calls all eyez me depiction friendship tupac deeply hurtful^jada pinkett smith calls all eyez me depiction friendship tupac deeply hurtful^jada pinkett smith calls all eyez me depiction friendship tupac deeply hurtful^jada pinkett smith calls all eyez me depiction friendship tupac deeply hurtful^jada pinkett smith calls all eyez me depiction friendship tupac deeply hurtful^jada pinkett smith calls all eyez me depiction friendship tupac deeply hurtful^april giraffe finally gives birth one million watch^julia louis dreyfus awarded mark twain prize american humor^harvey weinstein bad person late night hosts react sexual harassment allegations.^harvey weinstein bad person late night hosts react sexual harassment allegations.^harvey weinstein bad person late night hosts react sexual harassment allegations.^harvey weinstein bad person late night hosts react sexual harassment allegations.^harvey weinstein bad person late night hosts react sexual harassment allegations.^harvey weinstein bad person late night hosts react sexual harassment allegations.^harvey weinstein bad person late night hosts react sexual harassment allegations.,4,34,30,38,0.10526315789473684,0.7894736842105263,0
14185814,KGWNews,1235,224307,2391,213992,0,3,5,30,breaking news weather entertainment information portland area nbc affiliate email tips newsdesk.com job openings,in progress press secretary sarah sanders addresses media white house press briefing watch live at^now white house press briefing press secretary sarah sanders watch live fac^in progress nec director larry kudlow addresses media today white house press briefing watch live at^kim kardashian returns white house make case another convict release^emmy awards the winners list^channing tatum jenna dewan announce separation^channing tatum jenna dewan announce separation^channing tatum jenna dewan announce separation^koko gorilla knew sign language dies^ex 'dance moms star abby lee miller sentenced year prison^ex 'dance moms star abby lee miller sentenced year prison^scott baio wife renee reveals microvascular brain disease diagnosis^scott baio wife renee reveals microvascular brain disease diagnosis^scott baio wife renee reveals microvascular brain disease diagnosis^'house cards teaser reveals fate kevin spacey frank underwood^'house cards teaser reveals fate kevin spacey frank underwood^'house cards teaser reveals fate kevin spacey frank underwood^jetblue calls port cops family cake plane kicks^veep actress julia louis dreyfus diagnosed breast cancer^'nypd blue creator steven bochco dead^'nypd blue creator steven bochco dead^'nypd blue creator steven bochco dead^reports priyanka chopra nick jonas engaged two months dating^reports priyanka chopra nick jonas engaged two months dating^lady gaga announces las vegas residency dates^lady gaga announces las vegas residency dates^lady gaga announces las vegas residency dates^cardi b confirms secretly married offset september 'engaged^cardi b confirms secretly married offset september 'engaged^cardi b confirms secretly married offset september 'engaged^wwe star vader dead age^wwe star vader dead age^wwe star vader dead age^prince william prince harry best man royal wedding^prince william prince harry best man royal wedding^prince william prince harry best man royal wedding^reports kylie jenner pregnant^april giraffe pregnant,5,33,28,38,0.13157894736842105,0.7368421052631579,0
17141268,wdsu,1151,132139,1309,254064,1,3,12,22,new orleans area news updates wdsu-tv instagram snapchat wdsu6,"melania trump undergoes kidney surgery walter reed medical center^most popular baby names every u.s. state^most popular baby names every u.s. state^us slaps 50 billion tariffs chinese goods escalating trade dispute^what roseanne barr net worth^what roseanne barr net worth^what roseanne barr net worth^megyn kelly weighs matt lauer fired 'today show^david cassidy fighting memory loss wants 'enjoy life^david cassidy fighting memory loss wants 'enjoy life^george clooney makes 27,283 every hour thanks tequila^hoda kotb brings 'today nola^hoda kotb brings 'today nola^mariah carey new year eve performance 'they foiled^'free speech rally 'fight supremacy groups set converge boston common^caitlyn jenner latest celebrity float run office^koko gorilla knew sign language dies^james franco event canceled actor denies allegations sexual misconduct^playboy founder hugh hefner cause death revealed^playboy founder hugh hefner cause death revealed^playboy founder hugh hefner cause death revealed^mindy kaling reportedly pregnant first child^mindy kaling reportedly pregnant first child^'clueless actress stacey dash running congress california^'clueless actress stacey dash running congress california^'clueless actress stacey dash running congress california^kaley cuoco marries karl cook intimate horse ranch wedding^kaley cuoco marries karl cook intimate horse ranch wedding^discovery channel 'storm chasers star joel taylor dead^discovery channel 'storm chasers star joel taylor dead^discovery channel 'storm chasers star joel taylor dead^billboard music awards check complete list winners^everything need know 'this is us season^billboard music awards check complete list winners^netflix is reportedly reviving carmen sandiego with gina rodriguez^reese witherspoon confirms 'legally blonde happening^april giraffe pregnant^april giraffe pregnant",13,25,12,38,0.34210526315789475,0.3157894736842105,0
6842112,koat7news,359,98864,817,160825,1,2,13,22,breaking news real-time updates new mexico,"melania trump undergoes kidney surgery walter reed medical center^most popular baby names every u.s. state^us slaps 50 billion tariffs chinese goods escalating trade dispute^what roseanne barr net worth^what roseanne barr net worth^what roseanne barr net worth^what roseanne barr net worth^megyn kelly weighs matt lauer fired 'today show^megyn kelly weighs matt lauer fired 'today show^david cassidy fighting memory loss wants 'enjoy life^david cassidy fighting memory loss wants 'enjoy life^tonya harding made 'dancing with stars finale fans livid^tonya harding made 'dancing with stars finale fans livid^george clooney makes 27,283 every hour thanks tequila^mariah carey new year eve performance 'they foiled^caitlyn jenner latest celebrity float run office^james franco event canceled actor denies allegations sexual misconduct^playboy founder hugh hefner cause death revealed^playboy found hugh hefner cause death revealed^playboy founder hugh hefner cause death revealed^mindy kaling reportedly pregnant first child^mindy kaling reportedly pregnant first child^mindy kaling reportedly pregnant first child^mindy kaling reportedly pregnant first child^'clueless actress stacey dash running congress california^'clueless actress stacey dash running congress california^kaley cuoco marries karl cook intimate horse ranch wedding^kaley cuoco marries karl cook intimate horse ranch wedding^kaley cuoco marries karl cook intimate horse ranch wedding^discovery channel 'storm chasers star joel taylor dead^discovery channel 'storm chasers star joel taylor dead^discovery channel 'storm chasers star joel taylor dead^discovery channel 'storm chasers star joel taylor dead^billboard music awards check complete list winners^billboard music awards check complete list winners^netflix is reportedly reviving carmen sandiego with gina rodriguez^reese witherspoon confirms 'legally blonde happening^april giraffe pregnant",14,24,10,38,0.3684210526315789,0.2631578947368421,0
24204481,HelloCanada,999,59445,450,61208,0,0,28,10,canada weekly lifestyle magazine source celebrity entertainment news,jennifer aniston justin theroux reached custody agreement dogs^icymi chris pratt officially files divorce anna faris^two years split ben affleck jennifer garner says still ready date^liam payne breaks silence split cheryl^stars coming tiff julia roberts penelope cruz keira knightley^what duchess cambridge called prince william king^is duchess cambridge blake lively style inspiration^thecrown recreated important moment prince charles camilla romance^find play prince charles season three thecrown^meet actor set play young prince charles thecrown^julia roberts reveals oprah one thing 'hurts feelings marriage^is hope quite yet chris pratt anna faris still living together ...^sounds like justin bieber hailey baldwin already married^selenagomez gorgeous hairstyles years^stars coming tiff julia roberts penelope cruz keira knightley^reveals regrets filming wrecking ball music video^angelinajolie says 'i n't enjoy single rare interview split bradpitt^angelina jolie 'relieved child abuse investigation brad pitt^angelina jolie 'relieved learn investigation child abuse claims brad pitt ended^stars coming tiff julia roberts penelope cruz keira knightley^julia roberts shares rare personal photo husband danny moder^daniel craig rachel weisz welcome first baby together^brad pitt angelina jolie child support battle getting heated what star saying^katie holmes wants 'dawson creek reunion say bring teampacey cc^we know truth jenniferaniston justintheroux endless rumors^brad pitt admits heavy drinking played pivotal role breakdown marriage^brad pitt confesses heavy drinking played pivotal role breakdown marriage^brad pitt gets candid led breakdown marriage^laura prepon ben foster officially married see sweet wedding photo^everything know pippa middleton wedding venue dress designer^justin theroux breaks social media silence jennifer aniston split^everything know far pippa middleton wedding^it almost time pippa middleton walk aisle here everything know far wedding^pippa middleton wedding almost here everything know far^everything know far pippa middleton wedding^is rosamund pike set play princess diana feud season two^why prince william wo n't prince harry 'best man royal wedding^icymi chris pratt officially files divorce anna faris,28,10,-18,38,0.7368421052631579,-0.4736842105263158,1
94586657,mytalk1071,368,15556,129,33416,0,0,33,5,mytalk twin cities radio station keeps caught everything entertainment,busyphilipps poked fun lindsaylohan recreating odd dance moves former child star showed whi^kanyewest keeping touch caitlynjenner despite fact wife kimkardashian siblings^matt smith would like see vanessa hudgens play meghan duchess sussex thecrown^meghan duchess sussex estranged half sister samantha reportedly talks replace adult actress stormy d^chrissyteigen criticized father meghan duchess sussex embarrassing new british royal wi^former actress meghan duchess sussex heading back small screen new documentary series quee^meghan duchess sussex dad convinced daughter hard time new royal life^meghan duchess sussex reportedly agreed show couture givenchy wedding dress part public^mileycyrus liamhemsworth shut speculation called wedding^thecrown casts prince charles queen mother season lori julia^pop star joejonas actress fiancee sophieturner reportedly making plans tie knot winter wo^kimkardashian hid left hand kanyewest encounter shortly becoming mrs. krishumphries be^matt smith would like see vanessa hudgens play meghan duchess sussex thecrown^meghan duchess sussex estranged half sister samantha reportedly talks replace adult actress stormy d^chrissyteigen criticized father meghan duchess sussex embarrassing new british royal wi^former actress meghan duchess sussex heading back small screen new documentary series quee^meghan duchess sussex dad convinced daughter hard time new royal life^meghan duchess sussex reportedly agreed show couture givenchy wedding dress part public^jenniferlopez new boyfriend alexrodriguez full praise 'amazing superstar^jenniferlopez raved awesome new boyfriend alexrodriguez^jenniferlopez boyfriend alexrodriguez reportedly hunting first new york home together^caitlynjenner missed son brody jenner wedding indonesia^breaking news divorce angelinajolie amp bradpitt listen now cobra 'll give details^angelinajolie reportedly involved bizarre plot capture arrest ugandan warlord joseph kony^kendalljenner broke tears recalled reaction controversy surrounding infamous pepsi ad^well n't last long kanyewest back twitter choosing reactivate account series biz^meghanmarkle left one rescue dogs live permanently friends moving u.k. live wit^breaking news divorce angelinajolie amp bradpitt listen now cobra 'll give details^rachelweisz danielcraig proud parents baby girl^angelinajolie reached new low court battle estranged husband bradpitt accusing actor^angelinajolie representative blasting misleading reports custody battle estranged husband^angelinajolie confirmed reports switching lawyers ongoing divorce custody battle est^amberrose stunned fans beyonce jayz claiming gwynethpaltrow becky good hair who^edsheeran engaged long time girlfriend cherry seaborn^actress rachelmcadams pregnant first child according multiple reports^rihanna kanye west sister law kylie jenner named among time magazine most influential^singer/actress jamie lynn spears extra reason celebrate christmas pregnant second chi^are officially back together the weeknd bella hadid spotted kissing cannes film festival,33,5,-28,38,0.8684210526315791,-0.7368421052631579,1
20177010,KCCINews,860,117879,1018,272123,3,3,8,23,kcci news most-watched station central iowa leader local news coverage,"melania trump undergoes kidney surgery walter reed medical center^people found dead ohio^people found dead ohio^video watch extended interview u.s. sen. john mccain^most popular baby names every u.s. state^us slaps 50 billion tariffs chinese goods escalating trade dispute^what roseanne barr net worth^megyn kelly weighs matt lauer fired 'today show^david cassidy fighting memory loss wants 'enjoy life^icymi david cassidy fighting memory loss wants 'enjoy life^is kim kardashian pursuing music career^george clooney makes 27,283 every hour thanks tequila^mariah carey new year eve performance 'they foiled^caitlyn jenner latest celebrity float run office^koko gorilla knew sign language dies^koko gorilla knew sign language dies^james franco event canceled actor denies allegations sexual misconduct^playboy founder hugh hefner cause death revealed^playboy founder hugh hefner cause death revealed^playboy founder hugh hefner cause death revealed^playboy founder hugh hefner cause death revealed^steph and ayesha curry are eecting baby no^mindy kaling reportedly pregnant first child^mindy kaling reportedly pregnant first child^'clueless actress stacey dash running congress california^'clueless actress stacey dash running congress california^'clueless actress stacey dash running congress california^'clueless actress stacey dash running congress california^kaley cuoco marries karl cook intimate horse ranch wedding^discovery channel 'storm chasers star joel taylor dead^discovery channel 'storm chasers star joel taylor dead^discovery channel 'storm chasers star joel taylor dead^discovery channel 'storm chasers star joel taylor dead^billboard music awards check complete list winners^billboard music awards check complete list winners^netflix is reportedly reviving carmen sandiego with gina rodriguez^reese witherspoon confirms 'legally blonde happening",11,26,15,37,0.2972972972972973,0.40540540540540543,0
20097362,nbcbayarea,1423,325426,3431,312733,1,13,14,9,thank stopping place go exclusive local stories breaking news weather sports facebook,attorney general jeff sessions statement recusal^salmonella raw chicken made people sick across states centers disease control preventio^the number homicides committed using guns gone nearly third nationwide recent years according to^president donald trump offered views many recent news developments impromptu interview fox news f^an insurgent underdog vermont sen. bernie sanders laying groundwork launch bigger presidenti^the u.s. department education says cancelling 150 million students loans connected profit colle^during interview thursday morning fox friends said kanye west different ki^cagovdebate candidates tackle issue homelessness state continuing live coverage debate here^live video president trump makes remarks national federation independent business th anniversary celeb^salmonella raw chicken made people sick across states centers disease control preventio^the number homicides committed using guns gone nearly third nationwide recent years according to^white house press secretary holds white house press briefing booted virginia re^live white house press briefing^one four vehicles involved crash early morning e. capitol eressway stolen according s^popular comedian hannibal buress arrested miami disorderly intoxication^catherine duchess cambridge meghan duchess sussex attends ladies singles final match wi^prince harry meghan duchess sussex watch hamilton next creator lin manuel miranda gala^a royal baby way the duchess sussex meghan markle prince harry eecting first child^congrats amal george clooney welcome twins ella alexander^catherine duchess cambridge meghan duchess sussex attends ladies singles final match wi^prince harry meghan duchess sussex watch hamilton next creator lin manuel miranda gala^shots fired set tekashi ix9ine kanye west upcoming video tmz reporting according poli^catherine duchess cambridge meghan duchess sussex attends ladies singles final match wi^adorable catherine duchess cambridge seen holding prince louis christening^catherine duchess cambridge meghan duchess sussex attends ladies singles final match wi^adorable catherine duchess cambridge seen holding prince louis christening^gayle king says oprah winfrey intrigued idea running president n't see happ^icymi the royalwedding year brought touching moments british royal family fans as^anthony bourdain parts unknown nominated emmys month host death^stranger things officially renewed season^lea michele engaged boyfriend zandy reich on saturday former glee star hopped social media on^bachelor contestant bekah m. appears california missing persons list fine^'bachelor contestant bekah m. appears california missing persons list fine^this is us chrissy metz reveals surprising connection younger kate actress^heather locklear arrested attacking cop emt^congratulations order nick jonas priyanka chopra e news confirmed couple engaged after^michael phelps nicole johnson welcome baby no,15,22,7,37,0.40540540540540543,0.1891891891891892,0
4448855781,Power933,345,2800,68,13946,0,0,32,5,nan,john mayer has been hospitalized emergency appendectomy^ed sheeran did not 'break friendship code with taylor swift^beyonce not demanding silent delivery room despite report^are selena gomez amp the weeknd working on a movie together^stars celebrate rosh hashanah see celebrity tweets about jewish new year^selena gomez vogue cover story see interview highlights^celebrities react to hurricane irma^chris brown slammed by judge for skipping karrueche tran court hearing^chris soules had no alcohol in system after crash negative for drugs^justin bieber one pursued selena gomez vice versa ... listen live^did jennifer lopez 'like a comment dissing mariah carey^lady gaga taylor kinney not secretly dating despite late and wrong report^kate hudson brad pitt false dating rumor mocked by oliver hudson photo^mariah carey amp french montana did not flirt in recording studio^watch kim kardashian first interview since robbery on 'ellen degeneres show videos^hailee steinfeld responds to justin bieber dating rumors^nope justin bieber is not dating hailee steinfeld^justin bieber dating hailee steinfeld photo^miley cyrus regrets nude wrecking ball video^beyonce birth twins still hospital 'minor issue^is liam hemsworth mad at miley cyrus for texting nick jonas^is demi lovato upset about meghan trainor performing the 'smurfs movie song^twitter reacts zoe saldana says hollywood bullied donald trump^are mariah carey amp joe jonas feuding^flo rida not performing at donald trump inauguration despite report^grammy awards see the full winners list^iggy azalea blasts nick young after accidental dinner reunion^kanye west is not rebooting 'american idol^kim kardashian slams 'invasive surrogacy reports^selena gomez reveals she had a kidney transplant amp her friend was her donor^chris soules 'devastated after killing kenny mosher in fatal accident^mariah carey not dating both nick cannon and bryan tanaka despite report^harry styles announces intimate world tour see the dates^alex rodriguez year old daughter sings for jennifer lopez photos^justin timberlake announces 'the man of the woods tour see the dates^watch harry styles kiss james corden in christmas themed 'carpool karaoke^billboard music awards nominations see full list of bbmas nominees,32,5,-27,37,0.8648648648648649,-0.7297297297297297,1
236763329,NewIdeamagazine,643,27361,204,25752,0,0,34,3,we australia loved weekly magazine featuring celebrity news amazing exclusive interviews best pictures recipes health fashion,jennifer aniston confronts neri stay away brad^brad pitt angelina jolie custody war the kids tell^jessica simpson shows growing baby bump^george clooney amal 'divorce hell^justintheroux baby news rocks jenniferaniston^victory brad 'angelina hands kids^brad pitt margot robbie new scandal^baby number two justin timberlake jessica biel^check prince harry meghan markle new house^us report angelina jolie jennifer aniston 'elosive face face showdown^jenniferaniston justintheroux divorce turns nasty^angelina jolie fury brad pitt jennifer aniston move together^harry meghan our baby joy^why kate middleton meghan markle 'ca n't stand^brad pitt custody victory angelina jolie^angelina jolie fury brad pitt jennifer aniston move together^brad pitt margot robbie new scandal^channing tatum jenna dewan announce separation joint statement^furious portia warns jen 'stay away ellen^furious portia warns jen 'stay away ellen^jessica simpson shows growing baby bump^harry meghan our baby joy^camilla evil plot eed^jennifer aniston check revenge body^brad pitt secret lover pregnant^inside brad jen romantic honeymoon^julia roberts miracle baby^rachel weisz and daniel craig welcome first child^angelina jolie admits defeat amid bitter brad pitt custody battle^baby number two justin timberlake jessica biel^jenniferaniston justintheroux divorce turns nasty^jenniferaniston justintheroux divorce turns nasty^chris hemsworth agony elsa steamy kiss^brad pitt princess charlotte moving london love^enrique iglesias anna kournikova welcome twins^rachelmcadams welcomes first child report^kim kardashian west shares first photo chicago west,34,3,-31,37,0.9189189189189191,-0.8378378378378378,1
84141253,news8news,579,7984,207,45293,1,29,6,0,latest news updates wkbt-tv news,new york congresswoman elect alexandria ocasio cortez says seat us house representatives beca^a multistate outbreak listeria traced houston manufacturer vietnamese ready eat pork products^cigarette use among american adults lowest since centers disease control prevention^the us centers disease control prevention continues warn eating romaine lettuce harvested fr^strength training numerous benefits especially seniors take look benefits outlined^the centers disease control prevention telling consumers restaurants retailers throw away ro^the strain e. coli causing current outbreak romaine lettuce found reservoir farm sa^fentanyl commonly used drug involved drug overdoses according new government report the l^more americans turning forms complementary medicine yoga meditation chiropractors according^eighty seven people sickened salmonella linked recalled beef products us centers di^there confirmed cases polio like illness known afm states year friday the^the us centers disease control prevention received reports patients investigation acut^the number cases polio like illness acute flaccid myelitis appears peaked us cent^sixty three additional cases salmonella identified ongoing multistate outbreak linked raw be^a multistate outbreak listeria traced houston manufacturer vietnamese ready eat pork products^cigarette use among american adults lowest since centers disease control prevention^the us centers disease control prevention continues warn eating romaine lettuce harvested fr^strength training numerous benefits especially seniors take look benefits outlined^the centers disease control prevention telling consumers restaurants retailers throw away ro^the strain e. coli causing current outbreak romaine lettuce found reservoir farm sa^fentanyl commonly used drug involved drug overdoses according new government report the l^more americans turning forms complementary medicine yoga meditation chiropractors according^eighty seven people sickened salmonella linked recalled beef products us centers di^there confirmed cases polio like illness known afm states year friday the^the us centers disease control prevention received reports patients investigation acut^the number cases polio like illness acute flaccid myelitis appears peaked us cent^sixty three additional cases salmonella identified ongoing multistate outbreak linked raw be^with thanksgiving around corner us department agriculture food safety inspection service has^publix supermarkets recalling ground beef products chuck may e. coli us department of^hosting thanksgiving year the u.s. department agriculture tips prepare safe thanksgiv^saturday night live comedian leslie jones message anyone found victim online bu^princess charlotte turned wednesday she middle child prince william catherine duchess cambri^princess charlotte middle child prince william catherine duchess cambridge celebrated her^princess charlotte turned wednesday she middle child prince william catherine duchess cambri^princess charlotte middle child prince william catherine duchess cambridge celebrated her^britain prince harry praised father prince wales walking meghan markle aisle the,7,29,22,36,0.19444444444444445,0.6111111111111112,0
2884771,Newsweek,507,3364579,37810,213383,2,10,6,18,stay relevant news analysis politics science technology culture our staff likes tweet,barbara bush says george h.w bush died ready wife^barbara bush says george h.w bush died ready wife^sarah palin cpac speech shows lost^rudy giuliani says trump interview robert mueller without access spygate fbi documents^read full transcript second u.s. presidential debate st louis missouri^young americans rejecting capitalism huge numbers following bernie sanders presidential campaign^what need know democratic presidential debate new hampshire demdebate^veteran journalist gwen ifill part first female team anchor main democratic presidential debate^read full transcript third final u.s. presidential debate^full transcript democratic debate miami^cnn commentator marc lamont hill defends comments palestine united nations speech^who marc lamont hill cnn commentator defends comments palestine united nations speech^is ben affleck quitting batman pushed^chloe grace moretz says appalled body shaming poster film 'red shoes amp the dwarfs'^chloe grace moretz says appalled body shaming poster film 'red shoes amp the dwarfs'^chloe grace moretz says appalled body shaming poster film 'red shoes amp the dwarfs'^next move suits moving u.k. prince harry engagement says royal eert^what pentagon papers the true story behind new movie 'the post^woman accused hacking selena gomez email posting nudes justin bieber charged felony counts^woman accused hacking selena gomez email posting nudes justin bieber charged felony counts^the iconic house featured brady bunch tv show sale could 've got spare 2^the iconic house featured brady bunch tv show sale could 've got spare 2^hugh hefner cause death revealed^hugh hefner cause death revealed^abby lee miller undergoes quick little emergency surgery amid cancer battle^'big bang theory star kaley cuoco marries professional equestrian karl cook barn wedding^is sarah paulson going play princess diana 'feud^is sarah paulson going play princess diana 'feud^shailene woodley ate calories day new movie 'adrift^shailene woodley ate calories day new movie 'adrift^shailene woodley ate calories day new movie 'adrift^future mrs. jonas nick jonas priyanka chopra engaged^future mrs. jonas nick jonas priyanka chopra engaged^'cats fans rejoice taylor swift james corden jennifer hudson cast upcoming movie version of^oprah winfrey says god n't told run president^oprah winfrey says god n't told run president,8,28,20,36,0.2222222222222222,0.5555555555555556,0
1767741,NYTNational,827,80820,2899,181266,4,26,4,2,breaking news features national desk the new york times follow correspondents,long died george h.w bush went see funeral train commissioned carry coffin it^long died george h.w bush went see funeral train commissioned carry coffin it^long died george h.w bush went see funeral train commissioned carry coffin it^long died george h.w bush went see funeral train commissioned carry coffin it^criminal inquiry sought hillary clinton use email^transcript democratic presidential debate^transcript democratic presidential debate milwaukee^transcript democratic presidential debate flint mich^transcript democratic presidential debate miami^here transcript last night democratic presidential debate^here transcript republican presidential debate florida^transcript third presidential debate^a review us department education found texas officials broke federal laws special education m^a review us department education found texas officials broke federal laws special education m^trump interview fox friends covered lot here are some key things he said^the full video transcript president trump first address joint session congress^transcript democratic presidential debate^transcript democratic presidential debate milwaukee^transcript democratic presidential debate flint mich^transcript democratic presidential debate miami^here transcript last night democratic presidential debate^read full transcript barack obama speech south africa defended international institutions^watch president trump defended immigration policy speech national federation independent bu^at campaign rally las vegas president trump said republicans protect patients pre exis^in first interview following barbara bush death george w. bush rd president remembered mother s^read full transcript barack obama speech south africa defended international institutions^the long run broad response /11 offers outline mccain doctrine^sean spicer launching book style including glitzier invitation party lobby trump inter^sean spicer launching book style including glitzier invitation party lobby trump inter^strong words ohio obama clinton press on^hoda kotb replace matt lauer co host nbc flagship morning program today^hoda kotb replace matt lauer co host nbc flagship morning program today^hoda kotb replace matt lauer co host nbc flagship morning program today^gwyneth paltrow angelina jolie others say weinstein harassed^walmart said plan remove cosmopolitan checkout lines business decision a nonprofit group taking^stacey dash best known dionne davenport clueless running congress california republican,8,28,20,36,0.2222222222222222,0.5555555555555556,0
181647126,PureWow,1555,42144,580,62184,0,2,16,18,from amy schumer trending baby names girl crush reads online,the most popular baby names every state^the most popular baby names every state^reese witherspoon spills new details legally blonde^sarah jessica parker wants *this* star play samantha sex city^golden globes complete list winners^mila kunis ashton kutcher baby son is straight bitchin his that 70s show t shirt^mila kunis ashton kutcher baby son is straight bitchin his that 70s show t shirt^mila kunis ashton kutcher baby son is straight bitchin his that 70s show t shirt^kate middleton rocked perfect riding boots fall her official return maternity leave^dwayne the rock johnson is no match emily blunt gym^netflix casts prince charles amp queen mother the crown season^the complete list emmy awards winners^prince harry says everyone thinks meghan markle is pregnant baby girl^dakota johnson chris martin are reportedly dating here everything we know^times meghan markle kate middleton were royal style twins^julia roberts shares rare glimpse personal life danny moder see pic^prince harry amp meghan markle just chose their wedding day transportation and it straight out of a fairy tale^grammy awards the complete list winners^yet another japanese princess is giving up her royal title marry commoner amp major props girl^jada pinkett smith letter her daughter willow will make you want call your mom^chrissy teigen jokes she walking victoria secret fashion show^take that gilead yvonne strahovski is pregnant her first child^everything we know about american horror story season so far^surprise rachel mcadams is pregnant her first child amp sadly it not ryan gosling^stop everything you 're doing mindy kaling is reportedly pregnant her first child^full schedule freeform nights halloween purewow^things you need know about michelle williams new husband phil elverum^here how prince william earned major street cred prince george^priyanka chopra are reportedly engaged here what we know so far^everything you need know about princess eugenie amp jack brooksbank royal wedding^everything you need know before watching this is us season premiere^how get away with murder costars charlie weber liza weil are dating^serena williams withdraws australian open shockingly honest confession^grammy awards the complete list winners^oscars the complete list academy award winners^april giraffe is pregnant again amp there goes next months our life,16,20,4,36,0.4444444444444444,0.1111111111111111,0
70239610,MSNca,1290,17379,107,43505,1,1,21,13,nan,melania trump undergoes kidney surgery walter reed medical center^key moments trump interview fox friends with fact checks^prince harry girlfriend meghan markle finally meets queen elizabeth^blake shelton embarrasses gwen stefani onstage talks first started 'mess around together^angelina jolie accuses brad pitt paying enough child support court documents reveal^jennifer aniston attack justin theroux^justin bieber marriage 'threw selena gomez 'off guard hit her hard says source^justin bieber 'is selena gomez despite marriage hailey baldwin says source^the ugly truth jennifer aniston justin theroux divorce^justin bieber 'is selena gomez despite marriage hailey baldwin says source^meghan markle prince harry told royals their baby news eugenie 's wedding^oj simpson predicted 'keeping up with kardashians would fail via^are kanye west secretly separated^teri hatcher denies 'broke homeless living van^brad pitt was done being mr. nice guy custody battle with angelina jolie^teri hatcher denies 'broke homeless living van^meghan markle dropped major royal baby hint^the ugly truth jennifer aniston justin theroux divorce^meghan markle prince harry told royals their baby news eugenie 's wedding^gwyneth paltrow angelina jolie others say weinstein harassed them^the ugly truth jennifer aniston justin theroux divorce^jumanji trailer backlash twitter slams sequel robin williams classic^video rumors swirl rihanna might pregnant rihanna chrisbrown^troy gentry helicopter crash caused engine failure new report details final moments fatal flight^jada pinkett recalls heated call will smith ex 'it house^celebrity fashion trends make scratch head^hugh hefner cause death revealed^hugh hefner cause death revealed^anthony bourdain narcotics body time death^inside bachelorette contestant michael nance life tragic death 'he felt things very deeply'^adele unites cameron diaz jennifer lawrence women march^does photo prove amelia earhart survived final flight^tom petty rushed hospital after suffering full cardiac arrest report^'that '70s show where^reclusive richard simmons hospitalized evere indigestion^mila kunis surprises parents home makeover see results,22,14,-8,36,0.6111111111111112,-0.2222222222222222,1
89740331,1029NOW,1643,11559,177,30159,0,0,29,7,more music more variety am-10am am-2pm pm-7pm pm-12mid,teen choice awards nominations first wave of nominees full list^karrueche tran granted five year restraining order against chris brown^celebrities react nelsan ellis dead at^beyonce not demanding silent delivery room despite report^brad pitt gq divorce interview highlights on angelina jolie kids and drinking^selena gomez vogue cover story see interview highlights^jennifer garner ben affleck file for divorce amid false reconciliation rumor^chris soules had no alcohol in system after crash negative for drugs^kristen stewart on dating robert pattinson 'the public were the enemy^halle berry not pregnant at despite reports^watch kim kardashian first interview since robbery on 'ellen degeneres show videos^hailee steinfeld responds to justin bieber dating rumors^justin bieber dating hailee steinfeld photo^beyonce birth twins still hospital 'minor issue^beyonce birth twins still hospital 'minor issue^karrueche tran granted five year restraining order against chris brown^tony awards nominations see full tonys nominees list^chloe grace moretz apologizes for 'red shoes marketing^celebrities remember orlando pulse nightclub shooting victims one year later^is demi lovato upset about meghan trainor performing the 'smurfs movie song^justin bieber did not attend vanity fair oscars after party^are mariah carey amp joe jonas feuding^kanye west is not rebooting 'american idol^justin bieber amp hailey baldwin a timeline their relationship^robert pattinson amp charlie hunnam talk 'lost city of z on 'gma video^chris soules 'devastated after killing kenny mosher in fatal accident^mariah carey not dating both nick cannon and bryan tanaka despite report^mariah carey not dating both nick cannon and bryan tanaka despite report^michael strahan 'looking forward to working with alex rodriguez at abc^harry styles announces intimate world tour see the dates^'dance moms abby lee miller sentenced to one year in prison^'happy days star erin moran dead at^alex rodriguez year old daughter sings for jennifer lopez photos^billboard music awards nominations see full list of bbmas nominees^billboard music awards nominations see full list of bbmas nominees^miley cyrus defends selena gomez after stefano gabbana calls her 'ugly,29,7,-22,36,0.8055555555555556,-0.6111111111111112,1
15791186,KHOU,1320,709188,3132,362019,1,0,8,26,khou stands houston we relentless providing breaking news weather traffic tweet us email newstips.com we listening htownrush,"do n't eect texas ag commissioner sid miller apologize controversial facebook post^reports brad pitt accused child abuse investigation khou^winner 's list here complete winner list golden globes^emmy awards the winners list^channing tatum jenna dewan announce separation^channing tatum jenna dewan announce separation^royal wedding prince harry meghan markle fairy tale wedding^the royal procession prince harry duke sussex meghan duchess sussex leave windsor castle ascot^royal procession prince harry duke sussex meghan duchess sussex leave windsor castle greeted^koko gorilla knew sign language dies^ex 'dance moms star abby lee miller sentenced year prison^ex 'dance moms star abby lee miller sentenced year prison^meghan trainor engaged 'spy kids star daryl sabara^meghan trainor engaged 'spy kids star daryl sabara^walmart remove 'cosmopolitan magazine checkout lines amid me too movement^walmart plans remove magazine checkout lines ,000 stores across country.^walmart remove 'cosmopolitan magazine checkout lines amid me too movement^scott baio wife renee reveals microvascular brain disease diagnosis^scott baio wife renee reveals microvascular brain disease diagnosis^it beautiful day neighborhood tom hanks set play mr. rogers upcoming biopic you are my^report meghan markle dad longer attend royal wedding^report meghan markle dad longer attend royal wedding^report meghan markle dad longer attend royal wedding^veep actress julia louis dreyfus diagnosed breast cancer^veep actress julia louis dreyfus diagnosed breast cancer^reports priyanka chopra nick jonas engaged two months dating^reports priyanka chopra nick jonas engaged two months dating^reports priyanka chopra nick jonas engaged two months dating^lady gaga announces las vegas residency dates^lady gaga announces las vegas residency dates^lady gaga announces las vegas residency dates^cardi b confirms secretly married offset september 'engaged^reports jennifer garner ben affleck officially file divorce^april giraffe pregnant^april giraffe pregnant",9,26,17,35,0.2571428571428571,0.4857142857142857,0
36751886,Variety_TV,22,27131,1247,34934,0,3,10,22,tv coverage variety,sean hannity interview roseanne barr fox news hannity^margaret brennan returns face nation with new perspective news^fox news cnn shake up sunday schedules midterms coverage^hollywood mourns death legendary harry dean stanton the definition cool^michael strahan sara haines will host abc new gma hour^michael strahan sara haines will host abc new gma hour^katie couric gives first remarks matt lauer today exit^the crown casts josh o connor prince charles marion bailey queen mother^four duggar sisters sue in touch invasion privacy^critics choice award winners full list^michael strahan sara haines will host abc new gma hour^hollywood reacts matt lauer firing don let door hit you way out^big little lies season shailene woodley laura dern zo kravitz set return^scandal end after season report^modern family renewed two seasons abc^cw renews the originals izombie new seasons^vanessa hudgens joins so you think you can dance judge season^terrell owens joins dancing with stars season with cheryl burke^homeland claire danes says series will end with season^house cards producers consider killing off kevin spacey frank underwood exclusive^former mtv vj jesse camp reported missing^american horror story season title revealed^stranger things star finn wolfhard exits apa after agent accused sexual abuse^once upon time renewed season abc^fuller house renewed netflix season^jennifer hudson joins the voice season coach^katy perry host mtv video music awards^mike myers remembers austin powers co star verne troyer i miss him^rent selected fox next live musical^the originals end after season the cw^geraldo rivera apologizes bette midler alleged groping^everything we know about 13 reasons why season^lena dunham joins american horror story season^meryl streep joins big little lies season^freddie highmore bates motel series finale it fitting end love story,10,25,15,35,0.2857142857142857,0.42857142857142855,0
2488541,bostonherald,1546,104196,2349,277558,0,2,11,22,starting conversation every day passionate journalism watchdog special reports best ne sports business features live,john mccain slams 'half baked spurious nationalism liberty medal acceptance speech^police report drop homicides shooting victims chicago^burt ward celebrities pay tribute batman star adam west^celebrities react london attack^katie couric gives first remarks matt lauer 'today exit^caitlyn jenner considering bid us senate california^amal george clooney welcome twins^andy cohen calls kathy griffin accusations drug use '100 false^every political moment emmy awards^james comey testifies congress celebrities react twitter^lindsay lohan i racially profiled airport wearing headscarf^mariah carey new year eve performance 'they foiled^selena gomez reveals kidney transplant due lupus^jada pinkett smith calls tupac biopic 'deeply hurtful^teen mom star mackenzie mckee reveals mother diagnosed brain cancer^jeopardy host alex trebek recovering surgery remove blood clots brain^united airlines announces policy changes response passenger removal incident^united airlines announces policy changes response passenger removal incident^'house cards producers consider killing kevin spacey frank underwood^alanis morissette ex manager sentenced years prison embezzling millions singer^the starbucks narwhal frappuccino thing and tastes like pink starburst^mischa barton ex boyfriend agrees restraining order release alleged sex tape^melania trump trapped hotel room g20 protesters^andrew garfield i gay man right without physical act^ben affleck matt damon production company adopt inclusion riders^update tom petty rushed hospital suffering full cardiac arrest report^richard simmons hospitalized california evere indigestion says manager^richard simmons hospitalized severe indigestion says manager^daniel craig confirms play james bond^ben affleck jennifer garner officially file divorce^ben affleck jennifer garner officially file divorce^freddie highmore bates motel series finale that end boston herald^jennifer lawrence says wants take break acting milk goats farm^pauley perrette leaving ncis seasons^pregnant april giraffe calf due march,11,24,13,35,0.3142857142857143,0.37142857142857133,0
20275150,YahooCelebrity,1588,169612,1459,46899,0,0,13,22,visit get entertainment news one place,joel silver sued assistant death jennifer aniston justin theroux honeymoon^blac chyna request trademark angela ren e kardashian officially denied^blake shelton gwen stefani last person i eected back split^no beyonc get lip injections^angelina jolie brad pitt agreed keep divorce private we committed act united front^jennifer lopez spent day new boyfriend alex rodriguez sister this getting serious y'all^hailee steinfeld really want think dating justin bieber^angelina jolie says i n't enjoy single new interview post brad pitt life^christina aguilera is engaged boyfriend matt rutler^jennifer aniston addresses pregnancy rumors kanye west goes boating greece top stories^jessica simpson flaunts weight loss swimsuit kailyn lowry gives birth top weekend stories^brad pitt reportedly devastated shock chris cornell death a look back friendship^icymi britney spears instagram target russian hackers^ryan reynolds reveals saved nephew life^nick gordon appears court domestic violence arrest^dance moms star abby lee miller sentenced year day prison fraud^glee star charice pempengco changes name jake zyrus my soul male^taylor swift resurfaces photographed first time months^kourtney kardashian casually seeing year old model younes bendjima scott disick happy it^youtube star austin jones arrested child pornography charges^icymi miss north dakota cara mund crowned miss america^mel b files divorce stephen belafonte nearly years marriage^riley curry celebrates th birthday unicorn themed tea party see adorable pics^gold medalist sanya richards ross says abortion day flying olympics^prince harry admits wanted royal family^taylor swift music video director claims beyonc lemonade copied bad blood^carrie fisher debbie reynolds personal items auction beverly hils home sold^eliza dushku engaged boston real estate investor peter palandjian^lcd soundsystem gavin russom comes transgender^taylor swift makes sizable donation houston food bank hurricane harvey^allison janney reveals anna faris handling split chris pratt^richard simmons said better hospitalized severe indigestion^khlo kardashian says ready marry tristan thompson kuwtk could definitely use ratings boost^homealone star john heard cause death revealed^andrea constand thanks supporters judge declares mistrial bill cosby sexual assault case,13,22,9,35,0.37142857142857133,0.2571428571428571,0
20433284,ewnupdates,3726,983969,1964,303794,0,4,14,17,inside the truth,'leave land face war zulu nation^popular this week in scathing attack government king goodwill zwelithini says even t^popular on ewn in scathing attack government king goodwill zwelithini says even thin^ethiopia prime minister calls multiparty democracy chief staff^chris pratt files divorce anna faris^trending this week actor idriselba james bond fans campaigning next person play n^fergie josh duhamel split^fergie josh duhamel split^fergie josh duhamel split^kim kardashian west embarrassed kanye west pro trump rant^angelinajolie accuses bradpitt paying enough child support^gwen stefani wanted cooking show^amal george clooney welcome boy girl twins^amal george clooney welcome boy girl twins^brad pitt oldest son snubbed visit^ben affleck looking family friendly role^jennifer aniston casually dating^kanye west silences speculation around 'american idol^watch rock legend tom petty dead^watch rock legend tom petty dead^watch rock legend tom petty dead^prince harry asks elder brother william best man wedding^watch actor jerry lewis dies age^watch actor jerry lewis dies age^watch actor jerry lewis dies age^watch actor jerry lewis dies age^watch actor jerry lewis dies age^wrongful death lawsuit jim carrey dismissed^arnold schwarzenegger returns home emergency open heart surgery^arnold schwarzenegger return home emergency open heart surgery^kelly clarkson host billboard music awards^mobb deep rapper prodigy cause death revealed^mobb deep rapper prodigy cause death revealed^ben affleck jennifer garner officially file divorce^chris pratt files divorce anna faris,14,21,7,35,0.4,0.2,0
22546772,snydenydn,2157,43067,955,56962,0,0,18,17,the hottest entertainment news favorite celebrities,blac chyna request trademark name angela kardashian officially rejected report^chris pratt officially files divorce anna faris^jenna bush hager emotionally apologizes hidden fences blunder golden globes^see it comedian hannibal buress arrested disorderly intoxication miami^fergie josh duhamel trying another baby split^nope angelina jolie reportedly fighting brad pitt filing joint custody kids^nope angelina jolie reportedly fighting brad pitt filing joint custody kids^katie holmes late long flirty goodbye date handsome mystery man^dakota johnson chris martin definitely dating^christina aguilera reveals engaged boyfriend matt rutler shows massive ring^jennifer lopez looks 'devastated first appearance since marc anthony split^meghan markle reportedly finds certain royal rules frustrating understand^heidi klum shows bikini body beach st. tropez^photos at heidi klum proves still got supermodel bikini body^watch live the oscars nominations see full list academy award nominees^reese witherspoon reportedly furious nicole kidman failing promote new show big little lies^love lives kourtney kardashian scott disick back together^british man claims 'allergic kim kardashian 'i get teary want retch^summer phoenix reportedly files divorce casey affleck^tamar braxton files divorce husband vincent herbert^rachel mcadams reportedly pregnant first child^splitsville elle king says skipped wedding concert^julia louis dreyfus resume filming veep august nearly one year actress announced 'd di^alicia vikander michael fassbender married^meghan markle deletes facebook instagram twitter accounts engagement prince harry^meghan markle deletes facebook instagram twitter accounts getting engaged prince harry^7th heaven party five star jeremy london arrested domestic violence^michelle williams engaged boyfriend andrew youmans^rip wwe star big van vader dead^tom daley dustin lance black eecting first child^jennifer aniston seems fine since split justin theroux^meryl streep joins big little lies season^vanessa bayer leaving saturday night live seven seasons^chris pratt officially files divorce anna faris^confirmed morning joe co hosts joe scarborough mika brzezinski engaged,18,17,-1,35,0.5142857142857142,-0.028571428571428567,1
27604154,Magic107,259,1271,40,26032,0,0,21,14,the best variety today,john mayer has been hospitalized emergency appendectomy^american music awards nominations amas nominees full list^ed sheeran did not 'break friendship code with taylor swift^ed sheeran break friendship code taylor swift despite ridiculous report katy perry ...^celebrities react trump withdraws steph curry white house invitation^selena gomez vogue cover story see interview highlights^justin bieber one pursued selena gomez vice versa ...^justin bieber dating singer actress hailee steinfeld^justin bieber dating singer actress hailee steinfeld^nope justin bieber is not dating hailee steinfeld^justin bieber dating hailee steinfeld photo^beyonce birth twins still hospital 'minor issue^celebrities remember orlando pulse nightclub shooting victims one year later^is demi lovato upset about meghan trainor performing the 'smurfs movie song^justin bieber did not attend vanity fair oscars after party^justin bieber not attend vanity fair oscars party ...^are mariah carey amp joe jonas feuding^avril lavigne 'mildly amused by death conspiracy^fans react u2 cancels st. louis concert amid police protests^selena gomez reveals kidney transplant summer amp friend actress francia raisa donated ...^selena gomez reveals she had a kidney transplant amp her friend was her donor^ryan seacrest kelly ripa new co host 'live^james corden seduces jamie dornan hilarious 'fifty shades parody^taylor swift teases new song 'gorgeous on instagram listen to a snippet^jeopardy host alex trebek recovering from brain surgery^'happy days star erin moran dead at^'happy days star erin moran dead at^alex rodriguez year old daughter sings for jennifer lopez photos^taylor swift teases new song 'gorgeous on instagram listen to a snippet^justin timberlake announces 'the man of the woods tour see the dates^watch harry styles kiss james corden in christmas themed 'carpool karaoke^camila cabello announces her 'never be the same tour see the dates^gigi hadid slams body shamers for calling her 'too skinny at nyfw^sir roger moore dead james bond star dies short cancer battle^sir roger moore dead james bond star dies short cancer battle,21,14,-7,35,0.6,-0.2,1
22987426,HuffPostUKEnt,578,35780,468,115903,0,0,29,6,celeb obsessors netflix addicts nostalgia lovers probably busy watching favourite reality show,kim kardashian defends kylie jenner self made billionaire label^kim kardashian west quick dispute rumours drake affair^liam payne discusses difficulties going high profile break announcing split che^liam payne discusses difficulties going public break following high profile split che^thecrown confirms josh o'connor series three prince charles marion bailey queen mother^thecrown confirms josh o'connor series three prince charles^thecrown confirms josh o'connor play prince charles series^chris pratt says 'divorce sucks first interview anna faris split^who better action hero tom cruise daniel craig olga k co star tells us ...^katy perry ca n't resist throwing shade taylor swift mentioned^did catch katy perry shade taylor swift week 'american idol^katy perry ca n't resist throwing shade taylor swift mentioned 'american idol^angelina jolie finally breaks silence brad pitt split emotional interview^angelina jolie finally breaks silence split brad pitt^angelina jolie finally breaks silence split brad pitt emotional interview^angelina jolie finally breaks silence brad pitt split^'harry potter star noma dumezweni says donald trump would welcome 'cursed child audience^'harry potter star noma dumezweni says donald trump welcome cursedchild audience^jennifer lawrence admits still feels 'terrified three years nude photo leak^jennifer lawrence says still feels 'terrified three years nude photo leak^michael parkinson says friend billy connolly 'wonderful brain dulled parkinson diagnosis^billy connolly wife pamela stephenson labels chat show legend michael parkinson daft old fart suggesting^pamela stephenson denies michael parkinson claims husband billy connolly 'wonderful brain dulled'^billy connolly wife pamela stephenson labels michael parkinson daft old fart suggesting comedian brain^michael parkinson gives sad update friend billy connolly fight parkinson disease^david beckham charged speeding accused driving bentley almost mph speed limit^katy perry ca n't resist throwing shade taylor swift mentioned^did catch katy perry shade taylor swift week 'american idol^katy perry ca n't resist throwing shade taylor swift mentioned 'american idol^justin bieber cancels remaining dates purpose world tour^kaley cuoco marries equestrian karl cook romantic ceremony^from lady gaga katherine kelly top picks play princess diana series two 'feud'^here top picks play princess diana ryan murphy feud series^here top picks play princess diana ryan murphy feud^game of thrones stars kit harington rose leslie officially married,29,6,-23,35,0.8285714285714286,-0.6571428571428571,1
1289321,EastBayTimes,1094,61423,1450,149223,0,1,31,3,winner pulitzer prize breaking news reporting see latest news throughout east bay including contra costa alameda counties,who tonight third final presidential debate sen. barack obama sen. john mccain take poll^jennifer aniston short marriage justin theroux^after everything ben affleck wishes could win jennifer garner back new report says^jennifer lopez hired private detective check alex rodriguez cheating allegations report says^khloe kardashian allows tristan thompson delivery room daughter birth^how meghan markle kate middleton get along serena williams wimbledon final^ben affleck lindsay shookus friendship flirtation began still married jennifer garner^angelina jolie reported new boyfriend eect angelina jolie^are ben affleck jennifer lopez getting back together^after everything ben affleck wishes could win jennifer garner back new report says^the meghan markle bridezilla report tiara demand annoys queen elizabeth^katie holmes quit jamie foxx despite publicly humiliating women^jennifer lopez hired private detective check alex rodriguez cheating allegations report says^ann curry katie couric recall different memories matt lauer today^brad pitt hurricane katrina homes falling apart residents say new report^jennifer aniston short marriage justin theroux^ballistic khloe kardashian may early contractions family rushes cleveland^justin bieber hailey baldwin get marriage license or already married^matthew mcconaughey embrace donald trump^why kanye west think kim kardashian might divorce^angelina jolie agrees temporary truce brad pitt divorce war makes unpopular hollywood^maybe katie holmes jamie foxx really dating^kendall jenner blasts caitlyn jenner turning back family report says^meghan markle prince harry practically living together ready get engaged report says^julia roberts appears dismiss marital strife rumors posting rare photo husband^they foiled mariah carey weighs disastrous new year eve performance^julia roberts appears dismiss marital strife rumors posting rare photo husband^angelina jolie takes break nasty brad pitt divorce fight plead syrian refugees^brad pitt allow kids act angelina jolie maleficent sequel according report^selena gomez reveals kidney transplant lupus^cher says musical life want make gouge eyes that good right^after everything ben affleck wishes could win jennifer garner back new report says^was leah remini really wrong call jada pinkett smith scientologist^brady bunch house closes sale 3.5 million almost twice asking price^lady gaga announces las vegas residency,31,4,-27,35,0.8857142857142857,-0.7714285714285715,1
14434063,nytpolitics,286,460186,9202,122308,1,29,2,2,a fast-paced feed news analysis dispatches the new york times political team sign on politics email,long died george h.w bush went see funeral train commissioned carry coffin it^a criminal inquiry sought hillary clinton use email^a criminal inquiry sought hillary clinton email use secretary state^criminal inquiry sought hillary clinton use email^a criminal inquiry sought hillary clinton use email^transcript democratic presidential debate miami^transcript democratic presidential debate flint mich^transcript democratic presidential debate^missed last night democratic debate here transcript^senator elizabeth warren major foreign policy speech cited need rein unsustainable ill advise^read transcript third presidential debate donald trump hillary clinton.^read transcript third presidential debate donald trump hillary clinton.^read transcript third presidential debate donald trump hillary clinton.^key takeaways president trump first address joint session congress via^the full video transcript president trump first address joint session congress^analysis times reporters president trump first address joint session congress^key takeaways president trump first address joint session congress via^the full video transcript president trump first address joint session congress^missed last night democratic debate here transcript^transcript democratic presidential debate miami^transcript democratic presidential debate flint mich^read full transcript last democratic debate iowa caucuses feb^transcript democratic presidential debate^read full transcript barack obama speech south africa defended international institutions^read full transcript barack obama speech south africa defended international institutions^at campaign rally las vegas president trump said republicans protect patients pre exis^read full transcript barack obama speech south africa defended international institutions^read full transcript barack obama speech south africa defended international institutions^over objections state legislature alaska governor says eand medicaid^president trump speech cincinnati coincided worst single day decline dow jones average hist^go buy ivanka stuff i would say kellyanne conway said ethics eerts called violation.^go buy ivanka stuff i would say kellyanne conway said ethics eerts called violation.^stacey dash best known dionne davenport clueless running congress california^stacey dash best known dionne davenport clueless running congress california,3,31,28,34,0.08823529411764706,0.8235294117647058,0
17134268,CBSThisMorning,2829,380343,4430,129200,1,23,3,7,news matters original reporting weekday mornings a.m,watch sat lauren pierce bush children former president george h.w bush thi^the trump admin insists talks north korea get rid nuclear weapons track secretary state^now may aware going life last days i issued one state^federal health officials thursday reported first death ongoing salmonella outbreak linked raw turke^gun related deaths rise u.s. bucking decade long decline according new report c^watch senator john mccain warned american isolationism acceptance speech liberty award^rep. duncan hunter wife margaret hunter indicted federal grand jury tuesday charges using^rudy giuliani says president refuse interview special counsel robert mueller unless condition^president trump former lawyer michael cohen summer republican national committee deputy^watch sen. reflects john mccain legacy full interview co host^ahead on joins us live response horrific orlando mass shooting^six days midterm elections president trump trying shift debate health care econo^this week potus reversed admin policy separating migrant children its^federal health officials thursday reported first death ongoing salmonella outbreak linked raw turke^gun related deaths rise u.s. bucking decade long decline according new report c^watch sen. reflects john mccain legacy full interview co host^president trump headed nevada set address supporters make america great again rally las^rt thursday my interview president george w. bush^in interview donaldtrump blames president george w. bush /11 attacks^watch sen. reflects john mccain legacy full interview co host^four u.s. service members wounded extremist attack somalia killed one special operations sol^after midnight eastern time friday u.s. imposed tariffs 34 billion worth chinese goods the^the prices consumer goods including headphones speakers high tech lighting internet service could go u^the trump admin fired first shots looming trade war china after midnight et u.s. raised tariff^the gospel choir performed royal wedding prince harry meghan markle celebrating new achieve^is running president says clearly joke watch full clip tweet^everywhere goes today people still come say least consider so says^bill paxton family files wrongful death lawsuit hospital surgeon^the president stepping larry nassar sexual abuse scandal the former olympic do^mtv movie amp tv awards complete list winners^the newest teaser season house cards reveals fate kevin spacey character frank underwood s^emmy winning actress star julia louis dreyfus announced thursday diagnosed breast cancer^prince harry says wanted british royal family^richard simmons speaks facebook reassure fans ok hospitalized severe indigestion,4,30,26,34,0.1176470588235294,0.7647058823529411,0
24894496,billboardbiz,150,144868,2597,63410,1,0,6,27,business news site,music modernization act unanimously passes us house representatives^billboard music awards nominations see full list^here is complete list winners from billboard music awards updating live^travis scott pleads guilty disorderly conduct after allegedly inciting riot^fan sues gwen stefani amp live nation stampede that left her with broken leg^grammy awards see full winners list^miley cyrus breaks silence rootsy new music fiance liam hemsworth amp america 'unity is what we need^harry styles announces dates intimate world tour^katy perry unveils new album title 'witness announces fall tour dates^lin manuel miranda grandmother dies christmas day 'my heart is pieces^'american idol renewed second season abc^katy perry amp jennifer lopez join james corden 'carpool karaoke primetime special^katy perry amp jennifer lopez join james corden 'carpool karaoke primetime special^tony awards nominations the complete list^third suspect arrested connection with xxxtentacion murder^mtv movie amp tv awards complete winners list^ashley judd sues harvey weinstein sexual harassment defamation^justin timberlake announces man woods north american tour dates^here is complete list bet awards winners^mtv video music awards returning l.a.^jennifer hudson joins 'the voice coach season plus miley cyrus returns^taylor swift stalker sentenced years probation^lady gaga announces launch date for las vegas 'enigma residency^lady gaga announces las vegas residency 'i 'll leave my heart on stage every single night^billboard latin music awards complete winners list billboards2014 blma^billboard latin music awards complete winners list billboards2014 blma^billboard latin music award winners complete list^'rent set fox next live musical^cher announces broadway musical based her life coming^katharine mcphee david foster are engaged^billboard music awards nominations see full list^here is complete list winners from billboard music awards updating live^mtv emas taylor swift leads nominations^kelly clarkson host billboard music awards,7,27,20,34,0.2058823529411765,0.5882352941176471,0
2067661,WLWT,568,128367,1292,344422,2,2,9,21,leading way on air online on go,"melania trump undergoes kidney surgery walter reed medical center^people found dead ohio^most popular baby names every u.s. state^us slaps 50 billion tariffs chinese goods escalating trade dispute^what roseanne barr net worth^megyn kelly weighs matt lauer fired 'today show^megyn kelly weighs matt lauer fired 'today show^david cassidy fighting memory loss wants 'enjoy life^david cassidy fighting memory loss wants 'enjoy life^george clooney makes 27,283 every hour thanks tequila^mariah carey new year eve performance 'they foiled^'free speech rally 'fight supremacy groups set converge boston common^caitlyn jenner latest celebrity float run office^koko gorilla knew sign language dies^koko gorilla knew sign language dies^james franco event canceled actor denies allegations sexual misconduct^playboy found hugh hefner cause death revealed^playboy founder hugh hefner cause death revealed^playboy founder hugh hefner cause death revealed^mindy kaling reportedly pregnant first child^mindy kaling reportedly pregnant first child^'clueless actress stacey dash running congress california^kaley cuoco marries karl cook intimate horse ranch wedding^discovery channel 'storm chasers star joel taylor dead^discovery channel 'storm chasers star joel taylor dead^discovery channel 'storm chasers star joel taylor dead^discovery channel 'storm chasers star joel taylor dead^billboard music awards check complete list winners^everything need know 'this is us season^billboard music awards check complete list winners^netflix is reportedly reviving carmen sandiego with gina rodriguez^reese witherspoon confirms 'legally blonde happening^april giraffe pregnant^april giraffe pregnant",11,23,12,34,0.3235294117647059,0.35294117647058826,0
563957624,BritandCo,509,29206,549,62250,0,3,13,18,brit co media company inspires educates entertains real women creative spirit,these popular baby names state^these weirdest popular baby names state^these popular baby names state^response speculation pregnant make cheer^we 're happy princeharry addressed meghanmarkle pregnancy first time australia^may putting wedding office.^calls ruined double date .^reveals regrets wrecking ball video^dakota johnson chris martin reportedly dating^here fans freaking kate middleton recycled pregnancy coat^fuels engagement buzz grammys *huge* pink diamond ring^jenner opens life final surgery^baby board here meghanmarkle princeharry baby change line succession^texted ask pregnancy reports live tv.^icymi 're excited royalbaby ... so photos princeharry meghanmarkle cutest^reveals kidney transplant^elains kept pregnancy secret six months^turned role live action beauty beast^starz star engaged see ring debut^injured set new movie the rhythm section^rhoa star eecting first child husband marc daly^here grammys say performing^reportedly pregnant first child^a revival reportedly works^makes private cryptic post^here everything know pippa middleton wedding dress so far^tom jackson ex wife abby engaged^michael fassbender alicia vikander reportedly married^omg nickjonas priyankachopra reportedly engaged^says contractually done thor^looks like congratulations order confirms secretly married last year^princeharry meghanmarkle wedding cake flavor ode spring here details^blackfriday deals home goods sales miss^omg aprilthegiraffe pregnant,13,21,8,34,0.38235294117647056,0.2352941176470588,0
32432308,goodhousemag,2443,185333,1452,52375,0,0,20,14,decor inspo organizing tips recipe ideas advice help feel best follow us instagram,"what is roseanne barr net worth^a timeline prince harry meghan markle relationship^a timeline prince harry meghan markle relationship^a timeline matt lauer katie couric today show relationship^katie couric breaks her silence matt lauer firing from today show^john krasinski flew ,400+ miles every weekend see emily blunt his daughters^emma stone is vacation with justin theroux south france^tonya harding made it dancing with stars finale fans are livid^emma stone is vacation with justin theroux south france^meghan markle prince harry will reportedly have baby soon they can^katy perry reaction american idol contestant loving taylor swift is priceless^katy perry reaction american idol contestant loving taylor swift is priceless^ina garten jokes she responsible prince harry meghan markle getting engaged^people are freaking out over kate middleton new hair^people are freaking out over kate middleton new hair^gordon ramsay says he dropped over lbs save his marriage^katy perry reaction american idol contestant loving taylor swift is priceless^katy perry reaction american idol contestant loving taylor swift is priceless^why princess diana jewelry might start appearing public more after royal wedding^meghan markle prince harry will reportedly have baby soon they can^enrique iglesias anna kournikova welcome twins after dating years^dance moms star abby lee miller sentenced one year prison^kermit frog is getting new voice after years^meghan markle dad wo n't attend royal wedding new reports say^meghan markle dad will now attend royal wedding apparently^paula faris is leaving 'the view 'good morning america another role abc^kendall jenner basically went naked met gala^freeform '31 nights halloween schedule is finally here^john stamos is eecting his first child with fianc e caitlin mchugh^princess charlotte net worth is more than prince george here why^'counting on star john david duggar is officially engaged abbie burnett^justin theroux just broke his social media silence since split from jennifer aniston^all signs channing tatum jenna dewan were headed split^pauley perrette is leaving ncis after seasons",20,14,-6,34,0.5882352941176471,-0.17647058823529413,1
95214710,Indo_Style_,441,18434,132,39292,0,0,25,9,celebrity fashion beauty weddings sex relationships voices galleries style team ie instagram independentstyle,kim kardashian 'miserable annoyed husband kanye west refuses rest following hospitalisation^kim kardashian 'miserable annoyed husband kanye west refuses rest following hospitalisation^kim kardashian 'miserable annoyed husband kanye west refuses rest following hospitalisation^brad pitt makes bride day crashing wedding reception^'i 'm evolved romantic area cheryl sworn dating liam payne split.^lady gaga fianc taylor kinney split five years together^lady gaga fianc taylor kinney split five years together^lady gaga fianc taylor kinney split five years together^sharon ozzy osbourne split years marriage^jamie foxx 'good friend confirms katie holmes dating 'he happy^jamie foxx 'good friend confirms katie holmes dating 'he happy^jamie foxx 'good friend confirms katie holmes dating 'he happy^brody jenner kaitlynn carter tie knot indonesian island wedding today^angelina jolie finally breaks silence 'difficult brad pitt divorce^angelina jolie finally breaks silence 'difficult brad pitt divorce^angelina jolie finally breaks silence 'difficult brad pitt divorce^nick grimshaw spilling a listers angelina jolie 'cold will smith 'fake nice^selena gomez reveals kidney transplant donated friend due battle lupus disease^selena gomez reveals kidney transplant donated friend due battle lupus disease^kylie jenner baby stormi steal spotlight north west penelope disick birthday party^brad pitt 'completely devastated 'blindsided angelina jolie divorce.^brad pitt 'completely devastated 'blindsided angelina jolie divorce.^selena gomez finally opens relationship the weeknd^selena gomez finally opens relationship the weeknd^selena gomez finally opens relationship the weeknd^meghan markle arrives london ahead pippa middleton wedding^meghan markle arrives london ahead pippa middleton wedding^meghan markle arrives london ahead pippa middleton wedding^everything know pippa middleton wedding far^everything know pippa middleton wedding far^everything know pippa middleton wedding far^'it disability superpower kanye west diagnosed mental health condition^bradley cooper irina shayk welcome first child^kylie jenner 'pregnant u.s. reports,25,9,-16,34,0.7352941176470589,-0.4705882352941176,1
14182050,pinkvilla,751,867368,615,156217,0,0,28,6,your daily dose bollywood gossip fashion instagram youtube,are bradpitt jenniferaniston baby^ellen degenres wife portia de rossi slits wrists marriage problems portiaderossi^the internet accuses kim kardashian copying international beauty brand makeup collection nakedcherry^selenagomez worried ex boyfriend justinbieber consecutive emotional meltdowns^selenagomez thrown loop ex boyfriend justinbieber haileybaldwin marriage^did justinbieber marriage haileybaldwin play important role selenagomez emotional breakdown^george amal clooney welcome twins ella alexander georgeclooney amalclooney^justinbieber makes haileybaldwin priority guilt selenagomez emotional breakdown^haileybaldwin calls justinbieber 'incredible amidst reports singer selenagomez^angelina jolie dirt diary brad pitt boozing violent rages volatile behavior source claims^angelinajolie i n't enjoy single^bradpitt friends state actor never date celebrity angelinajolie drama^kanye west advised date kim kardashian^angelinajolie regrets relationship bradpitt wants life^selenagomez worried ex boyfriend justinbieber consecutive emotional meltdowns^angelinajolie regrets relationship bradpitt wants life^brangelina custody battle bradpitt meet children without angelinajolie permission^here bradpitt protect children custody battle angelinajolie^angelinajolie feels guilty trauma caused children due custody battle bradpitt^bradpitt angelinajolie ecret meeting bury hatchet amidst messy custody battle^angelina jolie lawyer quitting making divorce battle brad pitt hostile venomous^amidst divorce battle angelinajolie bradpitt date night special friend^bradpitt angelinajolie gear full blown custody battle december^selenagomez worried ex boyfriend justinbieber consecutive emotional meltdowns^sonam kapoor anand ahuja wedding here timeline relationship anandahuja^justinbieber makes haileybaldwin priority guilt selenagomez emotional breakdown^did justinbieber marriage haileybaldwin play important role selenagomez emotional breakdown^selenagomez worried ex boyfriend justinbieber consecutive emotional meltdowns^ed sheeran gets engaged longtime girlfriend cherry seaborn announces instagram^prince harry meghan markle royal wedding evolution royal wedding dress^robertpattinson nearly fired twilight^julia louis dreyfus diagnosed breast cancer julia louisdreyfus^leonardo dicaprio star quentin tarantino charles manson movie brad pitt tom cruise might join^indomitable taylorswift remade cover british vogue reputation,28,6,-22,34,0.8235294117647058,-0.6470588235294118,1
24920395,wjz,563,245768,1767,331997,0,27,2,4,the latest maryland news weather sports traffic wjz news tips -578-7568 e-mail newsroom.com download apps,"trump on capital gazette shooting president donald trump offered statement support journalists after^breaking new statement baltimore city public schools video teacher attacked^democratic debate bernie sanders really n't socialist president eisenhower^there cases possible confirmed acute flaccid myelitis united states year according^one four us adults sits eight hours day according new study us centers diseas^just in the centers disease control prevention urging americans eat romaine lettuce amid links^authorities say death centers disease control prevention employee whose body found river^with halloween right around corner centers disease control prevention asking owners chickens^pork roll recall a multistate outbreak listeria traced houston manufacturer vietnamese ready to^the life eectancy u.s. declined slightly last year according new data centers disease con^nearly ,000 people united states died guns last year marking highest number gun deaths ye^abortion rates united states dropped lowest level years according report released^an outbreak salmonella linked raw turkey products sickened least people across states us ce^the centers disease control prevention keeping close watch flu highest number deat^no raw cookie dough the centers for disease control prevention says raw cookie dough contain bacteria that^there cases possible confirmed acute flaccid myelitis united states year according^one four us adults sits eight hours day according new study us centers diseas^just in the centers disease control prevention urging americans eat romaine lettuce amid links^with halloween right around corner centers disease control prevention asking owners chickens^pork roll recall a multistate outbreak listeria traced houston manufacturer vietnamese ready to^the life eectancy u.s. declined slightly last year according new data centers disease con^nearly ,000 people united states died guns last year marking highest number gun deaths ye^abortion rates united states dropped lowest level years according report released^the centers disease control prevention keeping close watch flu highest number deat^no raw cookie dough the centers for disease control prevention says raw cookie dough contain bacteria that^coming up on wjz vice president joe biden delivers statement rose garden^hosting thanksgiving year the u.s. department agriculture tips prepare safe thanksgiv^the new york times revealed bannon scheduled appearance article monday morning wave criticism^bishop michael curry released statement undergo surgery prostate cancer on tuesday he gained gl^it 's official prince charles walk meghan markle aisle wedding prince harry saturday wa^kylie jenner happy snapchat new redesign snap stock closed thursday said i^actor shia labeouf arrested this time public drunkenness georgia^actor shia labeouf arrested this time public drunkenness georgia",2,31,29,33,0.060606060606060615,0.8787878787878788,0
21116401,KIRO7Seattle,9853,426843,3695,297828,0,4,6,23,news traffic weather seattle western wa download apps note tweets us may showcased media,sen. john mccain sits cbs exclusive interview u.s. role iraq live kiro right^photos democratic presidential debate new hampshire^update the fire north queen anne four alarm fire one building collapsed four buildings^breaking four alarm fire near seattle pacific university spread five buildings one collapsed pow^prince harry meghan markle a relationship timeline^international women day stars celebrate^katie couric breaks silence news matt lauer dismissal 'today^amal george clooney welcome twins^after years marriage al tipper gore announce separation^celebrities react death linkin park singer chester bennington^james franco denies allegations sexual misconduct^tamar braxton files divorce husband manager vincent herbert^meghan markle wo n't maid honor royal wedding^meghan markle dad heart surgery wo n't attend royal wedding report says^clay adler former mtv reality star dead^justin timberlake announces new album 'man woods^justin theroux breaks social media silence jennifer aniston split^former fox news ceo roger ailes dead^former fox news ceo roger ailes dead^storm chasers star joel taylor dead^john dickerson replaces charlie rose 'cbs this morning^john dickerson replaces charlie rose 'cbs this morning^labor day deals sales macy walmart best buy^labor day deals sales macy walmart best buy^bradley cooper irina shayk welcome first child reports say^snap inc. stock falls kylie jenner tweet snapchat redesign^celine dion donates concert proceeds victims las vegas shooting^celine dion donates concert proceeds victims las vegas shooting^man inspired als ice bucket challenge dead^michael jackson musical coming broadway^watch miley cyrus gives emotional performance 'malibu billboard music awards^kylie jenner pregnant according reports^ncis fan favorite pauley perrette leaving show seasons,6,27,21,33,0.18181818181818185,0.6363636363636364,0
14085146,WPXI,3565,194318,1353,305081,1,3,7,22,legalese if send us tweet consent letting wpxi use showcase media including tv,read transcript sen. jeff flake speech comparing pres donald trump josef stalin^read transcript sen. jeff flake speech comparing pres donald trump josef stalin^photos democratic presidential debate new hampshire^photos democratic presidential debate new hampshire^prince harry meghan markle a relationship timeline^international women day stars celebrate^katie couric breaks silence news matt lauer dismissal 'today^amal george clooney welcome twins^celebrities react death linkin park singer chester bennington^oprah 'intrigued idea running president friend gayle king says^kourtney kardashian scott disick back together^enrique iglesias anna kournikova reportedly welcome twins^tonight it season finale the final four acts take stage one last time winner i^james franco denies allegations sexual misconduct^tamar braxton files divorce husband manager vincent herbert^meghan markle wo n't maid honor royal wedding^mtv movie amp tv awards complete winners list^portia de rossi says steven seagal unzipped pants audition^meghan markle dad heart surgery wo n't attend royal wedding report says^clay adler former mtv reality star dead^justin timberlake announces new album 'man woods^justin theroux breaks social media silence jennifer aniston split^daytime emmy awards complete winners list^storm chasers star joel taylor dead^labor day deals sales macy walmart best buy^bradley cooper irina shayk welcome first child reports say^snap inc. stock falls kylie jenner tweet snapchat redesign^celine dion donates concert proceeds victims las vegas shooting^michael jackson musical coming broadway^michael jackson musical coming broadway^kelly clarkson set host 2018 billboard music awards^kylie jenner pregnant according reports^ncis fan favorite pauley perrette leaving show seasons,8,25,17,33,0.24242424242424246,0.5151515151515151,0
17919393,W7VOA,1994,88747,4167,111171,6,25,2,0,bureau chief past president member,the chaplain us house representatives rescinding resignation^first bill taken house representatives defeated it would cut legal immigration to^us house representatives vote tomorrow immigration legislation announces^us house representatives passes bipartisan legislation h.r keep taayer dollars hands of^from speaker us house representatives^trump failed protect nation port authority suspected bomber wrote facebook according terrori^the broadcast n't started yet due final minutes college basketball playoff game the^this afternoon ny taped interview airing tomorrow morning^on monday morning make first foreign policy speech titled after deal a new iran strategy^co chairman republican national committee bob paduchik run election instead serv^concerning speech today vfw annual national convention kansas city missouri^the president briefed flight receiving regular updates horrific tragedy pennsylvan^amid reports angered remarks director aspensecurityforum dan coats just^eressing support outreach dprk national intelligence director sa^one simple joys time public service getting meet many fascinating people walks^at yesterday hearing motion argued president unbridled authority pi^about minutes behind originally scheduled time briefing reporters singaporesummit^update give camera briefing :30 pm according^delayed briefing underway^correspondents many questions briefing scheduled today there b^added today schedule briefing :45 edt 19:45 gmt^the press briefing trump administration official outcome the^update th row historian meaning indeed make^confirmed administration official indeed speaking briefing room at^the occasional press briefing^and first briefing since europe trip underway^an increased emphasis non kinetic means new us counter terrorism strategy according spea^we 've informed get ready briefing g7charlevoix no word speaking us^no scheduled media briefing today quote tweeted^four fatalities others wounded suspect custody according one official source^the restaurant critic one died wrote food los angel^shots fired beverly hills house filming video via^in feb. specified enemy american peop,8,25,17,33,0.24242424242424246,0.5151515151515151,0
26289655,16WAPTNews,338,99246,678,184637,1,4,11,17,your guide breaking news weather central mississippi wapt news the one watch,"melania trump undergoes kidney surgery walter reed medical center^most popular baby names every u.s. state^most popular baby names every u.s. state^jackson police need help solving murder^us slaps 50 billion tariffs chinese goods escalating trade dispute^what roseanne barr net worth^megyn kelly weighs matt lauer fired 'today show^megyn kelly weighs matt lauer fired 'today show^icymi david cassidy fighting memory loss wants 'enjoy life^david cassidy fighting memory loss wants 'enjoy life^david cassidy fighting memory loss wants 'enjoy life^tonya harding made 'dancing with stars finale fans livid^tonya harding made 'dancing with stars finale fans livid^george clooney makes 27,283 every hour thanks tequila^mariah carey new year eve performance 'they foiled^caitlyn jenner latest celebrity float run office^james franco event canceled actor denies allegations sexual misconduct^playboy found hugh hefner cause death revealed^playboy founder hugh hefner cause death revealed^mindy kaling reportedly pregnant first child^producer dj avicii found dead^'clueless actress stacey dash running congress california^'clueless actress stacey dash running congress california^'clueless actress stacey dash running congress california^kaley cuoco marries karl cook intimate horse ranch wedding^discovery channel 'storm chasers star joel taylor dead^discovery channel 'storm chasers star joel taylor dead^discovery channel 'storm chasers star joel taylor dead^discovery channel 'storm chasers star joel taylor dead^billboard music awards check complete list winners^billboard music awards check complete list winners^netflix is reportedly reviving carmen sandiego with gina rodriguez^reese witherspoon confirms 'legally blonde happening",12,21,9,33,0.3636363636363637,0.2727272727272727,0
15375209,manilabulletin,213,594770,2911,593380,3,7,14,9,breaking news stories different sides rts journalists unparalleled journalism philippines since befullyinformed,mayor sara i opinion divorce i member house representatives prrd mak^read alvarez statement we undo past certainly shape future the house representativ^inside fake news sausage factory this income read befullyinformed^watch sec silvestre bello iii usec joel maglunsod issues classificatory statement labor depar^look quezon governor david suarez delivers speech celebration provincial children month today q^casilao anakpawis vehemently condemns statement made president food producers co^panelo jalandoni cites pronouncement dilg sec a o would arrested such statement made when^humble macron responds critics state union address^record us imports drive goods trade deficit china high august^cherry picking china looks replace us farm goods trade war^kim kardashian meeting trump prison reform^channing tatum jenna dewan split years marriage via^david cassidy fighting memory loss wants enjoy life read befullyinformed^david cassidy fighting memory loss wants enjoy life read befullyinformed^david cassidy fighting memory loss wants enjoy life read befullyinformed^trump warns north korea fire fury read befullyinformed^did miley cyrus liam hemsworth secretly get married read befullyinformed^did miley cyrus liam hemsworth secretly get married read befullyinformed^did miley cyrus liam hemsworth secretly get married read befullyinformed^channing tatum wife jenna dewan tatum announce split befullyinformed^channing tatum jenna dewan split years marriage via^mariah carey new year eve performance they foiled read befullyinformed^chris martin planning play argentina global citizen campaign^chris martin planning play argentina global citizen campaign^jada pinkett smith calls tupac biopic deeply hurtful read befullyinformed^james franco denies sexual misconduct allegations befullyinformed^james franco denies sexual misconduct allegations befullyinformed^james franco denies sexual misconduct allegations befullyinformed^matt damon apologizes comments sexual misconduct befullyinformed^matt damon apologizes comments sexual misconduct befullyinformed^bradley cooper irina shayk welcome first child read befullyinformed^reports say kylie jenner pregnant first child read befullyinformed^pregnant april giraffe calf due march,17,16,-1,33,0.5151515151515151,-0.030303030303030307,1
21320186,yahoolifestyle,16799,45777,669,35931,0,0,21,12,style beauty wellness coverage inspires informs includes everyone,the unhealthy habit contributed jennifer lawrence darren aronofsky split^'southern charm star cameran eubanks honest motherhood 'kate middleton walking hospital high hee^a timeline prince harry meghan markle relationship^sarah jessica parker says time apart from matthew broderick is 'beneficial their marriage^did pippa middleton ban meghan markle her wedding^hailey baldwin praises 'incredible hubby bieber new interview amid report 'not ex selena gomez^calls bad double date^kim kardashian thanked sisters saying looks anorexic people upset^not everyone thrilled taylor swift got political instagram 'be quiet sing^ivanka trump slammed fishing royal wedding invite^meghan markle prince harry love story from blind date fairy tale royal wedding^kids royals adorable pics kids freaking meet meghan markle kate middleton princess diana^kids royals adorable pics kids freaking meet meghan markle kate middleton princess diana^people are freaking out over kate middleton sexy look^'nope hair people feelings alessandra ambrosio senegalese twist braids^people really excited see meghan markle old style back^'utterly tasteless people freaking victoria david beckham kids shooting water guns british^things morning commute *princess charlotte turns today *brad pitt makes a^kate middleton massive fortune duchess here know royal net worth^wants 'be out spotlight until baby birth source^people ca n't get enough britney spears t shirt target men^anna kournikova and welcome twins in secret^koko gorilla learned sign language dies^helped formerly homeless pregnant fan buy house baby gear^josh brolin addresses diane lane domestic abuse arrest 'there elaining^elle king just skipped out her own wedding wildest reasons^priestley says he punched harvey weinstein face golden globes party^julia louis dreyfus diagnosed breast cancer speaks universal health care^alicia vikander michael fassbender are reportedly married after ibiza wedding^the unhealthy habit contributed jennifer lawrence darren aronofsky split^surprise ariana grande pete davidson are engaged after dating few weeks^meghan markle was n't allowed sit next prince harry pippa middleton wedding reception^meghan markle prince harry reveal royal wedding cake details everyone happy,21,12,-9,33,0.6363636363636364,-0.2727272727272727,1
300893869,DishNation,5843,109504,475,107279,0,0,26,7,dishnation tv show dishes celebrity news humorous commentary pop culture watch,it s over jennifer aniston amp justin theroux announce separation^yo philly kim kardashian powerful brand we tell even getting paid kanye her^is david hasselhoff robbing cradle oprah winfrey stedman graham heat things kitchen plus yo^/03/18 oprah winfrey says it s on when she cooks this for stedman graham via^hey nyc rumor mcrumor time ... are ben affleck jennifer garner spending nights together find pm^matt lauer pays price cardi b bounces back vmas and eddie murphy going ten tune to^the real reason selena gomez split from justin bieber^icymi kylie jenner is pregnant travis scott baby^hailey baldwin reportedly jealous justin bieber kourtney kardashian friendship should hailey worried^drake causing family drama reportedly hooking reality star indialove sister^tampa michael strahan shows bosses good morning america real boss :30pm^a former real housewife just confirmed that jamie foxx katie holmes are dating hollywood today live^katie holmes jamie foxx done ... but ever actually dating plus suge knight claims dr. dre pa^the one person thrilled about kourtney kardashian s recent breakup^is trouble paradise find victoriabeckham said marriage davidbeckham^/05/18 victoria beckham defends marriage to david beckham after his absence on first vogue cover via^dallas see n't feeling red hot red shoes dwarfs ad either :30pm on^hey orlando chris brown newest music video freaking us like watch midnight on^american idol tells come get it^yo philly it jay z amp anniversary recently brought jay tears tune find o^jennifer lopez alex rodriguez set engagement rumors straight rush marriage do th^/10/18 jennifer lopez and alex rodriguez are in no rush for marriage via^since katie holmes newly single reconnected dawson creek pal joshua jackson dishnation^selena gomez reveals kidney transplant summer^episode /14/17 selena gomez reveals she had a kidney transplant via^scott disick finds hard way n't easy dating younger women find sofia richie happy^engaged longtime girlfriend cherry seaborn^rachel mcadams sharing journey motherhood find waited long welcome first child^priyanka chopra nick jonas engaged after months dating think soon^michael b. jordan goes shirtless in creed ii first look^michael b. jordan goes shirtless in creed ii first look^meryl streep joins big little lies for season^khloe kardashian tristan thompson getting baby ready dish,26,7,-19,33,0.7878787878787878,-0.5757575757575758,1
20583090,ScottishSun,953,47124,550,204441,0,0,27,6,get latest scottish news entertainment sport no.1 scottish sun also facebook,kim kardashian kanye west kids look miserable head children fashion show la^this picture justin theroux cuddling close friend naomi watts upset wife jennifer aniston^revealed the reason behind jennifer lawrence darren aronofsky split^exclusive emma stone ryan gosling used body doubles complex dance routines la la land^revealed the real reason behind jennifer aniston justin theroux split^cheryl liam payne planned romantic duet split^cheryl reveals begged mum move liam payne split^cheryl finally say split liam payne elosive hit^cheryl reveals real reason split liam payne^cheryl opens painful reason behind split liam payne^liam payne opens split cheryl first time^katy perry puts raunchy performance incredible eye popping costumes tour la^katy perry proved biggest pop star world right raunchy rendition mega hit roar^katy perry puts raunchy performance la^do photos confirm justin bieber selena gomez back together^the crown films moment young prince charles camilla parker bowles fell love^keeping up with the kardashians spoilers khloe calls mum kris jenner w***e^keeping up with the kardashians spoilers khloe calls mum kris jenner w***e^this picture justin theroux cuddling close friend naomi watts upset wife jennifer aniston^exclusive from argentinian tycoon scary movie rapper six secret lovers prince harry bride meghan^prince harry meghan markle pay moving secret tribute princess diana ahead royalwedding^taylor swift hiding big secret^david beckham splashes 3m buy london pub mate guy ritchie^brad pitt vows year celibacy prompting heartbreak women across world^billy connolly wife blasts 'old fart parky 'dulled brain comments^sir billy connolly release two tv shows book despite 'dulled brain claims^actor matt smith undergoes chilling transformation new role charles manson^outlander fans go meltdown amid rumours caitriona balfe engaged^happy days star erin moran dead aged^revealed the real reason behind jennifer aniston justin theroux split^actor ed westwick accused sexual assault third woman^revealed the reason behind jennifer lawrence darren aronofsky split^ed sheeran fiancee cherry seaborn flashes new engagement ring day london,27,6,-21,33,0.8181818181818182,-0.6363636363636364,1
15933690,NBCDFW,2153,461271,2985,201623,1,3,2,26,the first tv station texas best place dfw go exclusive local stories latest breaking news weather updates nbc5investigates,set dvrs jenna bush hager host one hour special saturday honoring grandfather president george h.^sarah palin zings gop establishment cpac closing speech^federal health officials thursday reported first death ongoing salmonella outbreak linked raw turke^federal health officials thursday reported first death ongoing salmonella outbreak linked raw turke^president trump defends 'beautiful confederate statues^david cassidy fighting memory loss wants 'enjoy life^'fear factor revived mtv ludacris host^claims drugged actress 'bit beyonc face^star jones marries ricardo lugo cruise ship^'star wars the last jedi footage debuts disney d23 e. gt^anthony weiner sentenced months prison sexting minor^ntx superstar clarkson opens new interview when i really skinny i wanted kill myself.^'veronica mars brad bufanda dies suicide age^the truth days leading demi lovato overdose^see ren e zellweger transform judy garland first photo upcoming film^heather locklear arrested attacking cop emt^nd suspect murder rapper xxxtentacion arrested^miss north dakota cara mund crowned miss america^sedated seanpenn chain smokes bizarre 'late show appearance^howie mandel n't remember meghan markle 'deal no deal^harvey weinstein confirmed treatment amid sexual assault harassment scandal gt^breaking 'superman star margot kidder dead^janet jackson shares first photo baby boy eissa al mana gt^kate upton marries justin verlander lavish italian wedding^meghan markle deletes facebook instagram twitter^reveals pregnant baby boy^katharine mcphee david foster engaged^michael phelps nicole johnson welcome baby no gt^actresses protest sexual harassment wearing black golden globes^actress rosario dawson finds year old cousin dead l.a. home^actress brigitte nielsen says pregnant baby no^reality tv pregnant according reports,3,29,26,32,0.09375,0.8125,0
18391051,6abc,548,866301,2836,231255,0,5,4,23,philadelphia area news traffic weather politics sports wpvi including breaking news accuweather forecast,this day in history the patient protection affordable care act known obamacare signed law ye^this day in history the patient protection affordable care act known obamacare signed law ye^live video president trump eu commission president deliver statement rose garden^i 've enjoyed every single day the good ones bad ones john mccain life service mccain^i 've enjoyed every single day the good ones bad ones john mccain life service mccain^david cassidy fighting memory loss wants 'enjoy life^david cassidy fighting memory loss wants 'enjoy life^yay gma day michael strahan sara haines team co hosts gma day new third hour good mo^yay gma day michael strahan sara haines team co hosts gma day new third hour good mo^rapper nelly arrested suspicion rape^rapper nelly arrested suspicion rape^rapper nelly arrested suspicion rape^nd suspect arrested rapper xxxtentacion murder^nd suspect arrested rapper xxxtentacion murder^nd suspect arrested rapper xxxtentacion murder^happy nationalchocolateday here popular halloween candy state^happy nationalchocolateday here popular halloween candy state^happy nationalchocolateday here popular halloween candy state^happy nationalchocolateday here popular halloween candy state^actor vince vaughn arrested suspicion dui california^actor vince vaughn along passenger detained checkpoint police say he subsequently arr^just in meghan markle says dad attend royal wedding^supreme court declines hear appeal 'making murderer subject brendan dassey^supreme court declines hear appeal 'making murderer subject brendan dassey^supreme court declines hear appeal 'making murderer subject brendan dassey^congrats jenkintown bradley cooper girlfriend irina shayk welcome first child^new jersey rockers among rock roll hall fame inductees^new jersey rockers among rock roll hall fame inductees^new jersey rockers among rock roll hall fame inductees^r amp b singer brandy norwood hospitalized apparently losing consciousness plane lax authorities said^it official april giraffe pregnant^it official april giraffe pregnant,4,28,24,32,0.125,0.75,0
18527874,13wmaznews,514,69300,538,141674,0,0,5,27,central georgia leading news source follow wmaz latest breaking news top headlines,reports brad pitt accused child abuse investigation^channing tatum jenna dewan announce separation^channing tatum jenna dewan announce separation^channing tatum jenna dewan announce separation^angelina jolie breaks silence double mastectomy^koko gorilla knew sign language dies^walmart remove 'cosmopolitan magazine checkout lines amid me too movement^walmart remove 'cosmopolitan magazine checkout lines amid me too movement^walmart remove 'cosmopolitan magazine checkout lines amid me too movement^scott baio wife renee reveals microvascular brain disease diagnosis^scott baio wife renee reveals microvascular brain disease diagnosis^scott baio wife renee reveals microvascular brain disease diagnosis^xxxtentacion murder suspect arrested central georgia^report meghan markle dad longer attend royal wedding^report meghan markle dad longer attend royal wedding^'nypd blue creator steven bochco dead^'nypd blue creator steven bochco dead^'nypd blue creator steven bochco dead^reports priyanka chopra nick jonas engaged two months dating^reports priyanka chopra nick jonas engaged two months dating^reports priyanka chopra nick jonas engaged two months dating^lady gaga announces las vegas residency dates^lady gaga announces las vegas residency dates^cardi b confirms secretly married offset september 'engaged^cardi b confirms secretly married offset september 'engaged^cardi b confirms secretly married offset september 'engaged^wwe star vader dead age^wwe star vader dead age^wwe star vader dead age^prince william prince harry best man royal wedding^april giraffe pregnant^april giraffe pregnant,5,27,22,32,0.15625,0.6875,0
23788966,TALK1370,2625,2465,145,159967,0,3,6,23,the right choice austin breaking news weather sports am hd2 everywhere,"headlines michael cohen resigns republican national committee post^headlines multiple victims injured shooting near chicago hospital police say^headlines us announces tariffs 50b chinese goods trump says 'no trade war^entertainment chris pratt files divorce anna faris^entertainment oprah winfrey shares perfect date night longtime beau stedman graham^entertainment angelina jolie accuses brad pitt paying enough child support^entertainment you win 'pretty woman inspired shopping spree courtesy julia roberts^entertainment 'dancing stars judge carrie ann inaba host miss america competition^entertainment rachel bilson eddie cibrian talk crime solving dynamic take two^entertainment bill paxton family files wrongful death lawsuit hospital surgeon^entertainment david spade donates 100,000 mental health organization following kate death^entertainment jamie foxx host bet awards^entertainment dancing with stars pros val chmerkovskiy jenna johnson engaged^entertainment matt damon apologizes comments sexual misconduct^entertainment show bachelor nick viall fiancee vanessa grimaldi end engagement^entertainment 'house cards killed kevin spacey former president frank underwood^entertainment bachelor paradise season cast revealed^entertainment rob amp big star christopher big black boykin dead^entertainment tracee ellis ross host american music awards^sports tom brady eats first strawberry chugs beer stephen colbert^headlines queen elizabeth ii visits victims manchester arena attack hospital^entertainment jordan fisher lindsay arnold win dancing stars season^entertainment andrew garfield claims i gay man right ... without physical act^entertainment wonder woman london premiere canceled wake manchester bombing^entertainment meet women competing arie luyendyk jr. heart season the bachelor^entertainment kate winslet confirms leonardo dicaprio still quote titanic lines^sports serena williams withdraws australian open says 'i 'm i personally want^entertainment is khlo kardashian ready give tristan thompson boot^entertainment watch steven spielberg ready player one trailer^headlines all details prince harry meghan markle wedding rings^entertainment chris pratt files divorce anna faris^headlines april giraffe whose last birth drew millions livestreaming followers pregnant",6,26,20,32,0.1875,0.625,0
16161622,MyNBC5,697,35579,621,233767,2,7,8,15,the source news weather sports northern new york vermont new hampshire upper valley email us newstips.com,"melania trump undergoes kidney surgery walter reed medical center^people found dead ohio^follow live democratic presidential candidates debate manchester new hampshire^watch president trump ended speech tuesday national federation of independent business conference w^most popular baby names every u.s. state^most popular baby names every u.s. state^most popular baby names every u.s. state^breaking washington white house vice president joe biden make statement rose garden^us slaps 50 billion tariffs chinese goods escalating trade dispute^what roseanne barr net worth^david cassidy fighting memory loss wants 'enjoy life^david cassidy fighting memory loss wants 'enjoy life^icymi david cassidy fighting memory loss wants 'enjoy life^george clooney makes 27,283 every hour thanks tequila^mariah carey new year eve performance 'they foiled^mariah carey new year eve performance 'they foiled^caitlyn jenner latest celebrity float run office^james franco event canceled actor denies allegations sexual misconduct^playboy founder hugh hefner cause death revealed^playboy founder hugh hefner cause death revealed^playboy founder hugh hefner cause death revealed^mindy kaling reportedly pregnant first child^'clueless actress stacey dash running congress california^kaley cuoco marries karl cook intimate horse ranch wedding^discovery channel 'storm chasers star joel taylor dead^billboard music awards check complete list winners^billboard music awards check complete list winners^netflix is reportedly reviving carmen sandiego with gina rodriguez^reese witherspoon confirms 'legally blonde happening^april giraffe pregnant^april giraffe pregnant^april giraffe pregnant",10,22,12,32,0.3125,0.375,0
15764283,usatodaylife,3094,82506,1946,106462,0,3,11,18,latest entertainment celebrity news along movie tv reviews usa today updated life staff,roseanne barr went fox news thursday night first television interview since fired abc^can guess state highest number babies named colby danner cashton here popula^from jolisa libby names baby girls popular state^think kids ones eat poo play toilet clarkson ce^angelina jolie brad pitt finally getting married ok movie still^see timeline prince harry meghan markle royal relationship since started dating back^josh o'connor marion bailey joined cast thecrown prince charles queen mother^no jokes you 're going get trouble keeping pushing oscars^are katie holmes jamie foxx dating claudia jordan backpedals statement^the divorce custody battle brad pitt angelina jolie set go trial next month they^rough sunday kuwtk caught tristan thompson cheating^icymi justin theroux breaks silence heartbreaking divorce jennifer aniston^bachelor alum ben higgins fights 'fake news split lauren bushnell^brad pitt quit acting 'three years^a second suspect arrested charged first degree murder shooting death xxxtentacion^meghan trainor engaged 'spy kids star daryl sabara^youtube star austin jones millions teen followers arrested child pornography charges^a second suspect arrested charged first degree murder shooting death xxxtentacion^the wrongful death lawsuit filed jim carrey accusing illegally obtaining giving girlfr^merylstreep it hurt attacked rose mcgowan banner headlines weekend i want let know^jesse camp star mtv wan na be vj reported missing riverside calif. police his sister report^might practice dodging pelted water bottle refusing sing^uncle jesse becoming dad john stamos eecting first child fianc e caitlin mchugh^nick jonas priyanka chopra engaged and shared sweetest messages futu^congrats order former gameofthrones co stars kit harington rose leslie they 're married^rebecca gayheart files divorce husband eric dane years marriage^another tear jerker emerged movie beat awards season roma black white spanish^congratulations katharine mcphee david foster engaged^leonardo dicaprio star quentin tarantino charles manson movie^joins season cast americanhorrorstory photo getty^your holiday binge watch schedule got little crowded thanks theoa^icymi set headline coachella,11,21,10,32,0.34375,0.3125,0
66481133,TheNew93Q,10850,25627,152,89337,0,0,13,19,for new country always the fewest commercials,it official gwen stefani mentoring blake shelton team 'the voice season^song coming home playing mins the new q listen^prince harry meghan markle a relationship timeline^international women day stars celebrate^even gwen stefani shocked blake shelton miranda lambert split^even gwen stefani shocked blake shelton miranda lambert split^katie couric breaks silence news matt lauer dismissal 'today^keith urban nicole kidman beam pride exciting moment^keith urban gets downright sappy wife nicole kidman^celebrities react death linkin park singer chester bennington^oprah 'intrigued idea running president friend gayle king says^richard simmons sues radaronline national enquirer protect privacy^kourtney kardashian scott disick back together^enrique iglesias anna kournikova reportedly welcome twins^report scandal end season^james franco denies allegations sexual misconduct^tamar braxton files divorce husband manager vincent herbert^meghan markle maid honor royal wedding^mtv movie amp tv awards complete winners list^portia de rossi says steven seagal unzipped pants audition^meghan markle dad heart surgery wo n't attend royal wedding report says^clay adler former mtv reality star dead^justin timberlake announces new album 'man woods^justin theroux breaks social media silence jennifer aniston split^daytime emmy awards complete winners list^storm chasers star joel taylor dead^bradley cooper irina shayk welcome first child reports say^snap inc. stock falls kylie jenner tweet snapchat redesign^celine dion donates concert proceeds victims las vegas shooting^michael jackson musical coming broadway^watch miley cyrus gives emotional performance 'malibu billboard music awards^ncis fan favorite pauley perrette leaving show seasons,13,19,6,32,0.40625,0.1875,0
24036264,HotNewHipHop,1402,1174439,5028,302026,0,0,14,18,the source hottest hip-hop songs mixtapes videos news,did kanye confirm caitlyn jenner amp sophia hutchins relationship^did kanye confirm caitlyn jenner amp sophia hutchins relationship^back^kyliejenner reportedly pregnant travisscott baby yup^did kanye confirm caitlyn jenner amp sophia hutchins relationship^kim kardashian announces new release date kanye west yandhi^khloe kardashian reportedly making moves get revenge body^khloe kardashian reportedly making moves get revenge body^intrigued diea running president says^kyliejenner amp travisscott getting slammed seemingly looking bored jennifer lopez vma performance^kylie jenner plans return back spotlight gives birth read plan come o^continues shun family portrait spotlight^continues shun family portrait spotlight^kendall jenner may next^th arrested suspect xxxtentacion murder case plead guilty details^police arrested fourth suspect xxxtentacion murder details^a fourth suspect xxxtentacion murder arrested details^a fourth suspect xxxtentacion murder arrested details^police arrested fourth suspect xxxtentacion murder details^ariana grande mac miller remain best friends following break read grand'es statement^cabello announces never be the same tour dates^cabello announces never be the same tour dates^cabello announces never be the same tour dates^khloe kardashian ready marry tristan thompson gt^amp ready parenthood see sweet photo^amp ready parenthood see sweet photo^khloe kardashian ready marry tristan thompson gt^khloe kardashian ready marry tristan thompson^allegedly face felony charges assault case^allegedly face felony charges assault case get details^allegedly face felony charges assault case details^allegedly face felony charges assault case check,14,18,4,32,0.4375,0.125,0
5767092,ds_reality,70,11746,340,401071,1,0,18,13,latest reality tv news digital spy,miley cyrus definitely fan f**king nightmare donald trump 'if wins i 'm moving^janet street porter says taylor swift tom hiddleston romance fake he desperate bond^khloe kardashian thinks social media demonic 'it great thing get sucked^brad pitt officially starts hours le mans motorsport prestigious endurance race kicks^rihanna chris brown friends 'terrified reunion^kourtney kardashian 'mason jealous kim baby north west^have sharon ozzy osbourne agreed temporary split years marriage^hailee steinfeld swears dating justin bieber 'we 've friends years^katie holmes spotted mystery man new york^katie holmes 'mystery man named lawyer^christina aguilera engaged boyfriend matt rutler^taylor swift secretly helped kanye west write 'famous claims kim kardashian west^simon cowell returning american idol i interest^jennifer lopez devastated marc anthony divorce^noel gallagher slams harry styles solo debut 'my cat could 've written minutes^production cancelled robert de niro amp robert pattinson idol eye^robert pattinson canceled 'cosmpolis appearance says rep^production cancelled robert de niro amp robert pattinson idol eye^'i 've got back kylie jenner poses like kim kardashian supports big sister selfie war^katy perry announces huge uk arena tour dates new album witness 're year away^ed sheeran says not engaged girlfriend cherry seaborn^black lightning will join dc tv line the cw also renews the originals izombie^house cards season spoiler free reviews early signs mixed kevin spacey ruthless frank underwood^who house cards frank underwood talking camera kevin spacey answer might surprise^twin peaks returns everything know far season^twin peaks returns the cast plot characters everything need know season^wonder woman london premiere cancelled following manchester bombing^ryan murphy reveals american horror story season first ten minutes look like^ben affleck jennifer garner officially file divorce^bates motel series finale brings show amazing bittersweet end happened^once upon time season release date cast spoilers everything need know^mila kunis gives parents home surprise makeover mum reaction priceless,19,13,-6,32,0.59375,-0.1875,1
25087685,WomensHealthMag,785,4602672,17627,102355,0,0,21,11,get latest health fitness sex beauty,channing tatum jenna dewan tatum split years marriage^prince george reportedly getting security following isis threat via^tonya harding made dancing with stars finale fans livid via^channing tatum jenna dewan tatum split years marriage^caitlyn jenner ex posted shadiest instagram calling skipping brody wedding^the today show announced officially replace matt lauer^bachelorinparadise stars jared finally got happy ending but let see happened^there bachelorinparadise meltdown did n't see and n't crying^there bachelorinparadise meltdown did n't see and n't crying^bachelorinparadise stars jared finally got happy ending but let see happened^bachelorinparadise stars jared finally got happy ending but let see happened^there bachelorinparadise meltdown did n't see and n't crying^there bachelorinparadise meltdown did n't see and n't crying^i khloe kardashian revenge body workout weeks here happened^i khloe kardashian revenge body workout weeks here happened^i khloe kardashian revenge body workout weeks here happened^i revenge body workout weeks here happened^kate middleton cut hair people freaking^kate middleton cut hair people freaking^kate middleton cut hair people freaking^angelina jolie brad pitt divorce finalized soon^kelly clarkson when i really skinny i wanted kill^kelly clarkson when i really skinny i wanted kill^kelly clarkson when i really skinny i wanted kill^why meghan markle wo n't maid honor royal wedding^rachel mcadams reportedly pregnant first child^breaking meghan markle dad wo n't attend royal wedding fallout staged pictures^actress bella thorne says sexually abused age^actress bella thorne says sexually abused age^actress bella thorne says sexually abused age^priyanka chopra nick jonas reportedly engaged months dating^all signs channing tatum jenna dewan headed split,21,11,-10,32,0.65625,-0.3125,1
20643110,V103,13925,25369,373,48901,0,0,22,10,chicago radio station today r b throwbacks,karrueche tran granted five year restraining order against chris brown^american music awards nominations amas nominees full list^celebrities react nelsan ellis dead at^jamie foxx katie holmes finally out public as couple^beyonce not demanding silent delivery room despite report^celebrities react to hurricane irma^chris brown slammed by judge for skipping karrueche tran court hearing^katherine jackson resigns as blanket guardian^no drake is n't 'lusting after rihanna despite new rumors^katie holmes not pregnant and planning wedding with jamie foxx^sorry drake amp bella hadid are not 'secretly dating^kim kardashian slams cocaine claim 'i do not play with rumors like this^celebrity reactions prince harry meghan markle engaged^halle berry not pregnant at despite reports^mariah carey amp french montana did not flirt in recording studio^beyonce birth twins still hospital 'minor issue^karrueche tran granted five year restraining order against chris brown^chris brown urges fans to donate to year old boy 'new legs gofundme^celebrities react nfl players kneel lock arms during national anthem^oprah not running for president says gayle king^obamas celebrate th anniversary after false split stories^mariah carey not dating both nick cannon and bryan tanaka despite report^tisha campbell martin files for divorce from husband duane^khlo kardashian makes her first public appearance since pregnancy news^nelly officially under criminal investigation sexual assault^hugh hefner cause death revealed^alex rodriguez year old daughter sings for jennifer lopez photos^here the complete list of bet awards winners^star jones ex husband al reynolds comes out as bisexual in candid blog^tori kelly is engaged to german basketball player andre murillo^'black panther is officially the most tweeted about movie of all time^demi lovato announces tour with dj khaled see the dates,22,10,-12,32,0.6875,-0.375,1
38143084,StandardEnts,608,8587,169,45058,0,0,23,9,the latest celebrity tv music games evening standard,has jennifer aniston 'confronted selena gomez justin theroux friendship^kim kardashian begs tristan thompson unblock instagram^sarah jessica parker says imagine sex city without kim cattrall^fergie josh duhamel announce split eight years marriage^cheryl never date liam payne split^katy perry teased fans raunchy sneak peak moschino campaign^brad pitt looking serious relationship focuses children rather finding love^has jennifer aniston 'confronted selena gomez justin theroux friendship^josh o connor tipped play young prince charles the crown^sarah jessica parker says imagine sex city without kim cattrall^khlo kardashian 'wants marry tristan thompson amid reports spending 'quality time cleveland^we took look brad pitt relationship timeline jennifer aniston sinitta^are justin bieber hailey baldwin already married^brad pitt 'absolutely smitten mit professor neri oxman^is caitlyn jenner mystery celebrity big brother housemate^is caitlyn jenner mystery celebrity big brother housemate^brad pitt cleared child abuse investigation angelina jolie admits relieved^caitlyn jenner misses birth daughter kylie baby girl^travis scott pleads guilty disorderly conduct month baby kylie jenner^kris jenner 'planning adopt child boyfriend corey gamble^kylie jenner felt wrath jennifer lopez fans pictured looking bored mtvvmas set^selena gomez reveals kidney transplant donated best friend francia^piers morgan slates david beckham new hair i never get attraction^heidi klum reveals 'very single ready mingle ellen degeneres chat^when prince harry meghan markle engagement interview air tv time channel everything else ne^justin theroux breaks social media silence jennifer aniston split visit puppy shelter^avicii dead ex girlfriend posts moving tribute 'closest confidante dj death^congratulations karlie kloss engaged joshua kushner^bradley cooper irina shayk welcome first child^weinstein company file bankruptcy asset sale talks collapse^will smith in my feelings challenge even drake agrees^coachella line beyonc eminem the weeknd confirmed headline us festival,23,9,-14,32,0.71875,-0.4375,1
1019340242619285504,microsoftnews,459,1164,20,39400,0,0,26,6,trusted news world best journalists,lindsay lohan unusual dance moves mykonos go viral^pregnant cradles baby bump form fitting maxi dress^shows off growing baby bump^shows baby bump nyc pregnancy reveal^pregnant jessica simpson glows first baby bump pic^matt lauer inching 'his way back society 'today ousting^meghan markle mom doria ragland is looking forward becoming grandmother i 'm 'very happy^kim kardashian embarrassed kanye visit trump source^see julia roberts birthday message richard gere^'not despite new wife source^see julia roberts birthday message richard gere^hoda kotb al roker amp craig melvin open megyn kelly today hour first show since cancellation^pregnant cradles baby bump form fitting maxi dress^shows off growing baby bump^shows baby bump nyc pregnancy reveal^pregnant jessica simpson glows first baby bump pic^report kendall jenner rips caitlyn 'turning back family^spied visiting katie holmes n.y.c amid romantic summer^see julia roberts birthday message richard gere^spied visiting katie holmes n.y.c amid romantic summer^brad pitt angelina jolie get trial date their custody battle^angelina beams grocery run kids amid battle brad pitt^brad pitt angelina jolie ugly custody battle latest^brad pitt angelina jolie could messy custody battle get worse^brad pitt ickened angelina jolie public custody battle source^this was prince harry meghan markle favorite moment their royal wedding^mraz opens 'two spirit sexuality^'brady bunch house sale 1.85 million^here 'house cards wrote kevin spacey frank underwood^former mtv vj jesse camp reported missing sister^first aquaman trailer makes splash comic con^john david duggar engaged abbie grace burnett,26,6,-20,32,0.8125,-0.625,1
31181674,CountryLiving,1652,544905,2125,46596,0,0,28,4,like new page with focus decorating gardening cooking country living beats path home really matters,how keith urban marriage nicole kidman completely turned life around^how blake shelton gwen stefani went 'the voice co stars one music hottest couples^katie couric breaks her silence on matt lauer firing from the today show^how blake shelton gwen stefani went 'the voice co stars one music hottest couples^tonya harding made it dancing with stars finale fans are livid^nicole kidman keith urban love well decade love one another never be^nicole kidman keith urban love well decade love one another never be^nicole kidman keith urban love well decade love one another never be^nicole kidman keith urban love well decade love one another never be^nicole kidman keith urban love well decade love one another never be^nicole kidman keith urban love well decade love one another never be^nicole kidman keith urban love well decade love one another never be^nicole kidman keith urban love well decade love one another never be^nicole kidman keith urban love well decade love one another never be^nicole kidman keith urban love well decade love one another never be^nicole kidman keith urban love well decade love one another never be^nicole kidman keith urban love well decade love one another never be^nicole kidman keith urban love well decade love one another never be^nicole kidman keith urban love well decade love one another never be^nicole kidman keith urban love well decade love one another never be^katy perry reaction american idol contestant loving taylor swift is priceless^how blake shelton gwen stefani went 'the voice co stars one music hottest couples^exclusive katie couric reveals whether she would return host 'today show^how blake shelton gwen stefani went 'the voice co stars one music hottest couples^how blake shelton gwen stefani went 'the voice co stars one music hottest couples^whoa 'flip flop star christina el moussa her sister could seriously be twins^how blake shelton gwen stefani went 'the voice co stars one music hottest couples^katy perry reaction american idol contestant loving taylor swift is priceless^breaking meghan markle dad wo n't attend royal wedding after fallout from staged pictures^freeform just announced its '31 nights halloween schedule it bigger better than last year^freeform '13 nights halloween schedule is finally here^meghan markle prince harry reportedly did n't sit together pippa middleton wedding,28,4,-24,32,0.875,-0.75,1
8839632,NBCNightlyNews,478,986121,11041,139556,3,21,0,7,breaking news in-depth reporting context news around world full episodes newsletter,the suspect new york city subway blast posted message pres trump facebook page the^live president trump addresses nation florida school shooting watch live nbc the^george h.w bush heard eulogy died^a polio like condition called acute flaccid myelitis likely caused viruses probably single vi^one person died made sick outbreak salmonella linked raw turkey centers for^democrats hold point advantage heading midterm elections poll finds^the u.s. department education announced thursday would automatically cancel 150 million student loans con^according latest data collected u.s. department education public school districts reported restra^live president trump makes remarks national federation independent business th anniversary celebration^a polio like condition called acute flaccid myelitis likely caused viruses probably single vi^one person died made sick outbreak salmonella linked raw turkey centers for^democrats enjoy point advantage republicans congressional preference midterm elections e^pres obama new supreme court nomination i going present someone indisputably qualified seat^senator john mccain words^senator john mccain in words for legacy^senator john mccain words live coverage today memorial service^senator john mccain in words^watch senator john mccain words shares senator remembered^live white house press briefing watch facebook page^live white house press briefing watch facebook page^live white house press briefing watch facebook page^live white house press briefing watch facebook page^ready eat salads made small suppliers across country recalled might contaminate^ready eat salads made small suppliers across country recalled might contaminate^bill cosby found guilty sexual assault retrial^bill cosby found guilty sexual assault retrial more tonight^meghan markle future father law prince charles walk aisle royal wedding.^meghan markle future father law prince charles walk aisle royal wedding.^meghan markle dad wo n't attend royal wedding prince harry st^just in us supreme court declines hear appeal brendan dassey whose murder conviction subject 'ma^just in country music star loretta lynn admitted nashville hospital suffering stroke home statement website says,3,28,25,31,0.0967741935483871,0.8064516129032258,0
15727981,nbc6,992,299684,2584,166323,1,4,3,23,south florida trusted source breaking news weather traffic watch us live /7 nbc6 app,jenna bush hager host one hour special saturday honoring grandfather president george h.w bush who^i sitting trying find collusion crime collusion crime giuliani said inter^watch live vice president joe biden deliver statement rose garden^breaking vice president joe biden deliver statement rose garden^watch live hillary clinton speaks campaign rally las vegas^comedian hannibal buress arrested miami disorderly intoxication^comedian hannibal buress arrested miami disorderly intoxication authorities say^famous feuds oprah takes chris brown love triangles controversial politics friendships gone bad these..^here help victims families las vegas mass shooting^netflix stranger things officially renewed season^lindsey vonn fires back twitter trolls winning medal first olympics race^that stunt talk show host wendy williams faints live tv^thank chrissy teigen live tweeting jesus christ superstar live^miley cyrus retracts apology nude vanity fair portrait^breaking nd suspect last month murder rapper xxxtentacion arrested bso says^heather locklear hospitalized minor injuries car crash^meet duke duchess sussex what prince harry meghan markle new royal titles mean^'superman star margot kidder dead^portia de rossi says steven seagal unzipped pants audition^scandal series finale ends happily thought possible^carrie underwood says needed stitches nasty fall^golden globes telecast live streamed first time^caitlyn jenner says n't talked kim kardashian year^billboard latin music awards finalists the full list^demi lovato sings breaking sobriety new song sober^ghostbusters ii child star hank deutschendorf dies apparent suicide^meghan markle deletes facebook instagram twitter ahead royal wedding^actor terry crews reports alleged sexual assault la police sources^geraldo rivera apologizes bette midler alleged groping incident^lena dunham animal shelter feuding old dog lamby^yes april giraffe pregnant,4,27,23,31,0.12903225806451613,0.7419354838709677,0
42958829,CBSEveningNews,1546,316549,4271,101547,3,19,2,7,the official account the cbs evening news longest running evening newscast,more nyc bombing suspect says picked workday attack terrorize many people possible he pos^trump failed protect nation nyc subway bombing suspect akayed ullah taunted president trump faceb^at least seven people found dead ohio home^as juul halts store sales flavored e cigarettes company ceo said statement ... numbers tel^sec pompeo u.s. relationship saudis pres trump issues statement support crown prince this^this big day free fair trade big day indeed pres trump says conclusion statement^this trade war cutting legs farmers white house 'plan spend 12 billion gold^after president returns europe sit follow i^watch president trump tells going helsinki summit low eectations h^discusses summit pres trump n. korea kim jong un singapore on^new interviews president trump scotland ahead monday summit russian president vladimir puti^how to watch cbs news coverage helsinki summit president trump amp russian pres vladimir putin begin^will trump agree interview mueller our spoke president trump lawyer rudy giuliani w^tomorrow sits co host first interview since late hus^more suspicious packages mailed different targets george soros former sec state hillary clinto^i concerns. secretary state nominee rex tillerson interview^tomorrow sits co host first interview since late hus^full transcript president donald trump interview face nation^tomorrow sits co host first interview since late hus^white house press sec sarah sanders denounced threats made trump officials daily^the white house continuing make progress north korea tells daily brief^the prognosis may grim attitude one officer fighting stage four kidney cancer sunny de^their performance wedding prince harry meghan markle brought worldwide audience feet now^says oprah winfrey never running president^bill paxton family files wrongful death lawsuit hospital surgeon^the defense blasted bill cosby accuser today opening statement sexual assault retrial the jury dead^prince harry engaged actress meghan markle reports^just in says 've suspended production notice give us time revi^final preparations underway england saturday royal wedding but last minute change^it trappings ordinary emmy acceptance speech director glen weiss segued finding^pauley perrette announces leaving ncis seasons,5,26,21,31,0.16129032258064516,0.6774193548387096,0
7587032,SkyNews,27,5155419,25009,356337,2,14,4,11,we take heart stories shape world for breaking news follow,us france never lost special bond speaking house representatives on^prosecutors revealed new york subway bomb suspect wrote facebook trump failed protect na^i n't say deal perfect never going nature negotiation ... let^these horrifying shameful unforgivable actions need disclosed criminal court jury decide and^there institutionalised practice shortening lives former bishop liverpool james jones giving a^in last century doubled life eectancy mankind goes science robust nhs.^may says brexit negotiations end game the prime minister also addressed uk re^highlights week include adam boulton interview filmmaker michael moore^hillary clinton pays tribute victims orlando mass shooting praises first responders survivors^outrage lush ad campaign cosmetics firm claims police 'paid lie^opening debate changes eu withdrawal bill brexit secretary david davis warns mps attempt m^artist damel carayol handed print painting entitled 'eye sore the final straw prime minister d^if consent drunk is consent a study estimates one four students across america wi^is local house fraser one four shut rent row^as many one four students subjected serious sexualassault graduate according to^if consent drunk is consent a study estimates one four students across america wi^the duchess cambridge crowned year top royal style influencer^'the safety american people highest absolute priority president donald trump says major feder^amal george clooney welcome twins ella alexander^david beckham hirked responsibility speeding charge say road safety groups^prince harry asks william best man^ed sheeran engaged long term girlfriend cherry seaborn^ed sheeran announced engaged girlfriend cherry seaborn^love island star sophie gradon dead^kevin spacey house of cards character frank underwood killed^meghan father walk aisle royal wedding^actress julia louis dreyfus revealed diagnosed breast cancer^prince harry admitted wanted royal family^reality tv star kylie jenner pregnant first child according reports^reality tv star kylie jenner pregnant first child according reports^sir roger moore james bond star dead,6,25,19,31,0.1935483870967742,0.6129032258064516,0
19032473,9NEWS,930,438111,3537,436225,0,4,6,21,the official twitter news denver co interact us beon9 wx we also retweet news team,ny mayor stopping mosque compromises terror fight news^in first address joint session congress president trump stuck closely prepared remarks ran^here full text president trump feb. address joint session congress prepared for^obama campaign woos hispanics tv radio ads news^meghan markle walked aisle looking serene peaceful but us know weddings stressful es^emmy awards the winners list^emmy awards the winners list^channing tatum jenna dewan announce separation^channing tatum jenna dewan announce separation^channing tatum jenna dewan announce separation^koko gorilla knew sign language dies^walmart remove 'cosmopolitan magazine checkout lines amid me too movement^walmart remove 'cosmopolitan magazine checkout lines amid me too movement^walmart remove 'cosmopolitan magazine checkout lines amid me too movement^scott baio wife renee reveals microvascular brain disease diagnosis^scott baio wife renee reveals microvascular brain disease diagnosis^scott baio wife renee reveals microvascular brain disease diagnosis^erin moran former happy days child star found dead indiana home weekend likely died^mindy kaling is reportedly pregnant with her first child^bet awards the complete winners list^reports priyanka chopra nick jonas engaged two months dating^reports priyanka chopra nick jonas engaged two months dating^reports priyanka chopra nick jonas engaged two months dating^lady gaga announces las vegas residency dates^lady gaga announces las vegas residency dates^lady gaga announces las vegas residency dates^wwe star vader dead age^wwe star vader dead age^wwe star vader dead age^april giraffe pregnant^april giraffe pregnant,6,25,19,31,0.1935483870967742,0.6129032258064516,0
18655359,ABC10,2043,153724,1551,190835,0,0,6,25,welcome abc10 twitter,kim kardashian returns white house make case another convict release^channing tatum jenna dewan announce separation^channing tatum jenna dewan announce separation^channing tatum jenna dewan announce separation^kate winslet leonardo dicaprio dates oscars sunday night themoreyouknow^julie bowen mom suggested using toaster gynecology check^koko gorilla knew sign language dies^walmart remove 'cosmopolitan magazine checkout lines amid me too movement^scott baio wife renee reveals microvascular brain disease diagnosis^scott baio wife renee reveals microvascular brain disease diagnosis^scott baio wife renee reveals microvascular brain disease diagnosis^report meghan markle dad longer attend royal wedding^former fox news ceo roger ailes dead^'nypd blue creator steven bochco dead^'nypd blue creator steven bochco dead^'nypd blue creator steven bochco dead^reports priyanka chopra nick jonas engaged two months dating^reports priyanka chopra nick jonas engaged two months dating^reports priyanka chopra nick jonas engaged two months dating^lady gaga announces las vegas residency dates^lady gaga announces las vegas residency dates^lady gaga announces las vegas residency dates^cardi b confirms secretly married offset september 'engaged^cardi b confirms secretly married offset september 'engaged^cardi b confirms secretly married offset september 'engaged^wwe star vader dead age^wwe star vader dead age^wwe star vader dead age^prince william prince harry best man royal wedding^april giraffe pregnant^april giraffe pregnant,6,25,19,31,0.1935483870967742,0.6129032258064516,0
16870853,SPIN,1163,484132,11572,87672,0,0,7,24,alternative music culture since,watch learn use gun needed me video^shots fired ix9ine kanye west nicki minaj video shoot^shots fired ix9ine kanye west nicki minaj video shoot^kim kardashian west announces new release date kanye west 'yandhi album^kim kardashian west announces new release date kanye west 'yandhi album^mariah carey issues personal statement nye performance they foiled^kanye west livestreamed speech africa mind control^courtney love warned young women harvey weinstein^courtney love warned young women harvey weinstein^second suspect arrested xxxtentacion murder case^second suspect arrested xxxtentacion murder case^engaged longtime girlfriend cherry seaborn^a suspect reportedly arrested xxxtentacion murder case^the fourth last suspect xxxtentacion murder case arrested florida^the fourth final suspect xxxtentacion murder case arrested florida^second suspect arrested xxxtentacion murder case^second suspect arrested xxxtentacion murder case^another murder suspect xxxtentacion shooting case arrested^another murder suspect xxxtentacion shooting case arrested^former mtv vj jesse camp reported missing california^former mtv vj jesse camp found reported missing^former mtv vj jesse camp reported missing california^former mtv vj jesse camp found reported missing^justin timberlake announces new album 'man woods^listen dj khaled justin bieber chance the rapper quavo new song no brainer^listen dj khaled justin bieber chance the rapper quavo new song no brainer^listen dj khaled justin bieber chance the rapper quavo new song no brainer^lady gaga announces las vegas residency^lcd soundsystem gavin russom comes transgender^lcd soundsystem gavin russom comes transgender^taylor swift announces new album 'reputation,7,24,17,31,0.2258064516129032,0.5483870967741935,0
14427407,WVTM13,1130,65074,903,235648,1,5,6,19,wvtm13 home central alabama breaking news sports weather,"melania trump undergoes kidney surgery walter reed medical center^most popular baby names every u.s. state^most popular baby names every u.s. state^most popular baby names every u.s. state^breaking vice president joe biden make statement momentarily white house rose garden^us slaps 50 billion tariffs chinese goods escalating trade dispute^what roseanne barr net worth^david cassidy fighting memory loss wants 'enjoy life^david cassidy fighting memory loss wants 'enjoy life^george clooney makes 27,283 every hour thanks tequila^mariah carey new year eve performance 'they foiled^caitlyn jenner latest celebrity float run office^koko gorilla knew sign language dies^james franco event canceled actor denies allegations sexual misconduct^playboy founder hugh hefner cause death revealed^playboy found hugh hefner cause death revealed^playboy founder hugh hefner cause death revealed^mindy kaling reportedly pregnant first child^'clueless actress stacey dash running congress california^'clueless actress stacey dash running congress california^'clueless actress stacey dash running congress california^kaley cuoco marries karl cook intimate horse ranch wedding^discovery channel 'storm chasers star joel taylor dead^billboard music awards check complete list winners^billboard music awards check complete list winners^billboard music awards check complete list winners^billboard music awards check complete list winners^netflix is reportedly reviving carmen sandiego with gina rodriguez^reese witherspoon confirms 'legally blonde happening^aprilthegiraffe pregnant^april giraffe pregnant",7,24,17,31,0.2258064516129032,0.5483870967741935,0
21143468,KISSFMPhoenix,10934,49791,877,86210,0,0,11,20,the valley hit music station in the morning snapchat kissfmphoenix instagram kissfmphoenix,sag awards nominations see full list of screen actors guild nominees^pranked^sorry amp secretly dating^amp bradleycooper looked elegant premiere movie astarisborn^amp returned pda filled trip jamaica dad wedding selenators^wants people donate year old boy new legs^we moon excited next royalbaby meghanmarkle princeharry royalbabywatch^iggy azalea blasts nick young after accidental dinner reunion^these things characters originally going die season^incorrect rumors princeharry fiance royalwedding2018^report jessica simpson pregnant trending via^some biggest pop culture moments described cheese everything birth twin^the bachelor bekah m was on missing persons list until fan recognized her^the bachelor bekah m was on missing persons list until fan recognized her^rachel mcadams is reportedly pregnant with her first child^rachel mcadams is reportedly pregnant with her first child^demi lovato reveals that she contemplated suicide at age^demi lovato reveals that she contemplated suicide at age^jenny slate and chris evans break up again^jenny slate and chris evans break up again^justin timberlake announces 'the man of the woods tour see the dates^watch harry styles kiss james corden in christmas themed 'carpool karaoke^watch harry styles kiss james corden in christmas themed 'carpool karaoke^'storm chasers star joel taylor dead at^'storm chasers star joel taylor dead at^icymi eazy got arrested assault amp cocaine possession sweden ...^camila cabello announces her 'never be the same tour see the dates^gigi hadid slams body shamers for calling her 'too skinny at nyfw^gigi hadid slams body shamers for calling her 'too skinny at nyfw^'black panther is officially the most tweeted about movie of all time^'black panther is officially the most tweeted about movie of all time,11,20,9,31,0.3548387096774194,0.2903225806451613,0
23085284,WMTWTV,417,83930,667,247926,1,2,11,17,real-time updates wmtw news maine total weather news coverage,"melania trump undergoes kidney surgery walter reed medical center^most popular baby names every u.s. state^us slaps 50 billion tariffs chinese goods escalating trade dispute^what roseanne barr net worth^megyn kelly weighs matt lauer fired 'today show^megyn kelly weighs matt lauer fired 'today show^david cassidy fighting memory loss wants 'enjoy life^david cassidy fighting memory loss wants 'enjoy life^tonya harding made 'dancing with stars finale fans livid^tonya harding made 'dancing with stars finale fans livid^george clooney makes 27,283 every hour thanks tequila^mariah carey new year eve performance 'they foiled^'free speech rally 'fight supremacy groups set converge boston common^caitlyn jenner latest celebrity float run office^koko gorilla knew sign language dies^james franco event canceled actor denies allegations sexual misconduct^playboy founder hugh hefner cause death revealed^playboy founder hugh hefner cause death revealed^playboy founder hugh hefner cause death revealed^mindy kaling reportedly pregnant first child^'clueless actress stacey dash running congress california^'clueless actress stacey dash running congress california^kaley cuoco marries karl cook intimate horse ranch wedding^discovery channel 'storm chasers star joel taylor dead^discovery channel 'storm chasers star joel taylor dead^discovery channel 'storm chasers star joel taylor dead^billboard music awards check complete list winners^billboard music awards check complete list winners^netflix is reportedly reviving carmen sandiego with gina rodriguez^reese witherspoon confirms 'legally blonde happening^april giraffe pregnant",12,19,7,31,0.3870967741935484,0.2258064516129032,0
20687592,xl1067,3413,43564,464,42947,0,0,17,14,orlando hit music station home ////,john mayer has been hospitalized emergency appendectomy^chris pratt files divorce from anna faris^sharon osbourne apologizes to justin bieber 'i was wrong to 'attack you^selena gomez vogue cover story see interview highlights^celebrities react to hurricane irma^no drake is n't 'lusting after rihanna despite new rumors^taylor swift wins countersuit against dj david mueller in groping trial^robert pattinson amp katy perry are not dating^meghan markle twins with kate middleton during outing with queen^joe jonas sophie turner 'already thinking of having kids is made up story^jessica simpson gives birth baby boy^chris brown urges fans to donate to year old boy 'new legs gofundme^iggy azalea blasts nick young after accidental dinner reunion^fans react u2 cancels st. louis concert amid police protests^no zayn is not 'desperate to defend girlfriend gigi hadid^selena gomez reveals she had a kidney transplant amp her friend was her donor^selena gomez reveals she had a kidney transplant amp her friend was her donor^here how help victims las vegas mass shooting^taylor swift teases new song 'gorgeous on instagram listen to a snippet^bachelor nick viall vanessa grimaldi split end engagement^rachel mcadams is reportedly pregnant with her first child^demi lovato reveals that she contemplated suicide at age^taylor swift teases new song 'gorgeous on instagram listen to a snippet^kim kardashian shares first photo baby chicago west^bachelorette peter kraus reveals he suffered eating disorder^tori kelly is engaged to german basketball player andre murillo^watch harry styles kiss james corden in christmas themed 'carpool karaoke^jennifer lawrence darren aronofsky split^taylor swift announces new album 'reputation see the cover art^camila cabello announces her 'never be the same tour see the dates^chris pratt files divorce from anna faris,17,14,-3,31,0.5483870967741935,-0.0967741935483871,1
21142818,KISSFMSEATTLE,627,22114,367,38783,0,0,26,5,home the carla marie anthony show,sag awards nominations see full list of screen actors guild nominees^chris pratt files divorce from anna faris^ed sheeran did not 'break friendship code with taylor swift^jamie foxx katie holmes finally out public as couple^celebrities react trump withdraws steph curry white house invitation^are selena gomez amp the weeknd working on a movie together^stars celebrate rosh hashanah see celebrity tweets about jewish new year^brad pitt gq divorce interview highlights on angelina jolie kids and drinking^selena gomez vogue cover story see interview highlights^katie couric said matt lauer pinched her on the ass on 'today back in^jennifer garner ben affleck file for divorce amid false reconciliation rumor^celebrities react to hurricane irma^katie holmes not pregnant and planning wedding with jamie foxx^lady gaga taylor kinney not secretly dating despite late and wrong report^kristen stewart on dating robert pattinson 'the public were the enemy^wow see poor girl lips tried get done like nsfw^kim kardashian not attending paris fashion week despite claims^kate hudson brad pitt false dating rumor mocked by oliver hudson photo^halle berry not pregnant at despite reports^watch kim kardashian first interview since robbery on 'ellen degeneres show videos^chloe grace moretz apologizes for 'red shoes marketing^twitter reacts zoe saldana says hollywood bullied donald trump^fans react u2 cancels st. louis concert amid police protests^no zayn is not 'desperate to defend girlfriend gigi hadid^mariah carey not dating both nick cannon and bryan tanaka despite report^michael strahan 'looking forward to working with alex rodriguez at abc^rachel mcadams is reportedly pregnant with her first child^elle king skipped wedding^jenny slate and chris evans break up again^'storm chasers star joel taylor dead at^chris pratt files divorce from anna faris,26,5,-21,31,0.8387096774193549,-0.6774193548387096,1
31127446,markknoller,2236,324723,9362,134507,1,28,1,0,cbs news white house correspondent,despite gop sizeable loss house representatives pm abe congratulated pres trump historic victo^pres trump justice kavanaugh investiture ceremony morning and members court p^biden urged democratic donors empty checkbooks sen. michael bennet appointed us senate seat last december^pres calls another host stage deliver remarks full praise trump agenda^the mueller investigation continue says morning in interview conway said^chooses charlotte north carolina site republican national convention says rnc committee members^it tax policy center urban institute brookings institution^pres trump heading indianapolis previously scheduled speech future farmers america convention^pres trump arrived indianapolis speech convention told reporters air force one ma^pres trump condemns synagogue shooting wicked act mass murder at start speech ffa convention in^i actually get along well rod said today asked deputy ag rosenstein amp atty gen sessions be^pres responds filing michael cohen case tweet containing six words exclamation point totally^chooses charlotte north carolina site republican national convention says rnc committee members^wh damage control trump veterans day op ed website veterans better friend pres^pres still las vegas he 'll visiting v.a hospital appropriations bill signing heads spring^pres boards air force one depart las vegas en route springfield mo another political fundraiser addr^vp biden heading las vegas he addresses naacp natl convention later campaign rally cong candidate erin bilbray^pres obama tapes appearance leno heads las vegas rd campaign rally day^today event north las vegas th campaign rally pres obama done^after hr min flight pres trump arrives las vegas campaign rally offers greeters wave thumbs u^after golf pres obama heads las vegas clinton/nevada dems campaign rally san diego fundraiser^pres decries senate failing ratify treaties citing law sea convention says time senate job^old habits die hard wh press office sent press e mail :00pm briefing press secretary robert gibbs they meant jay carney^robert gibbs begin final wh briefing press secretary^obama says choice november fear versus hope past versus future ... choice sliding backward moving forward^also monday seeks rally party behind remarks philadelphia democratic dinner^wh announces new steps including new us tariffs 50 billion goods imported china response chine^tariffs while trumpeting great friendship pres xi china announces us tariffs 50 bill^in first tweet day pres slams dems trade china on saturday wh announced commitme^grading curve i would give a+ says pres trump asked would grade president ci,2,28,26,30,0.06666666666666668,0.8666666666666667,0
121336026,natfinnonE,6200,5853,88,18696,0,0,3,27,senior features editor grad chronicler foibles pragmatist reader tired hopeful opinions,"this reese witherspoon ensuring everyone found terrible sarah michelle gellar using ryan^kristen stewart may be officially beloved after saturday night live inside dawn new era actress^miley cyrus amp liam hemsworth split signs their engagement was rocks via^the twisted case casey anthony sifting through evidence amp lies that prevented justice year old caylee^inside mel b stephen belafonte twisted divorce elosive allegations love gone wrong from start^the short tragic life aaron hernandez inside violent downfall e news^met gala see all red carpet arrivals via^summer '69 when charles manson scared hell out hollywood via^secrets lies cheaters amp frauds a history real housewives relationship implosions^hollywood has lost its mind over politics just like everyone else via^pregnant jessica simpson i 'm having boy plus get load how she broke news e online via^when royal family really has scandal they do n't mess around^the hits keep coming kevin spacey inside whirlwind collapse via^inside quentin tarantino complicated history with his leading ladies via^legacy bling ring when stealing from rich famous had its own moment spotlight^my spirit animal ... catherine zeta jones has 2,600 worth skin care inside her bathroom cabinet^princess diana private life is display once again years after her death is everything fair game^inside quietly adventurous career jessica biel from th heaven the sinner^how paris jackson officially became new it girl via^inside moment that launched selena gomez life changing comeback^how prince harry is defining his place royal family before he gets married^years after jon amp kate plus how gosselins blazed reality tv trail imploded along way^remembering tom petty the quintessential all american rock star who never backed down^why angelina jolie post divorce life looks nothing like brad pitt via^the only guide ever growing duggar family tree you 'll ever need via^tracing johnny depp steep descent from untouchable stardom via^untangling the many murders ed edwards via^the murder jonben t ramsey why we 're still obsessed with this case years after her death^paris hilton traumatic trip jail years ago how she revamped her life after celebutantes gone wild era^the biggest scandals olympic figure skating history via",3,27,24,30,0.1,0.8,0
19430999,KING5Seattle,8056,656092,4913,326757,0,3,6,21,news weather traffic seattle western washington nbc affiliate email newstips.com,a new ad campaign washington state department health centers disease control prevention^a new ad campaign washington state department health centers disease control prevention^oliver amp olivia top list popular baby names wa state released social security administration^emmy awards the winners list^emmy awards the winners list^emmy awards the winners list^emmy awards the winners list^channing tatum jenna dewan announce separation^channing tatum jenna dewan announce separation^koko gorilla knew sign language dies^koko gorilla knew sign language dies^ex 'dance moms star abby lee miller sentenced year prison^walmart remove 'cosmopolitan magazine checkout lines amid me too movement^scott baio wife renee reveals microvascular brain disease diagnosis^scott baio wife renee reveals microvascular brain disease diagnosis^scott baio wife renee reveals microvascular brain disease diagnosis^scott baio wife renee reveals microvascular brain disease diagnosis^report meghan markle dad longer attend royal wedding^report meghan markle dad longer attend royal wedding^report meghan markle dad longer attend royal wedding^report meghan markle dad longer attend royal wedding^former fox news ceo roger ailes dead^'nypd blue creator steven bochco dead^'nypd blue creator steven bochco dead^'nypd blue creator steven bochco dead^'nypd blue creator steven bochco dead^wwe star vader dead age^wwe star vader dead age^april giraffe pregnant^april giraffe pregnant,6,24,18,30,0.2,0.6,0
108936631,360Nobs,68,73981,292,287370,0,1,16,13,follow twitter handle get best entertainment lifestyle content submit content submission.com team360nobs,during presidential debate republican u.s. nominee donald trump speaks democratic^fergie and husband josh duhamel split after years of marriage^princeharry duke sussex meghan duchess sussex attended gala performance hamilton support o^latest post ellen degeneres agrees to go to marriage therapy to save marriage to portia de rossi ...^ellen degeneres agrees to go to marriage therapy to save marriage to portia de rossi^ellen degeneres agrees to go to marriage therapy to save marriage to portia de rossi^ellen degeneres agrees to go to marriage therapy to save marriage to portia de rossi^princeharry duke sussex meghan duchess sussex attended gala performance hamilton support o^here are the winners of the critics choice awards full list^latest post ellen degeneres agrees to go to marriage therapy to save marriage to portia de rossi ...^ellen degeneres agrees to go to marriage therapy to save marriage to portia de rossi^ellen degeneres agrees to go to marriage therapy to save marriage to portia de rossi^ellen degeneres agrees to go to marriage therapy to save marriage to portia de rossi^kim kardashian kanye west secretly got married^kim kardashian kanye west secretly got married^kim kardashian kanye west secretly got married^latest post kim kardashian kanye west secretly got married^black panther stranger things infinity war among nominees for mtv movie amp tv awards see full list^cma awards here the complete list of winners^bill cosby found guilty sexual assault retrial^complete nomination list for the tony awards as bradley cooper helen mirren and carey mulligan lead the pack^complete nomination list for the tony awards as bradley cooper helen mirren and carey^complete nomination list for the tony awards as bradley cooper helen mirren and carey mulligan lead the ...^sag awards here the complete list of winners^fergie and husband josh duhamel split after years of marriage^the originals comes to an end after seasons^the originals comes to an end after seasons^serena williams withdraws from australian open^reasons why renewed season by netflix^reasons why renewed season by netflix,16,14,-2,30,0.5333333333333333,-0.06666666666666668,1
79238164,HodaAndJenna,479,403243,1355,37266,2,0,16,12,friendship fun laughs america feel-good morning show big stars sweet surprises,george h.w bush heard eulogy died^george h.w bush heard eulogy died^wants ellen play samantha 'sex city^will ever sex city sat sarah jessica parker ask^meghan duchess sussex steps blush signature color^meghan duchess sussex wows tuxedo minidress hamilton performance^amal clooney changed dresses met gala museum gift shop^meghan duchess sussex steps blush signature color^meghan duchess sussex wows tuxedo minidress hamilton performance^yasss^reveals ever actually buzzed show^see deliver best impressions^should parents tell daughters pretty talk complimenting kids^bryan batt teaches new orleans phrases new orleans tourism paid today producti^gave us best impressions like^shared fondest new orleans memories included jenna visit repub^is ok compliment child appearance should tell daughter pretty and^angelina jolie reflects 'difficult year 'i enjoy single^too far tom brady criticized kissing year old son lips^neil diamond retires touring parkinson disease diagnosis^prince harry asks prince william best man royal wedding^rachel weisz pregnant eecting first child daniel craig^jason aldean wife brittany eecting baby no see cute announcement^olivia newton john postpones tour dates due breast cancer battle^after years kermit frog getting new voice^it boy chip joanna gaines welcome baby no^meghan markle requests respect report dad wo n't attend royal wedding^ben stiller christine taylor separate years marriage^jennifer garner ben affleck officially file divorce^returning 'will amp grace see new pics,18,12,-6,30,0.6,-0.2,1
187318645,WetpaintTV,14123,78792,498,105197,0,0,19,11,official twitter follow us tv spoilers celebrity gossip entertainment news snapchat,annoyed refuses rest seems miserable report^are benaffleck amp jenniferlopez getting back together^is vanessa grimaldi dumping nick viall smallville alum michael rosenbaum gt^is vanessa grimaldi dumping nick viall smallville alum michael rosenbaum gt^the truth gwen stefani blake shelton breakup rumors gt^rob kardashian demands second dna test daughter dream report gt^lamar odom threatening destroy khloe kardashian amp tristan thompson future weddingread crazy deet^family drama reportedly led difficult delivery beyonce amp jay z twins gt^katy perry robert pattinson seen kissing are they dating video^caitlyn jenner considering running mayor malibu report gt^misses amas reason thejenners thekardashians gt^ellen degeneres bans caitlyn jenner show book nasty accusations gt^congrats baby jess jessica simpson gives birth baby boy ace knute johnson^rumors swirling amy schumer john mayer datingwait whaaaat get scoop gt^is n't kanye west finally addresses rumors joining 'american idol revival gt^gwen stefani amp blake shelton ordered show pda thevoice report gt^are really back together not fast apparently gt^we never getting back together kuwtk gt^shares pic vaca are back together get details gt^update pregnant jessica simpson nd baby sickness i 'm exhausted eating tums^omg we all juicy details rachel lindsay carat engagement ring amp bryan abasolo not dissapoint^congratulations william tell welcome baby boy get details gt^gameofthrones stars say will win iron throne got gt^now we 've got bad blood taylor swift music video director claims beyonc copied tay music video get deets^join coach season gt^eddie cibrian responds brandi glanville accusations leann rimes gt^everything know season gt^khloe kardashian ready kids tristan thompson amp fans shaking hearing newsget deets now^spoilereverything need know 'once upon a time season reboot do n't say n't warn^once upon time season spoiler roundup everything you need know,19,11,-8,30,0.6333333333333333,-0.26666666666666666,1
1338624264,SDEKenya,243,51620,81,136322,0,0,19,11,we take entertainment seriously ultimate kenyan entertainment website gossip /local news/ music/ events/ showbiz photos/ crazy monday/ the nairobian/ pulse/,music sensation madonna katy perry get raunchy photo shoot^check madonna katy perry raunchy photo shoot^music artistes madonna katy perry get raunchy latest photo shoot^music sensation madonna katy perry get raunchy latest photo shoot^madonna katy perry raunchy photo shoot hits web^madonna katy perry get raunchy photo shoot^singers madonna katy perry leave fans shocked pictures 'raunchy photo shoot hit web^madonna katy perry get raunchy latest photo shoot^music artists madonna katy perry get raunchy photo shoot^music artistes madonna katy perry get raunchy photo shoot^music artists madonna katy perry get raunchy latest photo shoot^academy awards full list oscar winners wo oscars^academy awards full list oscar winners wo oscars^kim kardashian resents kanye west 'other woman feels left^kim kardashian resents kanye west 'other woman feels left^academy awards full list oscars winners^crazymonday angelina jolie involved bizarre special forces plot arrest ugandan warlord joseph kony^crazymonday angelina jolie involved bizarre special forces plot arrest ugandan warlord joseph kony^crazymonday angelina jolie involved bizarre special forces plot arrest ugandan warlord joseph kony^meghan markle makes history set spend christmas prince harry royal family^meghan markle makes history set spend christmas prince harry royal family^meghan markle makes history set spend christmas prince harry royal family^meghan markle makes history set spend christmas prince harry royal family^tina turner eldest son craig raymond found dead apparent suicide^tina turner eldest son craig raymond found dead apparent suicide^tina turner eldest son craig raymond found dead apparent suicide^nypd blue creator steven bochco dead^nypd blue creator steven bochco dead^nypd blue creator steven bochco dead^nypd blue creator steven bochco dead,19,11,-8,30,0.6333333333333333,-0.26666666666666666,1
3416635955,NewswithRachel,591,444,61,66143,1,0,21,8,stints international news wires across globe covering finance economics general politics.with newspaper magazine online reporting eerience,last queen elizabeth ii line corgis dies says british press^justin timberlake other stars rumored to perform at super bowl^the real reason jennifer aniston justin theroux split brad pitt played part^where love fergie josh duhamel split years marriage^jennifer aniston leaning brad pitt cope mother death report via^ben affleck quitting batman movies actor 'excited ready roll claims report via^'he got gun britney spears terrified stage invader las vegas show^what justin bieber close ones think 'the one selena gomez^twitter reacts to ivanka trump 'why i disagree with my dad us weekly magazine cover^the weeknd wants 'blow selena gomez mind epic marriage proposal^amal george clooney welcome twins ella alexander via^double joy amal george clooney eect welcome twins june via^'terrified karrueche tran staying away home filing restraining order chris brown via^are katie holmes jamie foxx dating check first photo intimate dinner date via^gisele bundchen 'begging husband tom brady call quits fifth nfl super bowl win report via^meghan markle moving london sights set bigger things prince harry^meghan markle moving london sights set bigger things prince harry^meghan markle wasn ordered to royal boot camp by queen elizabeth ii^kim kardashian 'hurt beyonce jay z silence kanye west hospitalisation via^jessica simpson 'heartbroken mom shamed sharing cute photos daughter^jennifer aniston angelina jolie not feuding over a new man report says^brad pitt next date nothing like angelina jolie report claims actor seeking love via^tisha campbell martin files divorce husband duane years marriage 'it pains^justin theroux cancels 'late show appearance after jennifer aniston split^will elsa get girlfriend frozen here director say^prince harry meets first lady melania trump ahead invictus games opening ceremony^mum word mindy kaling pregnant first child reveal father^where love fergie josh duhamel split years marriage^bbc sport australian open serena williams withdraws tournament^cnn anchor don lemon sister leisa dead from accidental drowning,22,8,-14,30,0.7333333333333333,-0.4666666666666667,1
293451031,YahooCelebUK,732,107373,824,160995,0,0,26,4,be know pop culture celeb stories live without,kim kardashian support hubby auditioned american idol^so either jennifer aniston eaten massive bowl pasta baby news ...^jennifer aniston baby news 're telling us^liam payne opens cheryl split^miley cyrus liam hemsworth cancel bora bora honeymoon^miley cyrus liam hemsworth honeymoon cancelled wedding still^miley cyrus 'cancels honeymoon plans fianc liam hemsworth^miley cyrus liam hemsworth cancel bora bora honeymoon^more rumours liam hemsworth rocks now wants break eek^miley cyrus liam hemsworth relationship rocks brothers beg dump^poor robert pattinson looks seriously miserable split kristen stewart we 're sure could cheer^angelina jolie admits 'crying shower breaks silence brad pitt split^angelina jolie dad latest break silence divorce brad pitt^can talk gorgeous photos taylor swift amp calvin harris holiday please^kim kardashian kanye west ecretly engaged oh em gee^kim kardashian kanye west secretly engaged *chokes lunch*^kim kardashian kanye west ecretly married la weekend^kim kardashian kanye west ecretly engaged oh em gee^kim kardashian kanye west secretly engaged *chokes tea*^did kim kardashian kanye west secretly wed weekend^prepare drama blac chyna suing entire kardashian family^kim kardashian admits selfie obsession litttttle bit ridic ...^pamela stephenson calls michael parkinson 'daft old fart billy connolly comments^justin bieber gives advice 'balding prince william the cheeky wotsit^kanye west 'psychotic breakdown left kim kardashian 'terrified sending love.^brad pitt left devastated angelina jolie banned seeing children thanksgiving^courtney love warned women harvey weinstein interview years ago^so allegedly helped homeless pregnant fan buy house^strangerthings star shannon purser aka barb comes bisexual amid riverdale backlash^jennifer lawrence darren aronofsky apparently split one year together,26,4,-22,30,0.8666666666666667,-0.7333333333333333,1
273417314,B985FM,360,2345,76,45682,1,3,4,21,atlanta station now,read transcript sen. jeff flake speech comparing pres donald trump josef stalin^read transcript sen. jeff flake speech comparing pres donald trump josef stalin^trump appearing 'fox friends talk north korea immigration taped interview^trump appearing 'fox friends talk north korea immigration taped interview^international women day stars celebrate^katie couric breaks silence news matt lauer dismissal 'today^channing tatum wife jenna dewan tatum announce split^celebrities react death linkin park singer chester bennington^enrique iglesias anna kournikova reportedly welcome twins^james franco denies allegations sexual misconduct^tamar braxton files divorce husband manager vincent herbert^matt damon apologizes comments sexual misconduct^meghan markle maid honor royal wedding^mtv movie amp tv awards complete winners list^'superman star margot kidder dead^photos miss nebraska sarah rose summers crowned miss usa^meghan markle dad heart surgery wo n't attend royal wedding report says^clay adler former mtv reality star dead^justin timberlake announces new album 'man woods^justin theroux breaks social media silence jennifer aniston split^former fox news ceo roger ailes dead^daytime emmy awards complete winners list^storm chasers star joel taylor dead^announces global tour dates he coming atlanta july get details^labor day deals sales macy walmart best buy^celine dion donates concert proceeds victims las vegas shooting^colin trevorrow back direct jurassic world^michael jackson musical coming broadway^ncis fan favorite pauley perrette leaving show seasons,5,24,19,29,0.1724137931034483,0.6551724137931034,0
18205191,KRMGtulsa,474,30234,473,269241,0,3,9,17,krmg tulsa news talk featuring krmg morning news krmg evening news kilmeade rush hannity clark dana starnes benson,chicago mercy hospital shooting what know victims^police report drop homicides shooting victims chicago^audio president george w bush interview rush limbaugh tuesday^prince harry meghan markle a relationship timeline^david cassidy fighting memory loss wants 'enjoy life^katie couric breaks silence news matt lauer dismissal 'today^emmy awards the handmaids tale big little lies veep take top prizes complete winner list^emmy awards the handmaids tale big little lies veep take top prizes complete winner list^mariah carey new year eve performance 'they foiled^rapper travis scott pleads guilty disorderly conduct^celebrities react death linkin park singer chester bennington^oprah 'intrigued idea running president friend gayle king says^james franco denies allegations sexual misconduct^meghan markle maid honor royal wedding^mtv movie amp tv awards complete winners list^portia de rossi says steven seagal unzipped pants audition^meghan markle confirms dad attend royal wedding^justin timberlake announces new album 'man woods^justin theroux breaks social media silence jennifer aniston split^daytime emmy awards complete winners list^labor day deals sales macy walmart best buy^labor day deals sales macy walmart best buy^snap inc. stock falls kylie jenner tweet snapchat redesign^colin trevorrow back direct jurassic world^watch miley cyrus gives emotional performance 'malibu billboard music awards^ving rhames says police held gunpoint home neighbor reported burglary^kylie jenner pregnant according reports^reports say kylie jenner pregnant first child^pregnant april giraffe calf due march,9,20,11,29,0.3103448275862069,0.3793103448275862,0
23517712,WTKR3,1539,102150,786,209948,2,4,8,15,visit us online like us facebook follow us instagram,watch now us house representatives observe th anniversary mlk assassination^melania trump undergoes kidney surgery walter reed medical center^these victims chicago mercy hospital shooting^murphy sneaks white house press briefing persona non grata decades tonight a^murphy sneaks white house press briefing persona non grata decades tonight a^murphy sneaks white house press briefing persona non grata decades next n^prince harry meghan markle wed may^north korea vows strikes us trump warns 'fire fury^elle faces backlash false kim kardashian kanye west breakup tweet^arnold schwarzenegger returning the new celebrity apprentice^taylor swift new music video a guide means^taylor swift new music video a guide means^elle faces backlash false kim kardashian kanye west breakup tweet^coming julie bowen talks upcoming th final season modern family^laura dern wins supporting actress limited series movie big little lies emmys^'superman star margot kidder dead says tmz^after years kermit frog getting new voice^after years kermit frog getting new voice^justin timberlake announces new album man woods^grammy nominated swedish dj avicii dead^'storm chasers star joel taylor dead^ellen degeneres cries receiving best birthday gift portia de rossi^ellen degeneres cries receiving best birthday gift portia de rossi^'game thrones stars kit harington rose leslie married^game thrones stars kit harington rose leslie married^announces las vegas residency^taylor swift announces new album 'reputation^meryl streep joins 'big little lies season^judge declares mistrial bill cosby sexual assault case,10,19,9,29,0.3448275862068966,0.3103448275862069,0
780812012,Legends971,74,1009,35,18566,0,1,10,18,all legends country music one houston radio station,photos democratic presidential debate new hampshire^prince harry meghan markle a relationship timeline^international women day stars celebrate^even gwen stefani shocked blake shelton miranda lambert split^katie couric breaks silence news matt lauer dismissal 'today^keith urban nicole kidman beam pride exciting moment^keith urban gets downright sappy wife nicole kidman^celebrities react death linkin park singer chester bennington^oprah 'intrigued idea running president friend gayle king says^richard simmons sues radaronline national enquirer protect privacy^kourtney kardashian scott disick back together^enrique iglesias anna kournikova reportedly welcome twins^james franco denies allegations sexual misconduct^tamar braxton files divorce husband manager vincent herbert^meghan markle maid honor royal wedding^mtv movie amp tv awards complete winners list^portia de rossi says steven seagal unzipped pants audition^meghan markle dad heart surgery wo n't attend royal wedding report says^clay adler former mtv reality star dead^justin timberlake announces new album 'man woods^justin theroux breaks social media silence jennifer aniston split^daytime emmy awards complete winners list^storm chasers star joel taylor dead^bradley cooper irina shayk welcome first child reports say^snap inc. stock falls kylie jenner tweet snapchat redesign^celine dion donates concert proceeds victims las vegas shooting^michael jackson musical coming broadway^watch miley cyrus gives emotional performance 'malibu billboard music awards^ncis fan favorite pauley perrette leaving show seasons,10,19,9,29,0.3448275862068966,0.3103448275862069,0
14076329,RapUp,386,353435,3031,67114,0,0,11,18,exclusive hip-hop r b news delivered daily,kanye west nick cannon squash beef kim kardashian comments^kim kardashian denies hooking drake never happened end story^shots fired set ix9ine video kanye west nicki minaj^shots fired ix9ine shooting video kanye west nicki minaj beverly hills^mariah carey addresses new year eve debacle they foiled^tyga whether misses kylie jenner nah i good luv enjoy queenradio^kanye west opens hospitalization kim kardashian robbery feeling hurt jay z amp beyonc^ciara russell wilson welcome daughter sienna princess wilson^kanye west nick cannon squash beef kim kardashian comments^kanye west kim kardashian step out style restaurant opening^kanye west kim kardashian step out style restaurant opening^rihanna celebrates th birthday friends including toni braxton paris hilton^a second suspect arrested murder xxxtentacion^a second suspect arrested murder xxxtentacion^ed sheeran engaged longtime girlfriend cherry seaborn^ed sheeran engaged girlfriend cherry seaborn^nicki minaj helps open billboard music awards host ken jeong billboardawards^nicki minaj open sunday billboard music awards lil wayne jason derulo amp david guetta^a second suspect arrested murder xxxtentacion^a fourth suspect arrested murder xxxtentacion^a second suspect arrested murder xxxtentacion^a fourth suspect arrested murder xxxtentacion^tamar braxton files divorce vincent herbert^chris brown could face jail time pet monkey^ariana grande says mac miller remain best friends despite breakup^a man arrested criminal trespassing rihanna apartment building^justin timberlake announces man woods tour^kim kardashian shares first photo daughter chicago west^janelle mon e comes pansexual rolling stone interview,11,18,7,29,0.3793103448275862,0.2413793103448276,0
20643501,Inspiration1390,110,6723,96,15166,0,3,15,11,music power praise,pulpittuesday dr. byron brazier apostolic church god chicago^tune tomorrow pulpittuesday guest dr byron brazier apostolic church god chicago sonya blakey^exclusive sen. john mccain joins the mike broomhead show st interview since diagnosed cancer^jamie foxx katie holmes finally out public as couple^jamie foxx katie holmes finally out public as couple^celebrities react trump withdraws steph curry white house invitation^celebrities react trump withdraws steph curry white house invitation^katherine jackson resigns as blanket guardian^katherine jackson resigns as blanket guardian^katie holmes not pregnant and planning wedding with jamie foxx^sorry drake amp bella hadid are not 'secretly dating^sorry drake amp bella hadid are not 'secretly dating^celebrity reactions prince harry meghan markle engaged^celebrity reactions prince harry meghan markle engaged^kim kardashian slams 'invasive surrogacy reports^kim kardashian slams 'invasive surrogacy reports^obamas celebrate th anniversary after false split stories^obamas celebrate th anniversary after false split stories^here how help victims las vegas mass shooting^here how help victims las vegas mass shooting^tisha campbell martin files for divorce from husband duane^khlo kardashian makes her first public appearance since pregnancy news^khlo kardashian makes her first public appearance since pregnancy news^tamar braxton files divorce from vincent herbert^tamar braxton files divorce from vincent herbert^nelly officially under criminal investigation sexual assault^star jones ex husband al reynolds comes out as bisexual in candid blog^star jones ex husband al reynolds comes out as bisexual in candid blog^'black panther is officially the most tweeted about movie of all time,15,14,-1,29,0.5172413793103449,-0.03448275862068965,1
107128390,Fox411,374,46766,577,18377,0,0,17,12,celebrity news gossip fox style,blake shelton opens new restaurant nashville 'it seems good true foxnews^are bradpitt jenniferlawrence dating^how brad pitt angelina jolie divide 400 million fortune^terry crews slams former national enquirer editor accused sexual assault threatening false story^are bradpitt jenniferlawrence dating^are bradpitt jenniferlawrence dating^taylorswift calls 'bully kimkardashian addresses feud reputationtour opening night^angelina jolie 'relieved brad pitt cleared child services investigation^princeharry meghanmarkle reportedly postponing royal honeymoon^mariah carey still blaming others new year eve performance 'they foiled^kourtney kardashian younes bendjima split years report foxnews^'flip flop christina el moussa headed 'real housewives not fast^'flip flop christina el moussa headed 'real housewives not fast ...^meghanmarkle 'very excited nickjonas priyankachopra engagement report says^jenniferlawrence felt 'empowered 'terrified nude scenes redsparrow via^are bradpitt jenniferlawrence dating^biggest celebrity scandals^princeharry asks big brother princewilliam best man wedding meghanmarkle^sophie gradon 'love island star former miss great britain dead^demilovato reveals contemplated suicide age via^erin moran 'happy days star dead^who walk meghan markle aisle royal wedding father ca n't attend foxnews^'ladies london star annabelle neilson dead foxnews^meghan markle reportedly calls prince harry 'best husband ever foxnews^'big bang theory star kaley cuoco marries karl cook horse themed ceremony foxnews^billy bush wife sydney davis files divorce nearly years marriage report foxnews^andrew garfield 'i gay man right without physical act^breaking wwe star vader dead^jenniferaniston attends first public event since justintheroux split supports jasonbateman,17,12,-5,29,0.5862068965517241,-0.1724137931034483,1
16932962,DelishDotCom,1119,52241,948,58778,0,0,18,11,come food stay fun,reese witherspoon teased the first details of 'legally blonde^what is roseanne barr net worth^taste testing ramen one hardest things 've done ...^this timeline includes everything we know prince harry meghan markle relationship^channing tatum and jenna dewan tatum split after years of marriage^kris jenner keeping up kardashians house is for sale^tonya harding made it to the dancing with stars finale and fans are livid^kris jenner keeping up kardashians house is for sale^meghan markle and prince harry literally told the royals their baby news at eugenie 's wedding^channing tatum and jenna dewan tatum split after years of marriage^meghan markle and prince harry will reportedly have a baby as soon as they can^matt lauer texted hoda kotb after learning she would replace him^meghan markle will take over one of queen elizabeth royal duties^everyone is freaking out over kate middleton fingers for the most bizarre reason^meghan markle prince harry are officially leaving kensington palace moving windsor^gordon ramsay says he dropped over lbs to save his marriage^meghan markle and prince harry literally told the royals their baby news at eugenie 's wedding^meghan markle and prince harry will reportedly have a baby as soon as they can^steph and ayesha curry are eecting baby no^meghan markle dad will now attend royal wedding apparently^breaking meghan markle dad wo n't attend the royal wedding after fallout from staged pictures^everything we know so far about pippa middleton wedding^freeform '13 nights halloween schedule is finally here^freeform announced its '31 nights of halloween schedule and there a 'hocus pocus marathon^freeform '13 nights halloween schedule is finally here^kaley cuoco marries karl cook in an intimate horse ranch wedding^princess charlotte net worth is more than prince george here why^meghan best friend jessica mulroney pippa middleton royal wedding^eva longoria gives birth to a baby boy,18,11,-7,29,0.6206896551724138,-0.2413793103448276,1
120153772,WomenintheWorld,1854,352483,4110,75397,0,3,21,5,convening women leaders change makers sharing stories solutions improve life women+girls witw rts endorsements,one four u.s. households considered 'non traditional meaning wives earn husbands census re^one four u.s. households considered 'non traditional meaning wives earn husbands census re^one four u.s. households considered 'non traditional meaning wives earn husbands census re^kellyanne conway accused breaking federal law telling americans go buy ivanka stuff^kellyanne conway accused breaking federal law telling americans go buy ivanka stuff^katie couric opened firing former 'today show co host matt lauer believes info^katie couric speaks candidly disgrace former today co host matt lauer^katie couric opened firing former 'today show co host matt lauer^katie couric speaks candidly disgrace former today co host matt lauer^amal george clooney welcome twins daughter son^amal george clooney welcome twins daughter son^amal george clooney welcome twins daughter son^amal george clooney welcome twins daughter son^hoda kotb replaced matt lauer anchor today show reportedly paid fraction was^hoda kotb replaced matt lauer anchor today show reportedly paid fraction was^hoda kotb officially replaced disgraced matt lauer anchor 'today show reportedly rece^hoda kotb replaced matt lauer anchor today show reportedly paid fraction was^it boy there new royalbaby town catherine duchess cambridge gave birth rd child mo^jessica simpson gives birth witwcheat^oprah intrigued idea running president says oprah2020^katie couric opened firing former 'today show co host matt lauer believes info^katie couric speaks candidly disgrace former today co host matt lauer^katie couric opened firing former 'today show co host matt lauer^katie couric speaks candidly disgrace former today co host matt lauer^courtney love publicly warned women harvey weinstein way back^pregnant serena williams poses nude cover vanity fair planning swift return tennis court^pregnant serena williams poses nude cover vanity fair planning swift return tennis court^pregnant serena williams poses nude cover vanity fair planning swift return tennis court^pregnant poses nude cover planning swift return tennis court,21,8,-13,29,0.7241379310344828,-0.4482758620689655,1
21401466,VogueRunway,620,2040490,9909,107893,0,1,24,4,see fashion first,watch strut pair statement fringe earrings prim white crop top new blood or^kristen stewart dyes hair arctic shade snowy blonde^jenna dewan says divorce channing tatum positive thing^jenna dewan says divorce channing tatum positive thing^a comprehensive timeline meghan markle prince harry adorable relationship^pippa middleton keeps channeling kate^queen letizia like meghan duchess sussex stepped today silhouette summer.^go inside windsor royal county berkshire polo club prince harry played meghan duchess sus^meghan duchess sussex proves denim royal feminine carolina herrera dress.^prince harry meghan duchess sussex may gotten brand new house gift queen.^more casting news the crown season we get first glimse teenaged prince charles.^takes dressing next level going full futuristic diva latest instagram selfie.^the story behind epic wardrobe^the story behind epic wardrobe^the story behind epic wardrobe^queen letizia like meghan duchess sussex stepped today silhouette summer.^go inside windsor royal county berkshire polo club prince harry played meghan duchess sus^meghan duchess sussex proves denim royal feminine carolina herrera dress.^prince harry meghan duchess sussex may gotten brand new house gift queen.^katie holmes debuts cool new look time style inspiration labor day weekend^katie holmes jennifer lawrence agree summer bag^katie holmes debuts cool new look time style inspiration labor day weekend^katie holmes jennifer lawrence agree summer bag^emma stone readied photo call venice film festival risky eyeliner shade making look easy^a look prince harry meghan markle fairy tale wedding flowers inside st. george chapel^the complete list winners tonight sag awards^everything need know prince harry meghan markle royal engagement^jennifer lawrence darren aronofsky split^where meghan markle pippa middleton wedding,24,5,-19,29,0.8275862068965517,-0.6551724137931034,1
19383317,justjaredjr,1116,362860,2829,117111,0,0,25,4,just jared jr. definitive site teen celebrity fans up-to-the-minute coverage today hottest young stars film television music,sofia richie spotted rocking peach colored bikini mexico weekend^sofia richie looks happy grabbing dinner boyfriend scott disick^sofia richie quite labor day weekend see photos^sofia richie spends th birthday mexico bf scott disick^take multiple roles one project^ok 're super jealous kendall jenner poolside vacation right^shannen doherty shared amazing words new charmed series charmed^check inspirational quotes years^sofia richie spotted rocking peach colored bikini mexico weekend^sofia richie looks happy grabbing dinner boyfriend scott disick^sofia richie quite labor day weekend see photos^sofia richie spends th birthday mexico bf scott disick^selena gomez timothee chalamet hard work new woody allen film^got romantic filming scenes upcoming movie^selena gomez gave shoutout future co stars elle fanning timoth e chalamet^selena gomez timothee chalamet braved rain filming today^sofia richie spotted rocking peach colored bikini mexico weekend^sofia richie looks happy grabbing dinner boyfriend scott disick^sofia richie quite labor day weekend see photos^sofia richie spends th birthday mexico bf scott disick^sofia richie spotted rocking peach colored bikini mexico weekend^sofia richie looks happy grabbing dinner boyfriend scott disick^sofia richie quite labor day weekend see photos^sofia richie spends th birthday mexico bf scott disick^kylie jenner talks chose take step back spotlight pregnant^shailene woodley opening dating rugby player boyfriend ben volavola^oh kendall jenner reportedly hospitalized vanity fair oscar party^liam payne pregnant girlfriend cheryl cole shows baby bump first time new photos^the first teaser trailer marvel finally arrived watch,25,4,-21,29,0.8620689655172413,-0.7241379310344828,1
84830575,MikeAdamOnAir,4911,115115,2181,104666,0,1,26,2,catch on-air m-f -7pm buy adamsapplenyc beanie help feed hungry,sorry not sorry one demilovato four times platinum united states m+ copies sol^look what you made me do hit million likes youtube this taylorswift nd video^arianagrande rattles names women inspire i '90s baby whitney mariah madonna all^which paper magazine cover like rt jenniferlopez like mariahcarey^which upcoming album excited normani debut solo album selenagomez highly anticipated new a^whose next era excited mileycyrus katyperry selenagomez arianagrande^which new artist era excited avrillavigne selenagomez dinahjane littlemix^on th this month get takitaki djsnake cardib selenagomez ozuna rt 're excited for^which upcoming collab excited dinahjane marcebassy amp tydollasign djsnake ozuna^which upcoming team excited jenniferlopez amp badbunny meghantrainor seanpaul amp cnco^which new song excited new ladygaga bradleycooper latest prettymuch all^which upcoming collab excited zedd amp katyperry dualipa amp blackpink normani amp nickiminaj^has 'non era era selenagomez best yet rt think she currently rd streamed^takitaki feat pr eligible platinum status us t^selenagomez n't dropped album years ... currently third most streamed female artist o^how cute selenagomez reading fan mail bed^various media outlets reporting music video shoot beverly hills kanyewest nickiminaj and^when luke bryan asked americanidol contestant who look artist guy responded^which upcoming album excited normani debut solo album selenagomez highly anticipated new a^whose next era excited mileycyrus katyperry selenagomez arianagrande^which new artist era excited avrillavigne selenagomez dinahjane littlemix^on th this month get takitaki djsnake cardib selenagomez ozuna rt 're excited for^which upcoming collab excited dinahjane marcebassy amp tydollasign djsnake ozuna^which upcoming team excited jenniferlopez amp badbunny meghantrainor seanpaul amp cnco^which new song excited new ladygaga bradleycooper latest prettymuch all^which upcoming collab excited zedd amp katyperry dualipa amp blackpink normani amp nickiminaj^when luke bryan asked americanidol contestant who look artist guy responded^open billboard music awards this coming sunday t mobile arena vegas rt u'l^love love love picture engaged german basketball player andr murillo what beautiful,26,3,-23,29,0.8965517241379308,-0.7931034482758621,1
23978727,okayplayer,4729,102743,2381,94551,0,7,2,19,true notes since merch submissions.com,update yasiin bey issues statement video says clip taken context^president watch new video state of the union^president watch new video state of the union^president watch new video state of the union^president watch new video state of the union^president watch new video state of the union^president watch new video state of the union^oprah bff gayle king says oprah intrigued idea running president .^says intrigued idea running president^jada pinkett smith calls goldenglobes snub^a second suspect arrested murder xxxtentacion^a second suspect arrested murder xxxtentacion^a second suspect arrested murder xxxtentacion^a second suspect arrested murder xxxtentacion^a third suspect arrested murder^in new trailer announces release date new album 'revival^next year goldenglobes live streamed somewhere else without bleeps ||^stranger things actor finn wolfhard exits apa agent accused sexual abuse^stranger things actor finn wolfhard exits apa agent accused sexual abuse^stranger things actor finn wolfhard exits apa agent accused sexual abuse^stranger things actor finn wolfhard exits apa agent accused sexual abuse^strangerthings actor finn wolfhard exits apa agent accused sexual abuse^quincy jones wins lawsuit michael jackson estate he awarded 9.4 million royalties^quincy jones wins lawsuit michael jackson estate awarded 9.4 million royalties.^quincy jones wins lawsuit michael jackson estate he awarded 9.4 million royalties^finally steven spielberg ready player one trailer watch amazed^watch trailer steven spielberg directed adaptation ernest cline book 'ready player one '^watch trailer steven spielberg directed adaptation ernest cline book 'ready player one ',2,26,24,28,0.07142857142857142,0.8571428571428571,0
21094888,wsbtv,2274,1168982,3473,553743,0,6,3,19,metro atlanta source breaking news weather traffic coverage count,meet year old candidate running senate ... endorsed barack obama^meet year old candidate running senate ... endorsed barack obama^meet year old candidate running senate ... endorsed barack obama^meet year old candidate running senate ... endorsed barack obama^meet year old candidate running senate ... also endorsed barack obama^breaking white house vice president joe biden make statement rose garden watch ch updates^comedian/actress leslie jones town working gets twitter back forth popular^comedian/actress leslie jones town working gets twitter back forth popular^comedian/actress leslie jones town working gets twitter back forth popular^koko gorilla knew sign language dies^koko gorilla knew sign language dies^big congrats he returning host th oscars^'superman star margot kidder dead^'superman star margot kidder dead^'superman star margot kidder dead^meghan markle confirms dad attend royal wedding^meghan markle confirms dad attend royal wedding^clay adler former mtv reality star dead^clay adler former mtv reality star dead^clay adler former mtv reality star dead^clay adler former mtv reality star dead^clay adler former mtv reality star dead^clay adler former mtv reality star dead^clay adler former mtv reality star dead^snap inc. stock falls kylie jenner tweet snapchat redesign^snap inc. stock falls kylie jenner tweet snapchat redesign^snap inc. stock falls kylie jenner tweet snapchat redesign^snap inc. stock falls kylie jenner tweet snapchat redesign,3,25,22,28,0.10714285714285714,0.7857142857142857,0
15755669,NBCPhiladelphia,2528,610570,3292,225547,0,6,6,16,thank stopping place go exclusive local stories latest breaking news weather updates,"i recognize video footage raised lot questions regarding officers actions cape may prosec^a woman spirit airlines flight became erratic irate plane make unscheduled landing b^ninety people states including pa. nj infected salmonella midst outbreak th^the democratic national convention committee set evaluate philly find 'll town^i sitting trying find collusion crime collusion crime giuliani said inter^recall alert swift beef company recalling approximately ,260 pounds raw ground beef products may c^comedian hannibal buress arrested miami disorderly intoxication^a police body camera video reveals moments popular comedian arrested last month m^look halloween 'nuff said^the folks check new studio likes^gives birth son^brad pitt mustache breakdown conversation^all fashion details meghan markle royal christmas debut^amp offer pay mckayla maroney 100k fine break nda^tiffany haddish claims drugged actress bit face^over rainbow ren e zellweger transforms into judy garland first photo upcoming film^do remember soon royalty meghan markle suitcase model 'deal no deal howie mandel^actress slammed racist tweet ice checkpoint^watch miley cyrus dad billy ray cyrus remember tom petty heartbreaking 'wildflowers cover^mtv star clay adler dead^cameron diaz says she is 'actually retired after all^janet jackson shares first photo her baby boy eissa al mana^supermodel marries worldseries champ lavish italian wedding^actor reports alleged sexual assault police^bradley cooper irina shayk welcome first child^'supergirl co creator andrew kreisberg fired following sexual harassment allegations^bobbi kristina brown ex nick gordon arrested domestic violence kidnapping adult^it family affair britain royal officials say prince harry asked elder brother prince william b",6,22,16,28,0.21428571428571427,0.5714285714285714,0
14687256,FOX23,2404,88790,798,124959,0,2,6,20,covering news that matters,here transcript third presidential debate^watch live vice president joe biden preparing make statement white house rose garden^prince harry meghan markle a relationship timeline^international women day stars celebrate^katie couric breaks silence news matt lauer dismissal 'today^celebrities react death linkin park singer chester bennington^oprah 'intrigued idea running president friend gayle king says^richard simmons sues radaronline national enquirer protect privacy^enrique iglesias anna kournikova reportedly welcome twins^james franco denies allegations sexual misconduct^tamar braxton files divorce husband manager vincent herbert^meghan markle wo n't maid honor royal wedding^portia de rossi says steven seagal unzipped pants audition^meghan markle dad heart surgery wo n't attend royal wedding report says^clay adler former mtv reality star dead^justin timberlake announces new album 'man woods^justin theroux breaks social media silence jennifer aniston split^former fox news ceo roger ailes dead^storm chasers star joel taylor dead^labor day deals sales macy walmart best buy^bradley cooper irina shayk welcome first child reports say^snap inc. stock falls kylie jenner tweet snapchat redesign^celine dion donates concert proceeds victims las vegas shooting^man inspired als ice bucket challenge dead^michael jackson musical coming broadway^watch miley cyrus gives emotional performance 'malibu billboard music awards^kylie jenner pregnant according reports^ncis fan favorite pauley perrette leaving show seasons,6,22,16,28,0.21428571428571427,0.5714285714285714,0
20562637,businessinsider,262,2702381,31837,591318,3,9,6,10,what need know follow us facebook instagram youtube visit home page top stories day,nyc bombing suspect wrote 'trump failed protect nation facebook feds say^snapchat shutting lens store months focusing ad business^leonardo dicaprio says signed elon musk trip mars^awesome lines from sarah palin brilliant cpac speech lightning^estonia might have the most efficient tax filing system in the world^world leaders laughed trump un speech managed unite one thing isolationi^mcmaster unleashes russia final speech national security adviser via^everyone is talking about paul krugman column today^the popular baby names every us state^here popular baby names every us state^here popular baby names every us state^in emotional interview jake tapper john mccain says 'd like remembered^together meghan markle prince harry worth 30 million none money belongs cr^people freaking laura dern may snubbed reese witherspoon emmy win^'he diabolical leah remini says scientology poster boy tom cruise good person^trump long warm relationship oprah helped springboard presidential ambitions^hoda kotb says matt lauer texted congratulations replaced 'today show coanchor^billy bush confirms trump voice 'access hollywood tape^ellen page accuses brett ratner 'blatantly homophobic abusive behavior^nbc next live musical 'jesus christ superstar^donald trump almost played president 'sharknado happened^prince charles replace meghan markle dad royal wedding walk aisle^meghan markle father officially longer attending royal wedding eected walk down^meghan markle dad attend royal wedding walk aisle half brother calling for^justin timberlake announces release new album 'man woods^renee zellweger elains disappeared hollywood years^dj producer avicii warned 'i 'm going die documentary released months found dead^reasonswhy season returns netflix may th everything know fans eect,9,19,10,28,0.32142857142857145,0.35714285714285715,0
17836882,FOX5Atlanta,1620,618265,2345,306510,0,6,15,7,more local news station atlanta area home fox5atl,dekalb county upset annexation emory university centers disease control prevention and^the centers disease control prevention says popular kellogg cereal linked salmonella outb^the death centers disease control prevention employee whose body found river atlanta n^about million american adults considered prediabetic centers disease control prevention.^about million american adults considered prediabetic centers disease control prevention.^breaking washington white house vice president joe biden make statement rose garden^kate middleton prince william leave hospital welcoming baby boy^kate middleton proudly held new bundle joy prince william left hospital welcoming bab^is shaq still sweet shaunie o'neal the next stop kanyewest apology tour drake plus^how brad pitt angelina jolie divide 400 million fortune^divorce talks angelinajolie bradpitt hit new snag angelina livid what going no^kylie jenner travis scott marriage not cards ... yet and ... khloe kardashian pregnant tristan thomp^coming next kanyewest nickcannon squashed beef kimkardashian plus chrishemsworth^coming :30 kanyewest nickcannon squashed beef kimkardashian plus^coming up next host welcomes danbucantinsky bradleywhitford tishacampbell amp lisakudrow to^coming up next host welcomes patrickfabian lisakudrow timbagley to^oprah joins georgeclooney amalclooney donating money gun control march justintheroux found^why justinbieber selenagomez break is frank getting married mob what ca n't oprah f^coming next kanyewest nickcannon squashed beef kimkardashian plus chrishemsworth^coming :30 kanyewest nickcannon squashed beef kimkardashian plus^coming up next kylie jenner amp blac chyna war ended kim kardashian stepped peacemaker tmzlive^'superman star margot kidder dead^next the crew dishes last night seasonfinale empire arianagrande opens her^'wicked tuna star nicholas 'duffy fudge dead^breaking former fox news chairman ceo roger ailes dead^the kingofpop coming broadway a musical based life music eected hit^ap britain royal palace says prince harry asked elder brother prince william best man wedding next month^jennifer garner ben affleck officially file divorce,15,13,-2,28,0.5357142857142857,-0.07142857142857142,1
16042794,GuardianUS,731,202914,6190,218864,0,4,15,9,us news opinion features sports guardian,the greatest mitt romney campaign ad arrived late save^friday us briefing khashoggi search widens white house shifts tone^one us soldier killed four wounded somalia attack^revealed one four europeans vote populist^rachel weisz 'my parents refugees brexit feels like death^rachel weisz 'my parents refugees brexit feels like death^rachel weisz 'my parents refugees brexit feels like death^rachel weisz 'my parents refugees brexit feels like death^no cinderella margo jefferson real meghan markle^vince vaughn mel gibson hollywood cops prove lives matter^sarah ferguson make public apology oprah winfrey show^no cinderella margo jefferson real meghan markle^brad pitt angelina jolie search perfect pr hollywood divorce^i miss old kanye happened rap complex star^'they foiled mariah carey blames production team new year disaster^i created character called katy perry i want katheryn hudson it scary^i created character called katy perry i want katheryn hudson it scary^kevin bacon who would play film life harry styles^charlie says review matt smith magnetic charles manson unpersuasive cult drama^pregnant serena williams poses nude vanity fair cover shoot^tony awards complete list nominations^royal wedding live elton john performs prince harry meghan markle reception latest news^louis ck accused five women sexual misconduct new report^don rickles legendary comedian master celebrity roasts dies aged^taylor swift announces new album reputation november release^daniel craig confirms play james bond^daniel craig confirms play james bond^actor ving rhames says police held gunpoint home,15,13,-2,28,0.5357142857142857,-0.07142857142857142,1
739963476370673665,peopletv,7278,23269,176,21845,0,0,15,13,get fix celebrity news interviews exclusive stories red carpet events world entertainment,jennifer lawrence reveals hilarious way comforted darren aronofsky split more on^jenniferaniston justintheroux split 'lovingly two years marriage more peoplenow^jenniferaniston justintheroux split 'lovingly two years marriage^kanyewest publicly shares texts caitlynjenner amid ongoing feud kardashians more on^kimkardashian returned white house today help another imprisoned drug offender watch tonight^talks hanging beyonce jayz i told i went jail more chatter^for emilyblunt acting led career loves young age also helped deal stutter tha^from cher abba cover album lil wayne carterv even cardib selenagomez new song lots o^can eect former star make way back broadway she tells on^travisscott pleads guilty disorderly conduct allegedly inciting riot concert more peoplenow^from cher abba cover album lil wayne carterv even cardib selenagomez new song lots o^princeharry says excited introduce meghanmarkle australia first royal visit more on^meghanmarkle dropped major royal baby hint peoplenow^the time flew since meghanmarkle princeharry fairytale wedding 're delving new role t^returns reality tv husband evanross years the ashlee simpson show. more on^kim kardashian shows new grill first time since targeted paris robbery more peoplenow^says baby girl due 'any minute now 'i 'm over moon excited more peoplenow^caitrionabalfe engaged outlander actress shows ring goldenglobes more peoplenow^ad brighten day wearing yellow pops color like celebrities shop fashion^whatever takes drake stages epic degrassi the next generation reunion 'i 'm upset video more on^americanhorrorstory season title return date revealed wait^jt back announces new album 'man woods sneak peek video peoplenow^today on peoplenow aaronpaul wife lauren welcome first child daughter see adorable first baby phot^nickjonas priyankachopra engaged months dating source more peoplenow^nickjonas priyankachopra engaged what think surprising news share thoughts u^surprise arianagrande petedavidson are engaged after dating few weeks^parents khloekardashian tristanthompson ready meet baby girl^pauley perrette leaving ncis seasons more,15,13,-2,28,0.5357142857142857,-0.07142857142857142,1
12870772,birmingham_live,2618,292548,1245,309967,0,0,19,9,the latest birmingham news sport weather events download app free,meghan markle 'warned queen attitude tiara row ahead prince harry wedding^did meghan markle tell dad pregnant mum doria ragland 'very happy lovely news^did meghan markle tell dad pregnant mum doria ragland 'very happy lovely news^did meghan markle tell dad pregnant mum doria ragland 'very happy lovely news^cheryl 'moving 3.75m mansion bear liam payne split take look^cheryl 'moving 3.75m mansion bear liam payne split^cheryl 'moving 3.75m mansion bear liam payne split^before daughters found fame keeping up with the kardashians robert already well known oj simpson d^congratulations chris meah making shortlist digital young person year^congratulations daniel kirby making shortlist digital young person year wmtech18^congratulations waqhar shah making shortlist digital young person year^meghan markle blasted tealing princess eugenie wedding thunder prince harry royal baby news^meghan markle blasted tealing princess eugenie wedding thunder prince harry royal baby news^prince harry incredible five word outburst royal staff meghan markle wedding^meghan markle blasted tealing princess eugenie wedding thunder prince harry royal baby news^prince harry incredible five word outburst royal staff meghan markle wedding^prince harry incredible five word outburst royal staff meghan markle wedding^david beckham sister ex breaks silence family strife heartbreaking social media plea^good morning britain susanna reid embroiled furious row piers morgan david beckham speeding charge^prince harry asks william best man wedding^prince harry asks william best man wedding^meghan markle dad wo n't attend royal wedding uffering heart attack^full list bridesmaids page boys meghan markle prince harry royal wedding revealed^full list bridesmaids page boys meghan markle prince harry royal wedding revealed^full list bridesmaids page boys meghan markle prince harry royal wedding revealed^john cena nikki bella announce split six years^tonya harding threatens walk out piers morgan gbm interview tense questioning^tonya harding threatens walk out piers morgan gbm interview tense questioning,19,9,-10,28,0.6785714285714286,-0.35714285714285715,1
54368387,k103portland,1206,2643,95,14719,0,0,20,8,portland best variety today,teen choice awards nominations first wave of nominees full list^john mayer has been hospitalized emergency appendectomy^karrueche tran granted five year restraining order against chris brown^american music awards nominations amas nominees full list^celebrities react nelsan ellis dead at^ed sheeran break friendship code taylor swift despite ridiculous report katy perry^brad pitt gq divorce interview highlights on angelina jolie kids and drinking^chris soules had no alcohol in system after crash negative for drugs^halle berry not pregnant at despite reports^beyonce birth twins still hospital 'minor issue^beyonce birth twins still hospital 'minor issue^karrueche tran granted five year restraining order against chris brown^chloe grace moretz apologizes for 'red shoes marketing^celebrities remember orlando pulse nightclub shooting victims one year later^justin bieber not attend vanity fair oscars party ...^selena gomez reveals kidney transplant summer amp friend actress francia raisa donated kidney^robert pattinson charlie hunnam opened making the lost city of z joint interview^chris soules devastated killing year old farmer named kenny mosher fatal accident^mariah carey not dating both nick cannon and bryan tanaka despite report^michael strahan 'looking forward to working with alex rodriguez at abc^here how help victims las vegas mass shooting^'dance moms abby lee miller sentenced to one year in prison^taylor swift teases new song 'gorgeous on instagram listen to a snippet^alex rodriguez year old daughter sings for jennifer lopez photos^taylor swift teases new song 'gorgeous on instagram listen to a snippet^justin timberlake announces 'the man of the woods tour see the dates^camila cabello announces her 'never be the same tour see the dates^gigi hadid slams body shamers for calling her 'too skinny at nyfw,20,8,-12,28,0.7142857142857143,-0.42857142857142855,1
112486110,YahooCanada,1223,8488,173,52920,0,1,21,6,whether finance geek fantasy sports freak entertainment junkie yahoo takes love turns,"former u.s. first lady michelle obama deliver speech montreal adds edmonton speaking date march^annoyed refuses rest seems miserable says source^karrueche tran granted five year restraining order chris brown^meghan duchess sussex tackles heatwave cool 4,000 carolina herrera dress polo match^everyone missed meghan duchess sussex minor wardrobe whoops ireland royals^meghan duchess sussex accidentally eed bra everyone making *way* big deal^the measures royal family take meghan duchess sussex wants visit friends abroad^want see meghan duchess sussex wedding dress here royals^no get lip injections^meghan duchess sussex tackles heatwave cool 4,000 carolina herrera dress polo match^everyone missed meghan duchess sussex minor wardrobe whoops ireland royals^meghan duchess sussex accidentally eed bra everyone making *way* big deal^the measures royal family take meghan duchess sussex wants visit friends abroad^want see meghan duchess sussex wedding dress here royals^karrueche tran granted five year restraining order chris brown^catherine duchess cambridge rarely makes waves photos son prince george firing toy gun cause^catherine duchess cambridge looked stunning weekend dress cost 70^catherine duchess cambridge rarely makes waves photos son prince george firing toy gun cause^catherine duchess cambridge looked stunning weekend dress cost 70^just thought could n't get weirder internet freaking story says kate middleto^lindsay lohan wears hijab sparking mixed feelings social media^utterly tasteless people freaking victoria david beckham kids shooting water guns british^makes surprise appearance present colin kaepernick sports illustrated muhammad ali legacy award^actress summer phoenix files divorce casey affleck^the rules meghan duchess sussex follow full time royal^bradley cooper irina shayk welcome first child^buffythevampireslayer alum engaged boston real estate investor peter palandjian^justin theroux finally broken social media silence since split jennifer aniston",21,7,-14,28,0.75,-0.5,1
16794983,mix969,876,4594,140,28925,0,0,21,7,mix today best music mix mathew blades morning listen live free app,john mayer has been hospitalized emergency appendectomy^chris pratt files divorce from anna faris^pranked^katie couric said matt lauer pinched her on the ass on 'today back in^katie holmes not pregnant and planning wedding with jamie foxx^sorry amp n't secretly dating^amp jayz friendship reportedly good time amp kanyewest following pol^celebrity reactions prince harry meghan markle engaged^sorry looks like amp n't dating^so amp really dating^robertpattinson amp dating^fan arrested trespassing beverly hills home^i still ca n't get dress venice premiere astarisborn bradleycooper^amp returned pda filled trip jamaica dad wedding selenators^we moon excited next royalbaby meghanmarkle princeharry royalbabywatch^amp jayz friendship reportedly good time amp kanyewest following pol^talked amp lot weird fights lately^kind jealous n't get invite hang amp haha^icymi here singing funeral morning^so made juliebowen nervous filming lifeoftheparty^laying low time rehab emotional breakdown girl take time need take^stopped show really got pregnant amp okurrrr bardigang^watch harry styles kiss james corden in christmas themed 'carpool karaoke^jennifer lawrence darren aronofsky split^this learned marriage parents^still ca n't believe engaged we super jealous gf^chris pratt files divorce from anna faris^did hear aprilthegiraffe pregnant bring livestream,21,7,-14,28,0.75,-0.5,1
26524987,1025thebull,238,11982,99,122614,0,0,23,5,birmingham for new country station,teen choice awards nominations first wave of nominees full list^karrueche tran granted five year restraining order against chris brown^celebrities react nelsan ellis dead at^brad pitt gq divorce interview highlights on angelina jolie kids and drinking^selena gomez vogue cover story see interview highlights^jennifer garner ben affleck file for divorce amid false reconciliation rumor^what like create music video blake shelton cody alan connected adam rothlein inside sc^chris soules had no alcohol in system after crash negative for drugs^lady gaga taylor kinney not secretly dating despite late and wrong report^kristen stewart on dating robert pattinson 'the public were the enemy^carrie underwood forced mike fisher to retire for second baby^kim kardashian not attending paris fashion week despite claims^halle berry not pregnant at despite reports^watch kim kardashian first interview since robbery on 'ellen degeneres show videos^beyonce birth twins still hospital 'minor issue^karrueche tran granted five year restraining order against chris brown^miranda lambert refuses to talk politics 'you ca n't win anyway^chloe grace moretz apologizes for 'red shoes marketing^celebrities remember orlando pulse nightclub shooting victims one year later^robert pattinson amp charlie hunnam talk 'lost city of z on 'gma video^chris soules 'devastated after killing kenny mosher in fatal accident^mariah carey not dating both nick cannon and bryan tanaka despite report^michael strahan 'looking forward to working with alex rodriguez at abc^here how help victims las vegas mass shooting^ryan seacrest named kelly ripa new 'live co host^'dance moms abby lee miller sentenced to one year in prison^'happy days star erin moran dead at^remember guy homeless contest become mtv vj jesse camp he reported mis,23,5,-18,28,0.8214285714285714,-0.6428571428571429,1
54203238,StylistMagazine,8813,689455,4022,133926,4,0,20,4,the weekly magazine smart successful sophisticated women tweets fashion beauty books food fun stuff love,"nasa scientists want pay 12,000 stay bed days^nasa scientists want pay 12,000 stay bed days sign us^fancy lie nasa scientists want pay 12,000 stay bed days^this scientists want pay 12,000 stay bed days ...^we make point applauding next woman makes us feel inadequate achievements negate ou^why i feel sorry kate middleton fresh faced hospital exit royalbaby^why i feel sorry kate middleton fresh faced hospital exit^it kate middleton responsibility make feel good say kate middleton ho^we know play prince charles queen mother thecrown^netflix the crown announced three new cast members 're royally royally good choices^icymi prince charles thecrown^say hello new prince charles fans thecrown princecharles^say hello new prince charles fans thecrown princecharles^as nicole kidman keith urban celebrate th wedding anniversary revealed abide this^as nicole kidman keith urban celebrate th wedding anniversary revealed abide this^channing tatum jenna dewan announce separation nine years marriage^jennifer aniston justin theroux stay home avoid nasty cyber bullies critics^lisa kudrow friends co star misogynistic comments i told now f**kable^lisa kudrow friends co star misogynistic comments i told now f**kable^it important push past feelings professional self doubt just ask emma stone^emma stone says overcome serious professional insecurities take one biggest roles we could^jennifer aniston justin theroux called gossip industry divorce statement^things prince harry meghan markle want know royal wedding^things prince harry meghan markle want know royal wedding^why retracted apology vanity fair photoshoot sorrynotsorry^why miley cyrus retracted apology vanity fair photoshoot mileycyrus vanityfair^meghan markle prince harry reveal details unconventional wedding cake^meghan markle prince harry reveal details unconventional wedding cake sound delicious",24,4,-20,28,0.8571428571428571,-0.7142857142857143,1
21508174,DUANEALLEN,4216,35341,388,143439,23,2,2,1,year lead singer american music group the oak ridge boys,california democrat maxine waters charged counts do you support this via^smoking gun= gt san juan teamsters did n't show up work distribute relief supplies us aid rotting ports^julia roberts claims michelle obama isn t fit to clean melania s toilet^shaquille o neal says trump is possibly the best president of the president of all times ever he is not afraid t^breaking nfl fines pittsburgh steelers 1m each for skipping national anthem^food stamp enrollment drops four million one month breitbart via^oh tens thousands of scientists declare climate change a hoax via^it 's always been a hoax ... ..tens thousands of scientists declare climate change a hoax via^tens thousands of scientists declare climate change a hoax via^it 's always been a hoax ... ... ..tens thousands of scientists declare climate change a hoax via^melania trump undergoes kidney surgery walter reed medical center^of course wow obama orders life sized bronze statute himself to be permanently installed white house^trump approval rating better obama reagan same point presidencies via^obama latest idea even crazier than usual via st^obama latest idea even crazier than usual via st^ex cnn host crushes clintons via st^lisa page squeals dnc server was not hacked by russia via^hollywood actor bruce willis trump is the best us president ever anyone who dislikes him should move to^wasserman schultz going to mental hospital after what she did overnight desperate to escape arrest daily^breaking rosa parks daughter praises trump response charlottesville^people just found dead in ohio overnight and now trump has released shocking warning to americans daily^trey gowdy breaks his silence after of his investigators are found tortured and killed the political tribune^update hillary clinton leaves the country as mueller indictment is announced^full transcript donald trump nyc speech stakes election^rand paul drops mother all truth bombs crooked hillary via st^nbc reporter slams insane media hype teacher grading letter ttt^dennis quaid admits he was 'nervous to play the gipper american update^kim kardashian thanks donald trump granting alice marie johnson clemency via,25,3,-22,28,0.8928571428571429,-0.7857142857142857,1
19543182,rcpvideo,406,11101,376,55975,0,26,1,0,follow latest politics videos ...,watch live pence delivers joint statement with presidents guatemala el salvador honduras^state of the union panel what have we learned this week about immigration detention^stormy daniels minutes full replay/transcript^full fox news interview president trump divided congress mueller foreign policy fake news more^roundtable what does manafort indictment mean for mueller probe north korea summit predictions^full replay steve peter doocy wrangle interview from president trump on white house lawn^fox news sunday panel scotus confirmation battle north korea talks trump to meet putin^'fox news sunday panel legacy of george h.w bush how much has washington changed^fox news sunday panel is strong economy enough for gop to keep the house trump vs. cohen^fox news sunday panel is roe vs. wade on the line annapolis attack democrats shift further left^fox news sunday panel acting attorney general and mueller how will democrats run the house^'fox news sunday panel politics gets more tribal federal climate report trump vs. courts^fox news sunday panel north korea summit new iran deal trump discrediting the mueller probe^'fox news sunday panel white house trade policy at g7 north korea summit feat.^'fox news sunday panel mail bomb case temple shooting final days of midterms^'fox news sunday panel remembers charles krauthammer^fox news sunday panel legacy of george h.w bush how much has washington changed^fox news sunday panel politics gets more tribal federal climate report trump vs. courts^'fox news sunday panel acting attorney general and mueller how will democrats run the house^fox news sunday panel roseanne and samantha bee russia investigation trump kim summit^'fox news sunday panel trump makes immigration top issue what about economy iran saudi arabia^meetthepress canceled week tennis^nbc matt lauer interviews former president george w. bush ...^giuliani unsure if he could win in new hampshire fmr new york city mayor rudy giuliani r says n't kno ...^gingrich get rid of the white house press briefing^santorum super pac ad meet the real mitt romney this ad red white blue fund supportin ...^sessions illegal leak against general mike flynn is being investigated aggressively,1,26,25,27,0.037037037037037035,0.925925925925926,0
11611052,foxnewsradio,301,142278,3360,88716,2,24,0,1,the power fox news radio,suspect nyc subway walkway bombing posed trump failed protect nation facebook blast^president george h.w bush died november th home texas age discusses the^ken buck said called senator michael bennet afternoon congratulate winning u. s. senate race colorado^the centers disease control prevention issued broad warning new outbreak dangerous e.coli b^efforts resume morning raise duck boat sunk lake near branson missouri last week killing^tune in president sits chris wallace exclusive interview chec^va reform bill includes 12 billion new spending plus 5 billion offset spending cuts elsewhere^president trump new year message weekly address highlighting new republican tax plan among^plenty attack lines high profile apology last night democratic presidential debate new hampshire^an apology campaign controversy last night democratic presidential debate new hampshire^they 're getting ready hofstra university new york first presidential debate^the presidential candidates going face face toe toe hofstra university first debate^it could record breaking audience tonight first presidential debate hofstra university^tariffs work president trump doubling defense tariffs speech vfw convention kansas^president delivering first address joint session congress^the white house walking back president trump statement today would n't sign moderate immigration bill^listen fnr special coverage official campaign launch speech^people chicago hold vigil honoring victims monday hospital shooting^is president obama spiking football bin laden campaign ad fox news radio reports dc ...^white house advises vice president biden make statement rose garden pm et^president obama make statement iran rose garden et^listen fnr special coverage president obama statement iran rose garden^nj school kids taught obama praise song replacing 'jesus loves little children 'obama^a wild time white house rapper/producer kanye west dominates press briefing oval office talking^a live turkey brought james s. brady press briefing room media white house^the opening shots trade war fired ... us tariffs chinese goods go effect ... fox jill nado^pennsylvania da says retry case judge declares mistrial bill cosby sexual assault trial,2,25,23,27,0.07407407407407407,0.8518518518518519,0
66749236,HoustonsEagle,1475,2899,66,87530,0,1,7,19,houston only classic rock station 106.9 home dean rog in the morning,photos democratic presidential debate new hampshire^prince harry meghan markle a relationship timeline^international women day stars celebrate^katie couric breaks silence news matt lauer dismissal 'today^celebrities react death linkin park singer chester bennington^oprah 'intrigued idea running president friend gayle king says^richard simmons sues radaronline national enquirer protect privacy^kourtney kardashian scott disick back together^enrique iglesias anna kournikova reportedly welcome twins^report scandal end season^james franco denies allegations sexual misconduct^tamar braxton files divorce husband manager vincent herbert^meghan markle maid honor royal wedding^mtv movie amp tv awards complete winners list^portia de rossi says steven seagal unzipped pants audition^meghan markle dad heart surgery wo n't attend royal wedding report says^clay adler former mtv reality star dead^justin timberlake announces new album 'man woods^justin theroux breaks social media silence jennifer aniston split^daytime emmy awards complete winners list^storm chasers star joel taylor dead^bradley cooper irina shayk welcome first child reports say^snap inc. stock falls kylie jenner tweet snapchat redesign^celine dion donates concert proceeds victims las vegas shooting^michael jackson musical coming broadway^watch miley cyrus gives emotional performance 'malibu billboard music awards^ncis fan favorite pauley perrette leaving show seasons,7,20,13,27,0.25925925925925924,0.4814814814814815,0
29171054,RadioTimes,1730,87596,1505,178818,0,0,11,16,the home tv film on demandradio exclusive news comment analysis videos pictures much ... enquiries feedback.com,is playing prince charles the crown season^josh o'connor latest star confirmed thecrown season three say hello new prince charles^is playing prince charles the crown season^is playing prince charles the crown season^is ben affleck quitting batman^is ben affleck quitting batman^casey affleck accidentally suggests brother ben quitting batman^casey affleck accidentally suggests brother ben quitting batman^casey affleck accidentally suggests brother ben quitting batman^is ben affleck quitting batman^brad pitt quit acting three years^james mcavoy bill hader talks join jessica chastain it sequel itchapter2^james mcavoy bill hader talks join jessica chastain it sequel itchapter2^james mcavoy bill hader talks join jessica chastain it sequel itchapter2^get first look frozen stage musical^get first look frozen stage musical^meghan markle officially leaving suits season^meghan markle officially leaving suits season^warren beatty faye dunaway return present best picture oscars^outlander renewed seasons and^outlander renewed seasons and^outlander renewed seasons and^the curse queen biopic bryan singer fired directing bohemian rhapsody following set clash^the curse queen biopic bryan singer fired directing bohemian rhapsody following set clash^the curse queen biopic bryan singer fired directing bohemian rhapsody following set clash^the weinstein company set file bankruptcy failure last ditch talks according reports^the sopranos amp goodfellas actor frank vincent dies ripfrankvincent,11,16,5,27,0.4074074074074074,0.1851851851851852,0
35602095,hot96tweets,12841,22300,86,22908,0,0,13,14,the tri-state hit music station -10 -2 -6 -10,reportedly teaching boyfriend alex rodriguez dance^trending katie couric says matt lauer pinched butt lot matt fired today nbc innapro^trending kylie jenner reportedly pregnant travis scott baby^celebrityjuice sources say sudden engagement marriage may played rol^celebrityjuice kim kardashian recently rushed kanye west hospital suffering flu^celebrityjuice katy perry threw shade towards taylor swift american idol the feud lives^coming juice new details surfaced angelina jolie brad pitt divorce |^trending abc reportedly made offer judge next season |^trending selena gomez says interested judge american idol^coming juice new details surfaced angelina jolie brad pitt divorce |^celebrityjuice katy perry threw shade towards taylor swift american idol the feud lives^celebrityjuice sources say sudden engagement marriage may played rol^celebrityjuice left rehab following emotional breakdown |^icymi announced new co host abc live^icymi wife eniko parrish eecting first child together it baby boy congra^icymi kevin hart wife eniko parrish eecting first child together^icymi abc renewed american idol second season network^it looks like plans give birth cleveland^trending congrats miss district columbia kara mccullough crowned miss usa^icymi kara mccullough miss district columbia crowned miss usa this second year row w^congrats rachel mcadams sources close confirmed pregnant first child.^pregnant first child^eazy spoken first time since arrested sweden charges assault resisting arrest a^hakuna matata seth rogen billy eichner currently talks star timon pumbaa live action r^trending hakuna matata seth rogen amp billy eichner talks star timon amp pumbaa live action rema^icymi kevin spacey announced host tony awards year the tony awards june th^trending pauley perrette leaving 'ncis seasons,13,14,1,27,0.4814814814814815,0.037037037037037035,0
16343974,Telegraph,722,2733940,17701,354431,0,2,15,10,think ahead latest news comment analysis video,donald trump abortion stance alienating females christian support enough win midterms^is visionary madman join debate new war words series^oprah winfrey says waiting ign god run us president^jennifer aniston spokesman denies reports year old actress eecting 'miracle baby^jennifer aniston 'pregnant miracle baby aged husband justin theroux^jennifer aniston spokesman denies reports year old actress eecting 'miracle baby^jennifer aniston 'pregnant miracle baby aged husband justin theroux^oscars winners list full plus talking points academy awards^eva longoria pranked victoria beckham forcing swap heels ugg boots^eva longoria pranked victoria beckham forcing swap heels ugg boots^angelina jolie interview 'i n't enjoy single something i wanted premium^'daft michael parkinson wrong billy connolly brain 'dulled wife says^'i n't think i 'm victim i woman s**t situation georgina chapman breaks silence life h^miami divided david beckham tries win sceptical city football team bid^did picture brad pitt co star selena gomez contribute breakdown marriage angelina jolie^i ca n't think better replacement someone like prince charles thomas markle opens missing his^sarah jessica parker matthew broderick twins via surrogate sarah jessica parker matthew broderi..^former love island contestant sophie gradon dead^prince harry meets first lady melania trump ahead invictus games^emma watson donates 1 million anti sexual harassment campaign^comedian louis ck accused sexual misconduct five women^comedian louis ck accused sexual misconduct five women^don rickles toy story star legendary comedian dies aged^simon cowell rushed hospital accident london home^julia louis dreyfus diagnosed breast cancer^pippa middleton arrives prince harry meghan markle wedding^weinstein company set file bankruptcy,15,12,-3,27,0.5555555555555556,-0.1111111111111111,1
84620643,theNETng,9506,45877,196,86021,0,1,19,7,official twitter page net the world no website african entertainment since nov ff contact.ng,faan issues statement after aremu afolayan video accusing immigration officers of collecting bribe went viral^oops blac chyna request trademark angela kardashian gets denied^kanye west gave kim kardashian a million dollars for refusing a brand deal^chrissy teigen opens up about her postpartum depression for the first time as she covers glamour magazine^kanye west and nick cannon settle their beef over kim kardashian^next baby will be a boy kanye west and kim kardashian have one embryo left^kim kardashian reportedly upset about her husband kanye west decision on moving back to chicago^kylie jenner baby daddy travis scott pleads guilty to disorderly conduct^icymi kylie jenner baby daddy travis scott pleads guilty to disorderly conduct^kylie jenner baby daddy travis scott pleads guilty to disorderly conduct^blac chyna considers suing rob kardashian revenge porn^see full list grammy awards winners^see full list grammy awards winners^kanye west and nick cannon settle their beef over kim kardashian^kim kardashian reveals kanye west started a fight because she gave their son more attention than him^khloe kardashian ex husband lamar odom supposedly now dating tiffany haddish^icymi khloe kardashian ex husband lamar odom supposedly now dating tiffany haddish^heidi klum flaunts bikini body^here why selena gomez had an emotional breakdown^justin bieber gets comforted by church friends after news of selena gomez emotional breakdown^kevin hart wife eniko parrish eecting first child together^third suspect in xxxtentacion murder arrested in georgia^tina turner eldest son craig raymond turner found dead in apparent suicide^kim kardashian returns to paris for the first time since robbery^actor bradley cooper amp victoria secret model irina shayk welcome their first child^katy perry host mtv video music awards^judge declares mistrial bill cosby sexual assault case,19,8,-11,27,0.7037037037037037,-0.4074074074074074,1
23223409,JAMN1075,3335,7313,140,16875,0,0,23,4,portland hip hop throwbacks,amber rose i did not laugh at molestation victim^karrueche tran granted five year restraining order against chris brown^celebrities react nelsan ellis dead at^celebrities react trump withdraws steph curry white house invitation^beyonce not demanding silent delivery room despite report^are selena gomez amp the weeknd working on a movie together^chris brown slammed by judge for skipping karrueche tran court hearing^did jennifer lopez 'like a comment dissing mariah carey^katherine jackson resigns as blanket guardian^kanye west concerts on hold indefinitely^halle berry not pregnant at despite reports^watch kim kardashian first interview since robbery on 'ellen degeneres show videos^beyonce birth twins still hospital 'minor issue^karrueche tran granted five year restraining order against chris brown^mary j. blige hacked did not write kendu isaacs hate tweet^kanye west left twitter came back share feels mind control^celebrities react nfl players kneel lock arms during national anthem^oprah not running for president says gayle king^grammy awards see the full winners list^kanye west is not rebooting 'american idol^celebrities thank barack obama on last day as president^obamas celebrate th anniversary after false split stories^mariah carey not dating both nick cannon and bryan tanaka despite report^alex rodriguez year old daughter sings for jennifer lopez photos^here the complete list of bet awards winners^tori kelly is engaged to german basketball player andre murillo^billboard music awards nominations see full list of bbmas nominees,23,4,-19,27,0.8518518518518519,-0.7037037037037037,1
18563796,KTAR923,614,44218,1110,104375,0,25,1,0,arizona news station hear ktar news your home breaking news traffic,the centers disease control prevention found life eectancy u.s. dropped third year in^three reports released centers disease control prevention last week showed life eectancy t^fentanyl no drug involved overdoses nationwide according centers disease control and^the centers disease control prevention warned consumers week eating raw cookie dough cake mixe^kyrsten sinema delivered acceptance speech winning bid u.s. senate monday citing late j^meghan mccain daughter sen. john mccain said honored senator elect kyrsten sinema used la^meghan mccain daughter sen. john mccain said honored newly elected senator home^kyrsten sinema cited john mccain positive outlook american politics example arizonans carry o^kyrsten sinema acceptance speech winning azsen race pointed late sen. john mccain example^sen. john mccain working physical therapy attempt get stronger battles deadly brain ca^one hundred percent funds raised go toward necessary eenses like travel funeral eenses his^sen. john mccain featured hbo documentary include interviews family friends polit^meghan mccain daughter late sen. john mccain praised gov doug ducey interview on^the arizona department transportation working education business leaders change dismal statisti^the centers disease control prevention found life eectancy u.s. dropped third year in^three reports released centers disease control prevention last week showed life eectancy t^fentanyl no drug involved overdoses nationwide according centers disease control and^the centers disease control prevention warned consumers week eating raw cookie dough cake mixe^vice president joe biden make statement white house rose garden^in interview minutes said going celebrate gratitude life well lived^tune p.m. exclusive interview^meghan mccain daughter late sen. john mccain praised gov doug ducey interview on^meghan mccain daughter late sen. john mccain praised gov doug ducey interview on^the u.s. department agriculture scale back school lunch standards arizona official said students sh^the recent northern california wildfires attributed climate change less connection to^president donald trump said major federal investigation underway find responsible suspicious p,1,25,24,26,0.038461538461538464,0.9230769230769232,0
1587296611,thrstyle,689,32875,648,30239,0,1,6,19,how hollywood lives powered,one hundred percent proceeds woolsey fire thousand oaks themed tees go non profits incl^it official gwen stefani blake shelton dating^kevin hart wife eniko parrish welcome baby boy^harry styles reveals style icon shania twain^dakota johnson got um interesting new hair 'do february cover^gayle king says oprah winfrey was joking about running president^kate hudson reveals pregnant third child^enrique iglesias anna kournikova welcome twins report^rachel weisz pregnant eecting first child daniel craig^rachel mcadams welcomes first child report^seth meyers host cfda fashion awards^mindy kaling is pregnant with her first child report^mindy kaling is pregnant with her first child report^billy bush wife sydney davis separate years marriage^billy bush wife sydney davis separate years marriage^kaley cuoco bigbangtheory marries karl cook^surprise michael fassbender alicia vikander reportedly married^surprise michael fassbender alicia vikander reportedly married^michael fassbender alicia vikander married report^presley gerber gets tattoo sister kaia gerber name^katharine mcphee david foster engaged^kim kardashian kanye west reportedly hire surrogate carry baby no^see best street style cannes film festival^the complete list costume designers guild award winners^the complete list costume designers guild award winners^this emma stone gained pounds muscle role 'battle sexes,6,20,14,26,0.2307692307692308,0.5384615384615384,0
21419504,WCVB,971,280744,2974,443003,0,5,7,14,real time updates boston news leader wcvb newscenter,"video democratic presidential candidates debate new hampshire^lester holt moderator first presidential debate registered republican according nys voting records via debates^most popular baby names every u.s. state^most popular baby names every u.s. state^us slaps 50 billion tariffs chinese goods escalating trade dispute^what roseanne barr net worth^david cassidy fighting memory loss wants 'enjoy life^tonya harding made 'dancing with stars finale fans livid^george clooney makes 27,283 every hour thanks tequila^mariah carey new year eve performance 'they foiled^mariah carey new year eve performance 'they foiled^caitlyn jenner latest celebrity float run office^james franco event canceled actor denies allegations sexual misconduct^playboy founder hugh hefner cause death revealed^icymi playboy founder hugh hefner cause death revealed^playboy founder hugh hefner cause death revealed^mindy kaling reportedly pregnant first child^'clueless actress stacey dash running congress california^'clueless actress stacey dash running congress california^kaley cuoco marries karl cook intimate horse ranch wedding^discovery channel 'storm chasers star joel taylor dead^discovery channel 'storm chasers star joel taylor dead^billboard music awards check complete list winners^billboard music awards check complete list winners^reese witherspoon confirms 'legally blonde happening^april giraffe pregnant",7,19,12,26,0.2692307692307692,0.4615384615384616,0
18206318,TheSpec,935,115694,1150,202102,0,3,10,13,headlines alerts comments hamilton spectator use hamont join conversation -800-263-6902 subscribe,in rare move toronto police released statement wednesday night saying investigators determined video o^in recent fox news interview u.s. president donald trump said man almost certainly ordered hit ja^in recent fox news interview u.s. president donald trump said man almost certainly ordered hit ja^tabloids meghan markle miserable everybody else ... step inside royal hellscape bann^tabloids meghan markle miserable everybody else roundup celebrity headlines^meghan markle always looks like million bucks we mean quite literally since getting engaged prince harr^fergie josh duhamel split hiding getting little weird says^they foiled mariah carey calls sabotage disastrous new year eve^kim kardashian kanye west wed secretly week^jennifer lawrence first nude scene since hacked photo leak from 'terrified 'empowered'^opinion do need know much ben affleck^opinion do need know much ben affleck^meghan markle dad missing wedding prince harry donald trump^rocker tom petty dead^koko gorilla famous using sign language dies sleep^ryan seacrest kelly ripa new co host live^ryan seacrest kelly ripa new co host live^ryan seacrest kelly ripa new co host live^prince harry asks william best man william said would honoured^tonya harding admits prior knowledge nancy kerrigan attack abc special^tonya harding admits prior knowledge nancy kerrigan attack abc special^walmart remove 'cosmopolitan magazine checkout lines amid me too movement^everything want know meghan markle prince harry royal engagement photos^jennifer aniston 'has seemed fine since justin theroux split^jennifer aniston 'has seemed fine since justin theroux split^jennifer aniston 'has seemed fine since justin theroux split,10,16,6,26,0.38461538461538464,0.2307692307692308,0
13049362,Complex,686,1849866,10594,325909,0,0,12,14,making culture pop,nothing sway kylie she wants matter^blac chyna attempt trademark angela renee kardashian shut meanwhile calabasas..^chris pratt files divorce anna faris^get raunchy steven klein racy bondage themed photo shoot^kim kardashian britney spears celebrities looking absolutely terrified roller coasters^drake releases statement following scarf controversy i utilized fake media story^joey fatone denies rumors *nsync reunion super bowl^matt lauer officially replaced hoda kotb 'today^here reported details angelina jolie brad pitt temporary divorce agreement^scott disick says getting back together kourtney kardashian trolling nah^rob kardashian suing blac chyna reportedly beating high drunk^here reported details angelina jolie brad pitt temporary divorce agreement^katy perry announces release date tour new album 'witness^meet playboy first transgender playmate ines rau^helped buy house pregnant homeless fan^third suspect arrested murder xxxtentacion^jhen aiko shoots big sean cheating rumors^'house cards producers thinking killing kevin spacey frank underwood^ashley judd sues harvey weinstein sexual harassment defamation^justin timberlake announces release date new album 'man woods^kylie jenner gives birth child first travis scott^'game thrones stars rose leslie kit harington married^gwyneth paltrow denies becky good hair amber rose suggests^serena williams withdraws australian open^beyonc eminem weeknd headline coachella^chris pratt files divorce anna faris,12,14,2,26,0.4615384615384616,0.07692307692307693,0
7313362,chicagotribune,403,1095377,11775,189848,1,17,1,6,breaking news since,federal prosecutors charge accused nyc subway bomber say wrote facebook attack trump failed^in livestream the washington post morning james comey responded rudy giuliani recent insinuations^after chicago meeting democrats gut influence superdelegates presidential nomination process plan^president trump asks republican national committee chairwoman ronna mcdaniel serve second term^the california bar shooting victims a veteran police officer little league umpire recent college graduate^this tragedy grand scale we long way go but move forward love light vi^rogers park shooting victims remembered menorah lighting it remind light actually m^they professors accountants dentists beloved doctors serving local community pittsburgh synago^this is us struck emotional cord end tuesday episode screen tribute victims of^shooting victims how chicago emergency rooms handled violent weekend year^mourning protests pittsburgh buries synagogue shooting victims^victims mass shooting las vegas country music festival said outraged learned wer^on would 've joaquin oliver th birthday friends family stood outside nra headquarters virg^watch live vice president joe biden deliver statement rose garden^sen. heller said vehemently opposed trump returned one campaign donations campaign r^bob woodward sought interview president donald trump writing fear book trump preside^donald trump greeted friday news u.s. economy percent growth rate nd quarter impromp^top white house officials urged senators keep supporting u.s. involvement saudi led war yemen but aft^john mayer hospitalized emergency appendectomy according statement dead amp company whom^jury bill cosby sexual assault case deadlocked entering fifth day deliberations^pro golfer tiger woods arrested dui charge florida^elisabeth moss found emmy nomination courtesy shirtless anthony rizzo gif^tina fey sees many similarities julia louis dreyfus awarded mark twain prize^scott hutchison frontman scottish rock ban frightened rabbit found dead near edinburgh^does photo prove amelia earhart survived final flight investigators think,2,23,21,25,0.08,0.84,0
102480261,NBCNewsPR,1073,43845,1082,32834,0,23,2,0,the official twitter feed communications,just now sen. d va. wtih it appears rather strange coincidence that^this sunday sen. r mo joins exclusive interview cc^tune in tomorrow r alaska met supreme court nominee kavanaugh week joins^this sunday senate minority whip d ill. joins exclusive inter^ratings wins nd straight quarter across board most watched sunday show^this sunday amp^tomorrow sen. join plus exclusive interview with^let start simple question summit still asks u^tomorrow robinson amp join roundtable with^tune in tomorrow us ambassador russia joins mtp^this morning u.s ambassador russia talks moderator rus^i really would feel much better americans room shares sen. d va. on^tune in tomorrow sen. r mo joins exclusive interview mtp^plus join sunday rou^tomorrow jordan amp join roundtable^ratings wins july across board eighth straight month gt^tune in tomorrow update rudy giuliani lawyer president trump join mtp^now no state dinner joint statement deliverables going pre packaged you^ratings wins november sweep across board fourth straight sweep period^tomorrow senate minority whip d ill. joins exclusive intervie^the agenda president everything call i think highly unlikely 'll see c^rt watch matt lauer interview former president george w. bush video^tune in matt lauer exclusive live studio interview former president george w. bush airs tomorrow on^opens hour today know starting new chapter third hour o^chose becoming first female co anchors one thei,2,23,21,25,0.08,0.84,0
25530716,KAMRLocal4News,2316,13677,348,91825,1,21,1,2,your local news leader we proud first tv station amarillo we tell stories high plains myamarillo,"this new federal rule 've never reaction federal government try inc^the u.s. energy information administration said wednesday based preliminary estimates america likely sur^the tally ,000 cases percent increase previous year the centers disease c^this year count could surpass tallies seen similar outbreaks officials said fortunately^an estimated ,000 young children vaccination diseases shots r^the centers disease control prevention says investigating possible cases afm states^more ,000 people died drug overdoses last year according preliminary numbers released centers^the us centers disease control prevention says people sickened salmonella linked to^previously fda centers disease control prevention urged consumers eat romaine lett^the u.s. energy information administration said wednesday based preliminary estimates america likely sur^for months texas battled u.s. department education interpret federal statute pr^the tally ,000 cases percent increase previous year the centers disease c^this year count could surpass tallies seen similar outbreaks officials said fortunately^an estimated ,000 young children vaccination diseases shots r^the centers disease control prevention says investigating possible cases afm states^more ,000 people died drug overdoses last year according preliminary numbers released centers^the us centers disease control prevention says people sickened salmonella linked to^previously fda centers disease control prevention urged consumers eat romaine lett^the u.s. energy information administration said wednesday based preliminary estimates america likely sur^while heading u.s. department agriculture bob bergland commissioned major report structure amer^more ,000 pounds raw ground turkey recalled possibly linked large number peo^a possible second round tariff hikes announced tuesday u.s. trade representative targets 200 billion l^tonight miley cyrus liam hemsworth secretly get married don miss etnow^ryan seacrest kelly ripa new co host 'live^after years kermit frog getting new voice",2,23,21,25,0.08,0.84,0
13115682,azcentral,611,383040,3320,231377,1,20,2,2,award-winning local journalism bad jokes woodward palmieri instagram azcentral,his ultimate goal shrink code federal regulations size^video asia argento shared first public statement suicide death boyfriend anthony bourdain.a^video asia argento shared first public statement suicide death boyfriend anthony bourdain.a^one six women one men eerienced stalking according centers disease control prev^the centers disease control prevention linked popular kellogg cereal honey smacks salmonella outbrea^emotional sen. john mccain blasts 'half baked spurious nationalism acceptance speech^the suit alleges column defamed presenting record sheriff false light '' hinder p^sen. john mccain visited the arizona republic/azcentral.com newsroom last august would final interv^in new wide ranging magazine interview meghan mccain offered details relationship father u.s. s^watch sen. john mccain last interview video the arizona republic/azcentral.com taken last august h^video former vice president biden blasts trump immigration policies speech phoenix convention center^video former vice president biden blasts trump immigration policies speech phoenix convention center^video after social media blew debate laurel vs. yanny recorded audio of^video after social media blew debate laurel vs. yanny recorded audio of^the centers disease control prevention said outbreak largest e. coli outbreak deca^sen. john mccain visited the arizona republic/azcentral.com newsroom last august would final interv^in new wide ranging magazine interview meghan mccain offered details relationship father u.s. s^watch sen. john mccain last interview video the arizona republic/azcentral.com taken last august h^sen. john mccain visited the arizona republic/azcentral.com newsroom last august would final interv^in new wide ranging magazine interview meghan mccain offered details relationship father u.s. s^watch sen. john mccain last interview video the arizona republic/azcentral.com taken last august h^video billy bush confirms trump 'access hollywood tape^video billy bush confirms trump 'access hollywood tape^video hgtv announced winning bid iconic brady bunch house sale north^video hgtv announced winning bid iconic brady bunch house sale north,3,22,19,25,0.12,0.76,0
17527859,richberra,1826,113181,288,17576,0,0,3,22,the personal tweets rich berra johnjay rich radio program loveup,do n't listen kathy hilton jennifer aniston is not eecting baby girl e news^international women day facts celebrate special day daily star^selena gomez the weeknd have secretly been dating year exclusive in touch weekly^anna kournikova enrique iglesias welcome twins daily mail online^mtv movie amp tv awards full list nominees e news^becky g mistaken fan security fifth harmony concert e news^katy perry proves she best surprise wedding guest starting epic dance party e news^miss north dakota cara mund crowned miss america entertainment tonight^mtv movie amp tv awards complete list winners cbs news^britney spears addresses all those lip syncing rumors it really pisses me off e news^luke skywalker returns millennium falcon new 'star wars the last jedi trailer entertainment tonight^pumpkin spice season is already here ways you can celebrate early e news^cma awards nominations announced miranda lambert taylor swift more nominees e news^why paris hilton is happy she grew up before social media e news^beyonc family pics among never before seen photos how to make lemonade box set book e news^jason aldean asks americans come together after las vegas shooting e news^pink defends her super bowl national anthem performance e news^lady gaga announces las vegas residency billboard^billboard music awards winners complete list billboard^animaniacs may be coming back tv near you e news^mtv emas taylor swift leads nominations billboard^13 reasons why renewed for season by netflix deadline^sources eminem beyonc the weeknd headline coachella consequence sound^why you 'll never catch kate middleton wearing red nail polish e news^david s. pumpkins is back tom hanks reprising iconic saturday night live role halloween special e news,3,22,19,25,0.12,0.76,0
17028405,ABC7Chicago,1540,773800,3798,194792,1,8,7,9,follow abc chicago news chicago news weather sports eerienced chicago news team,first lady melania trump undergoes kidney surgery walter reed medical center^sen. john mccain getting ready interview hosea judy live :30am half hour^hundreds attend chicago area vigils pittsburgh synagogue shooting victims^breaking a chicago police officer among multiple victims mass shooting mercy hospital chicago sout^special report vice president joe biden make statement rose garden ... now^in sit interview mayor emanuel talks making big decision earlier summer discussions wi^live video president obama speaks economy galesburg ill. knox college ... now^in sit interview mayor emanuel talks making big decision earlier summer discussions wi^live video president obama speaks economy galesburg ill. knox college ... now^david cassidy fighting memory loss wants 'enjoy life^channing tatum jenna dewan tatum announce separation^bishop michael curry became star stirring minute sermon royal wedding prince harry and^meghan markle prince harry moving make room baby^meghan markle prince harry moving windsor ahead st child^meghan markle prince harry moving make room baby^caitlyn jenner latest celebrity float run office^neil diamond retires touring diagnosis parkinson disease^happy nationalchocolateday here popular halloween candy state^vince vaughn arrested suspicion dui manhattan beach^vince vaughn arrested suspicion dui manhattan beach^vince vaughn arrested suspicion dui manhattan beach^meghan markle says dad attend royal wedding^'game thrones stars kit harington rose leslie married^'game thrones stars kit harington rose leslie married^'game thrones stars kit harington rose leslie married,8,17,9,25,0.32,0.36,0
14897840,ABC7News,1047,156776,2884,320112,3,6,5,11,breaking news weather sports information washington d.c. area abc newsroom,watch live president trump talks new initiative improve vets care dept veterans teleheath event on^watch live facebook page president donald trump gives remarks american legion boys amp girls na^just in nyc subway bomb suspect faces federal charges posted trump failed protect nation faceboo^read full transcript abc7 scott thuman exclusive interview president barack obama^watch live president trump speaking national republican congressional committee march dinner^sarah huckabee sanders holding white house press briefing^on with sean spicer sat former white house press secretary talk resignat^a u.s. department agriculture lab beltsville maryland euthanizing thousands kittens cats ov^recall alert tens thousands pounds jimmy dean meat products possibly containing pieces metal have^stedman graham oprah partner skips royalwedding speak coppin state graduation^report ryan phillippe 'devastated 'false allegations domestic violence^mariah carey new year eve performance 'they foiled^report angelina jolie named bizarre lax terror threat sent police^d.c. mayor muriel bowser administration officials holding press conference farragut salt dome give^koko gorilla knew sign language dies^james franco denies sexual misconduct allegations^third suspect arrested xxxtentacion murder^matt damon apologizes comments sexual misconduct^meghan markle dad reportedly wo n't attend royal wedding staging photos^steve martin martin short 'colonoscopy parties tom hanks^breaking reports former fox news ceo roger ailes dead^fergie josh duhamel announce split years marriage^meryl streep joins cast 'big little lies season^richard simmons hospitalized severe indigestion^reports kylie jenner pregnant,8,17,9,25,0.32,0.36,0
39311859,koconews,835,145469,1276,212056,2,2,7,14,oklahoma city area news updates koco tune m-f :30-7 a.m. a.m. p.m,"people found dead ohio^people found dead ohio^most popular baby names every u.s. state^us slaps 50 billion tariffs chinese goods escalating trade dispute^what roseanne barr net worth^icymi megyn kelly weighs matt lauer fired 'today show^david cassidy fighting memory loss wants 'enjoy life^tonya harding made 'dancing with stars finale fans livid^george clooney makes 27,283 every hour thanks tequila^mariah carey new year eve performance 'they foiled^caitlyn jenner latest celebrity float run office^james franco event canceled actor denies allegations sexual misconduct^playboy founder hugh hefner cause death revealed^playboy founder hugh hefner cause death revealed^playboy founder hugh hefner cause death revealed^playboy founder hugh hefner cause death revealed^mindy kaling reportedly pregnant first child^'clueless actress stacey dash running congress california^kaley cuoco marries karl cook intimate horse ranch wedding^discovery channel 'storm chasers star joel taylor dead^icymi discovery channel 'storm chasers star joel taylor dead^billboard music awards check complete list winners^billboard music awards check complete list winners^netflix is reportedly reviving carmen sandiego with gina rodriguez^reese witherspoon confirms 'legally blonde happening",9,16,7,25,0.36,0.28,0
14426369,ksbw,178,98252,580,185808,2,1,8,14,monterey salinas santa cruz news weather sports ksbw action news,melania trump undergoes kidney surgery walter reed medical center^people found dead ohio^most popular baby names every u.s. state^megyn kelly weighs matt lauer fired 'today show^megyn kelly weighs matt lauer fired 'today show^david cassidy fighting memory loss wants 'enjoy life^icymi david cassidy fighting memory loss wants 'enjoy life^is kim kardashian pursuing music career^mariah carey new year eve performance 'they foiled^'free speech rally 'fight supremacy groups set converge boston common^caitlyn jenner latest celebrity float run office^james franco event canceled actor denies allegations sexual misconduct^playboy founder hugh hefner cause death revealed^playboy founder hugh hefner cause death revealed^playboy found hugh hefner cause death revealed^mindy kaling reportedly pregnant first child^mindy kaling reportedly pregnant first child^mindy kaling reportedly pregnant first child^'clueless actress stacey dash running congress california^'clueless actress stacey dash running congress california^discovery channel 'storm chasers star joel taylor dead^discovery channel 'storm chasers star joel taylor dead^discovery channel 'storm chasers star joel taylor dead^everything need know 'this is us season^netflix is reportedly reviving carmen sandiego with gina rodriguez,10,15,5,25,0.4,0.2,0
19870967,UPROXX,8220,87050,2019,155441,1,0,10,14,the culture now,texas ag chief sid miller blames staffer tweeting deleting c word at clinton^jennifer aniston justin theroux announce 've 'lovingly split two years marriage^busy philipps roasted lindsay lohan bizarre drunk looking dancing mykonos^jennifer aniston justin theroux announce 've 'lovingly split two years marriage^justin bieber hailey baldwin reportedly already married^jennifer aniston justin theroux announce 've 'lovingly split two years marriage^katy perry may added taylor swift feud subtle diss americanidol^relive mariah carey trl ice cream meltdown on the latest scheer rl^donald trump lashes 'no talent guy stephen colbert 'filthy^two popular strangerthings characters originally going die season^katy perry may added taylor swift feud subtle diss americanidol^strangerthings officially renewed season^bojack still good making love hate life equal measures h^barry great comedy also worked equally impressive drama still killing^robert pattinson revealed nearly fired 'twilight smiling enough^robert pattinson revealed nearly fired 'twilight smiling enough^get first look disney frozen the broadway musical^arresteddevelopment season way likely since jason bateman officially signed^arresteddevelopment season way likely since jason bateman officially signed^taylor swift teases new song called 'gorgeous baby talk weird synths^former mtv vj jesse camp reported missing sister california^we know character probably die next season thewalkingdead^announces 'man of the woods tour 'bring outside^leonardo dicaprio star quentin tarantino untitled charles manson movie via^missionimpossible star ving rhames says police held gunpoint home,11,14,3,25,0.44,0.12,0
19955912,1035KTU,1590,30234,535,46317,0,0,11,14,the beat new york call -800-245-1035 text,watch brad pitt surprises philly movie theater 'world war z showing crushing cheese steak^will benaffleck amp jenniferlopez get back together^watch liamhemsworth prank mileycyrus^watch liamhemsworth prank mileycyrus^watch liamhemsworth prank mileycyrus^what selenagomez feeling justinbieber engaged ...^justinbieber may married not selenagomez details^not dating^the weeknd split with selena gomez caused him to scrap an upbeat album^are kyliejenner travisscott getting married^khloekardashian forced relive one difficult times life latest episode kuwtk^the second suspect xxxtentacion murder case arrested^the second suspect xxxtentacion murder case arrested^'superman star margot kidder dead at r.i.p^kermit the frog getting new voice years^kermit the frog getting new voice years^kermit the frog getting new voice years^shailene woodley ate only calories day adrift rolehttps //^everything know upcoming reasonswhy season^everything know upcoming reasonswhy season^everything know upcoming reasonswhy season^everything know upcoming reasonswhy season^everything know upcoming reasonswhy season^slams body shamers calling too skinny nyfw^slams body shamers calling too skinny nyfw,11,14,3,25,0.44,0.12,0
709913315665793024,BravoNewZealand,475,2973,24,4536,0,0,11,14,say hello bravo entertainment lifestyle tv channel,do kris jenner caitlyn jenner ever talk^surprise katharine mcphee david foster engaged^how george clooney life changed forever after meeting amal clooney^kim kardashian kanye west brawl over band aids instagram^kim kardashian called *this* major celebrity intervene kanye west lowest^here proof kourtney kardashian is living her best life after younes bendjima breakup^how scott disick feels about kourtney kardashian younes bendjima breakup^do kris jenner caitlyn jenner ever talk^kanyewest returns twitter with video about mind control days after white house visit^angelina jolie brad pitt custody battle will go trial^kim kardashian kanye west brawl over band aids instagram^khloe kardashian laughs off post baby bikini video^kendall jenner ben simmons cuddle up khloe kardashian fourth july party^nervous kimkardashian returns paris first time since robbery kuwtk^ewan mcgregor daughter calls his girlfriend mary elizabeth winstead trash^watch tristan thompson dotes baby true heartwarming new video^khloe kardashian coos grinning baby true thompson adorable video^oprah winfrey recalls prince harry meghan markle glowing happiness royal wedding^priyanka chopra nick jonas are engaged here why our money is royal maid honor^chris pratt smitten katherine schwarzenegger inside their budding romance^surprise katharine mcphee david foster engaged^kylie jenner is already thinking about stormi epic first birthday party^prince harry thinks having children with meghan markle would be too many^paris hilton clarifies her lindsay lohan pathological liar comment^khloe kardashian reveals she wanted baby boy so badly,11,14,3,25,0.44,0.12,0
21316049,933thebeatjamz,624,7599,105,26416,0,0,16,9,jacksonville home hip-hop r b flava am-10am am-2pm pm-7pm pm-12am,coming :54 angela yee another rumor report what kim kardashian doctor say butt^american music awards nominations amas nominees full list^jamie foxx katie holmes finally out public as couple^celebrities react trump withdraws steph curry white house invitation^celebrities react to hurricane irma^chris brown slammed judge skipping court hearing related karrueche tran retraining order^katherine jackson resigns as blanket guardian^no drake is n't 'lusting after rihanna despite new rumors^katie holmes not pregnant and planning wedding with jamie foxx^sorry drake amp bella hadid are not 'secretly dating^celebrity reactions prince harry meghan markle engaged^halle berry pregnant despite slew inaccurate reports^chris brown urges fans to donate to year old boy 'new legs gofundme^celebrities react nfl players kneel lock arms during national anthem^iggy azalea blasts nick young after accidental dinner reunion^obamas celebrate th anniversary after false split stories^here how help victims las vegas mass shooting^tisha campbell martin files for divorce from husband duane^khlo kardashian makes her first public appearance since pregnancy news^madonna files emergency order to stop tupac shakur letter auction^tamar braxton files divorce from vincent herbert^nelly officially under criminal investigation sexual assault^star jones ex husband al reynolds comes out as bisexual in candid blog^'black panther is officially the most tweeted about movie of all time^demi lovato announces tour with dj khaled see the dates,16,9,-7,25,0.64,-0.28,1
20493439,WGCI,412,68755,572,58745,0,0,17,8,wgci we run the chi the wgci morning show -10am,karrueche tran granted five year restraining order against chris brown^celebrities react nelsan ellis dead at^beyonce not demanding silent delivery room despite report^chris brown slammed by judge for skipping karrueche tran court hearing^katherine jackson resigns as blanket guardian^no drake is n't 'lusting after rihanna despite new rumors^kim kardashian slams cocaine claim 'i do not play with rumors like this^halle berry not pregnant at despite reports^mariah carey amp french montana did not flirt in recording studio^beyonce birth twins still hospital 'minor issue^karrueche tran granted five year restraining order against chris brown^chris brown urges fans to donate to year old boy 'new legs gofundme^celebrities react nfl players kneel lock arms during national anthem^kim kardashian slams 'invasive surrogacy reports^everything may missed vs twitter fight abandoning^obamas celebrate th anniversary after false split stories^mariah carey not dating both nick cannon and bryan tanaka despite report^tisha campbell martin files for divorce from husband duane^khlo kardashian makes her first public appearance since pregnancy news^tamar braxton files divorce from vincent herbert^hugh hefner cause death revealed^alex rodriguez year old daughter sings for jennifer lopez photos^here the complete list of bet awards winners^star jones ex husband al reynolds comes out as bisexual in candid blog^'black panther is officially the most tweeted about movie of all time,17,8,-9,25,0.68,-0.36,1
30589869,VonBoozierTwins,2644,4330,98,84696,0,0,17,8,the real twins of nyc follow us to get a behind the scenes look at our journey in hollywood keepin it real since let work,kanye west auditions american idol san francisco brings kim kardashian see photos^gwen stefani blake shelton photographed first time official couple^karrueche tran screw chris brown ... i can post pics whoever i want video^ben affleck jennifer garner look tense during their post divorce bahamas trip see emotional pic^brad pitt is very upset about angelina jolie divorce is committed giving kids stability^kim kardashian shows off baby bump while sisters kourtney kendall kylie jenner flaunt leggy looks^nina dobrev ex ian somerhalder marrying nikki reed was 'beautiful^ozzy osbourne sharon osbourne split after more than years marriage^miley cyrus amp liam hemsworth split signs their engagement was rocks^katie holmes has lunch with mystery man new york city^kylie jenner says her hair is partially destroyed then debuts new hairstyle^kim kardashian shows off baby bump while sisters kourtney kendall kylie jenner flaunt leggy looks^jennifer aniston takes break from cake with justin theroux^matt bomer really proud wentworth miller coming out gay^royal baby boy is here see easel set up outside buckingham palace official announcement^kate carrying twins^katie holmes takes suri brooklyn catches up with dawson creek costar joshua jackson^rip here lies everything that so over^met gala see all red carpet arrivals^pregnant jessica simpson i 'm having boy plus get load how she broke news^bootcut jeans will you kick your skinny jeans curb^kesha mother drops counterclaims against dr. luke she tries find peace forgiveness her heart^the murder jonben t ramsey why we 're still obsessed with this case years after her death^cmt music awards nominations announced see complete list^inside world most shocking royal scandals,17,8,-9,25,0.68,-0.36,1
24688577,Y1025,182,1886,41,16107,0,0,17,8,the lowcountry christmas station playing an station listen live,chris pratt files divorce from anna faris^sharon osbourne apologizes to justin bieber 'i was wrong to 'attack you^celebrities react trump withdraws steph curry white house invitation^celebrity reaction jimmy kimmel monologue on las vegas shooting and guns^jimmy kimmel talks donald trump harvey weinstein on 'gma^katie couric said matt lauer pinched her on the ass on 'today back in^celebrities react to hurricane irma^katie holmes not pregnant and planning wedding with jamie foxx^sorry drake amp bella hadid are not 'secretly dating^celebrity reactions prince harry meghan markle engaged^watch kim kardashian first interview since robbery on 'ellen degeneres show videos^robert pattinson amp katy perry are not dating^beyonce birth twins still hospital 'minor issue^is demi lovato upset about meghan trainor performing the 'smurfs movie song^fans react u2 cancels st. louis concert amid police protests^jimmy fallon felt need to share 'heartfelt message about charlottesville^no zayn is not 'desperate to defend girlfriend gigi hadid^taylor swift teases new song 'gorgeous on instagram listen to a snippet^taylor swift teases new song 'gorgeous on instagram listen to a snippet^justin timberlake announces 'the man of the woods tour see the dates^watch harry styles kiss james corden in christmas themed 'carpool karaoke^'storm chasers star joel taylor dead at^camila cabello announces her 'never be the same tour see the dates^gigi hadid slams body shamers for calling her 'too skinny at nyfw^chris pratt files divorce from anna faris,17,8,-9,25,0.68,-0.36,1
23215660,KISS1075,2013,7296,152,44412,0,0,20,5,des moines hit music station with,celebrities react nelsan ellis dead at^ed sheeran break friendship code taylor swift despite ridiculous report katy perry^beyonce not demanding silent delivery room despite report^rap star a ap rocky feels little jealous kendall jenner romance blake griffin^chris soules had no alcohol in system after crash negative for drugs^justin bieber one pursued selena gomez vice versa ...^ryan lochte charge dropped in rio robbery case^kim kardashian slams cocaine claim 'i do not play with rumors like this^watch kim kardashian first interview since robbery on 'ellen degeneres show videos^nope justin bieber is not dating hailee steinfeld^justin bieber dating hailee steinfeld photo^hailee steinfeld responds to justin bieber dating rumors^beyonce birth twins still hospital 'minor issue^justin bieber not attend vanity fair oscars party ...^chris brown urges fans to donate to year old boy 'new legs gofundme^avril lavigne 'mildly amused by death conspiracy^selena gomez reveals kidney transplant summer amp friend actress francia raisa donated ...^selena gomez reveals she had a kidney transplant^chris soules 'devastated after killing kenny mosher in fatal accident^mariah carey not dating both nick cannon and bryan tanaka despite report^harry styles announces intimate world tour see the dates^alex rodriguez year old daughter sings for jennifer lopez photos^justin timberlake announces dates 'man woods tour^jamie lynn spears pregnant second child the singer actress shared news sweet ig post^taylorswift announces new album reputation,20,5,-15,25,0.8,-0.6,1
16442457,BonnieFuller,2370,23105,775,60617,0,0,21,4,mom president editor-in-chief,prince harry amp meghan markle relationship timeline how they met to the engagement via^selena gomez amp taylor swift 'lonely girls club get gether taylor house cook play meredith cat amp talk bout life^super congrats meghan markle amp prince harry happy news eecting first baby sp^katie holmes loves that bf jamie foxx is like a father to suri makes her laugh via^paige thomas i was terrified singing britney spears breakup song via^showing natural beauty minimal makeup to bring look together selena^selena gomez amp the weeknd reportedly split following hangouts with justin bieber via oh selena^justin bieber/ selena gomez split wow really getting serious she wo n't take calls only young woman world wont^protectmueller major amp loud protest going nyc if thought could try amp shutter mu^selena gomez wants to reconcile with mom but her relationship with justin is not up for debate^kim kardashian urging kanye west not to drop blac chyna diss track after she sues rob amp family via^is the weeknd dissing selena gomez with this stranger things tweet see shady message via^bella hadid is she worried about being a rebound romance for the weeknd via^angelina jolie rethinking brad pitt divorce misses seeing him every day via^sharon amp amp ozzy osbourne split after years of marriage amidst cheating reports via^sofia richie purposely transforming into kourtney kardashian for scott disick it a huge turn on^taylor swift slams kim kardashian for posting secretly recorded convo with kanye west via^christina aguilera joining american idol abc hoping to steal her from the voice via^trump renaming black history month after years of celebration report via^brad pitt amp amp angelina jolie meet prince george amp amp bring gift for princess charlotte details^kourtney kardashian amp amp scott disick back together amp amp the kids are so happy sweet pic via^miss nebraska wins miss usa things to know about sarah rose summers via^taylor swift teases intense new song gorgeous coming for kanye listen via^freeform nights of halloween is finally here full schedule via^roger ailes dead former fox news ceo dies at via,21,4,-17,25,0.84,-0.68,1
16116288,rolandsmartin,3601,530133,4919,457513,0,20,1,3,host rolandmartinunfiltered daily digital show senior analyst author international speaker ceo nu vision media,you trash joe want said family broken records across world o^i look forward next step conviction murder. watch rest botham jean family stat^mean like violent idiots ri^got female panel today six women newsonenow talking war on poverty years later tune^just found cincinnati tonight wish i could go hear i keynoting speech du^sorry live stream speech tonight come clearly the wifi bad duke energy convention center^am et newsone now we 'll bring highlights president trump address joint session congress^tune highlights trump/s address joint session congress right newsonenow^trump called education civil rights issue time address joint session congress am et newsonenow^am et newsone now we 'll bring highlights president trump address joint session congress ...^the legendary bishop arthur m. brazier pastor emeritus apostolic church god chicago died ...^landed chicago hours ago about host apostolic church god christmas special will air thanksgiving ...^at apostolic church god chicago state urban league address illinois gov pat quinn justy finished^except first black th president made supreme court pick hugh the and^that understood negotiate meet y fallen okey doke had^really glad see conservatives excited meeting north korea leader considering sav^the obama campaign flooding national black hispanic radio shows/networks ads ...^for n't know this interview president united states someone h^a comprehensive investigation voter impersonation finds credible incidents one billion ballots cast ...^the only way administration stop nonsense white house media unity if th^just landed miami nyc watch molly game flight jessica chastain and^i really n't give damn gossipy stories let get straight threatening b^house cards producers consider killing off frank underwood exclusive ...^'nypd blue creator steven bochco dead via,1,23,22,24,0.04166666666666666,0.9166666666666666,0
3108351,WSJ,1114,16918068,113179,287722,1,21,2,0,breaking news features,take ax code federal regulations writes^rudy giuliani says president sit interview special counsel sept. avoid midterm^elliott broidy latest hush payment ex playboy centerfold deal negotiated longtime trump lawyer fe^the nfl season kicks next week a new wsj/nbc news poll shows fan interest still four years ago an^democrats hold point edge question party control congress final wsj/nbc news poll b^in wsj/nbc news poll registered voters said would prefer democrats control congress pr^the democrats political advantage grown ahead midterm election new wsj/nbc news poll found^trump job approval held steady wsj/nbc news poll taken paul manafort conviction michael cohen^the democratic presidential candidates preparing debate new hampshire follow live blog demdebate^hillary clinton donald trump took sharply different approaches statements orlando mass shooting^watch live first presidential debate gets underway hofstra university^trump upset win coup tiny data firm helped campaign target ads using psychology^'there always irritants relationships secretary state pompeo said played trump refusal to^rudy giuliani trump lawyer called michael cohen 'pathological manipulator 'a liar fox news sunday^overconfidence upside believing manage corporation lead troops vital elemen^senator jeff flake remarks directed president trump monday appearance cincinnati questione^donald trump rst white house spokesman compares president rock star energizer bunny unicorn.^the u.s. department agriculture food drug administration jointly oversee meat grown animal^read full text president obama speech responsible homeownership^higher tariffs imported goods n't likely narrow u.s. trade deficit new york fed research warns^the u.s. trade deficit goods narrowed february may appears widened two months r^the u.s. trade deficit grew september driven part ramped capital consumer goods imports^north korea threatens missile strike guam hours trump warns fire fury^opinion denzel washington making sense writes,3,21,18,24,0.125,0.75,0
17334356,theknot,696,241047,3455,46992,0,0,3,21,at the knot believe one wedding tradition always make bring vision life the knot wedding planner app,the hills star brody jenner kaitlynn carter share first photo from their wedding^the hills brody jenner marries kaitlynn carter destination wedding^meghan markle prince harry wedding photographer took photos another royal couple^pretty little liars sasha pieterse marries hudson sheaffer ireland^dancing with stars pros val chmerkovskiy jenna johnson are engaged see his romantic proposal^outlander caitrionabalfe is engaged tony mcgill see her unusual engagement ring^lea michele is engaged boyfriend zandy reich see her carat ring^meghan markle will not have maid honor royal wedding good reason^vanderpump rules jax taylor brittany cartwright are engaged^2 broke girls star beth behrs celebrates her bridal shower with former co star kat dennings^anna wintour daughter bee shaffer engaged francesco carrozzini^queer eye tom jackson is engaged again ex wife abby see her engagement ring^queer eye tom jackson marries ex wife abby parr again smoky mountains^karlie kloss is engaged joshua kushner yes million times over^kaley cuoco marries karl cook see her multiple wedding weekend outfits^alicia vikander michael fassbender married get details super secret ibiza wedding^john david duggar is engaged abbie burnett after month long courtship see her ring^engaged peter palandjian see sweet proposal photo^american idol katharine mcphee david foster are engaged^nick jonas priyanka chopra road engagement inside their two month romance^meghan markle prince harry wedding cake details are revealed see pastry chef previous creations^what revenge co stars emily vancamp josh bowman engaged^prince william is prince harry best man the royal wedding^morning joe co hosts joe scarborough mika brzezinski engaged,3,21,18,24,0.125,0.75,0
16462068,wjxt4,768,171586,1149,235707,1,16,2,5,news4jax trusted source local news northeast florida southeast georgia,"breaking melania trump undergoes kidney surgery walter reed medical center eected remain hospitaliz^just in bill nelson gives statement regarding discrepancy ballots florida^thanksgiving food safety food handling errors inadequate cooking common issues lead poul^foodborne illness hits one six americans every year according us centers disease control prevent^update your salad safe u.s. centers disease control prevention reveals may caused e^chickens can wear costumes despite headlines centers disease control prevention said okay^cigarette use among american adults lowest since centers disease control prevention^polio like illness the us centers disease control prevention reported monday patients^an insurgent underdog vermont sen. bernie sanders laying groundwork launch bigger presidential^not earning as much what u.s. department education says salaries decade graduation^deciding fate superdelegates the democratic party debates much role delegates in^thanksgiving food safety food handling errors inadequate cooking common issues lead poul^chickens can wear costumes despite headlines centers disease control prevention said okay^cigarette use among american adults lowest since centers disease control prevention^polio like illness the us centers disease control prevention reported monday patients^ham recall johnston county hams recalling ,000 pounds ready eat ham products due possible^publix recall publix supermarkets recalling ground beef products chuck may e. coli the^still the apprentice to me snl comedian leslie jones says america trump ... joking t^prince harry meghan markle wed may^movie star jerry lewis dies age^aly raisman sues us olympic committee usa gymnastics^after years kermit frog getting new voice^she 's back taylor swift announces new album 'reputation^sports serena williams withdraws australian open",3,21,18,24,0.125,0.75,0
20269833,TribLIVE,180,73366,1351,171650,2,18,1,3,covers pittsburgh western pennsylvania news sports politics entertainment facebook,police ohio say one two people found dead mobile home park reporter worked for^police ohio say one two people found dead mobile home park reporter worked cleveland com^u.s. crude oil natural gas production grew despite decline number wells according u.s^in annual forecast u.s. energy information administration predicted last month home heating oil costs^six pennsylvanians got sick eating eggs contaminated salmonella according centers disease co^the centers disease control prevention reported record increase tickborne diseases^the centers disease control prevention said email one available comment unusual^new survey data centers disease control prevention show percent us eat kind f^i 'm looking trump said asked proposals impromptu interview fox news'^u.s. crude oil natural gas production grew despite decline number wells according u.s^in annual forecast u.s. energy information administration predicted last month home heating oil costs^men women republican national committee best avoid topic post helsinki summit angst^the centers disease control prevention reported record increase tickborne diseases^the centers disease control prevention said email one available comment unusual^new survey data centers disease control prevention show percent us eat kind f^the measure sent trump said january state union address patients terminal^u.s. crude oil natural gas production grew despite decline number wells according u.s^in annual forecast u.s. energy information administration predicted last month home heating oil costs^president trump received hurricane briefing white house category storm he told reporters face^four doctors one operations manager arrested alleged participation health care fraud schemes^when kate middleton emerged lindo wing st. mary hospital london world fascinated then^abby lee miller reality tv show dance moms sentenced year day federal prison reports^matt damon apologizes comments sexual misconduct^abc freeform air manchester benefit concert u.s. audiences,3,21,18,24,0.125,0.75,0
122834618,kiss1041fm,114,3871,58,30080,1,1,4,18,kiss atlanta r b follow us instagram facebook youtube,read transcript sen. jeff flake speech comparing pres donald trump josef stalin^read transcript sen. jeff flake speech comparing pres donald trump josef stalin^prince harry meghan markle a relationship timeline^international women day stars celebrate^katie couric breaks silence news matt lauer dismissal 'today^oprah 'intrigued idea running president friend gayle king says^enrique iglesias anna kournikova reportedly welcome twins^james franco denies allegations sexual misconduct^tamar braxton files divorce husband manager vincent herbert^meghan markle maid honor royal wedding^mtv movie amp tv awards complete winners list^'superman star margot kidder dead^portia de rossi says steven seagal unzipped pants audition^photos miss nebraska sarah rose summers crowned miss usa^meghan markle dad heart surgery wo n't attend royal wedding report says^justin timberlake announces new album 'man woods^justin theroux breaks social media silence jennifer aniston split^daytime emmy awards complete winners list^storm chasers star joel taylor dead^snap inc. stock falls kylie jenner tweet snapchat redesign^celine dion donates concert proceeds victims las vegas shooting^man inspired als ice bucket challenge dead^michael jackson musical coming broadway^ncis fan favorite pauley perrette leaving show seasons,5,19,14,24,0.20833333333333331,0.5833333333333334,0
15232635,KVUE,1085,207892,2379,210015,0,1,7,16,the best local news austin round rock central texas share pics using kvue,this week george stephanopoulos previously interrupted storm coverage airing kvue tune^julianna margulies recalls how george clooney shut down diva guest star 'er set exclusive^julianna margulies recalls how george clooney shut down diva guest star 'er set exclusive^reports brad pitt accused child abuse investigation^emmy awards the winners list^emmy awards the winners list^keith urban talks friendly competition nicole kidman taking kids work.^emma stone gets emotional about her close relationship with ryan gosling^koko gorilla knew sign language dies^koko gorilla knew sign language dies^ex 'dance moms star abby lee miller sentenced year prison^remove 'cosmopolitan magazine checkout lines amid metoo movement^scott baio wife renee reveals microvascular brain disease diagnosis^scott baio wife renee reveals microvascular brain disease diagnosis^chip joanna gaines welcome baby no see first pics^chip joanna gaines welcome baby no see first pics^ariana grande pete davidson make their relationship instagram official^bet awards the complete winners list^bet awards the complete winners list^meghan markle calls prince harry 'best husband ever during her first royal engagement without him^breaking former fox news ceo roger ailes dead^star vader dead age^leonardo dicaprio star quentin tarantino charles manson movie margot robbie^brooklyn decker andy roddick welcome baby no,7,17,10,24,0.2916666666666667,0.4166666666666667,0
3180209864,EOnlineAU,233,4498,38,5674,0,0,7,17,be pop cultured follow us red carpet fix celebrity news updates e shows love,pda alert blake shelton gwen stefani official^kourtney kardashian avoided awkward encounters weekend ex boyfriend younes bendjima scott disick^kourtney kardashian avoided awkward encounters weekend ex boyfriend younes bendjima scott disick^ryan gosling holds special place emma stone heart^it goes without saying wo n't easy khloe kardashian watch week kuwtk^kourtney kardashian avoided awkward encounters weekend ex boyfriend younes bendjima scott disick^kourtney kardashian avoided awkward encounters weekend ex boyfriend younes bendjima scott disick^adam levine jokes blake shelton three balls gwen stefani reaction priceless^woah 've removing gel nail polish wrong entire time^these celebs would definitely scored wimbledon stunning white outfits^these spring sandals 100 and cute gigi hadid^taylor swift come woods photographed first time four months nashville^ivanka trump feels blindsided viciousness politics ...^ellen degeneres reveals favorite fashion moment dress^meghan markle scored invite pippa middleton may th wedding^you ai n't ever friend like will smith talks play genie disney live action aladdin reboot.^tech accessory common^did prince harry really drive miles get meghan markle inside pippa middleton wedding reception^ellen degeneres reflects th anniversary public coming it really scary time.^stunned success reasons why i believed project long.^selena gomez new los angeles home totally affordable by hollywood standards least^jimmy kimmel returns work shares positive update newborn son health^playmates playboy models recreate iconic covers decades later^straya fav couple nicole kidman keith urban love ever here keep spark alive,7,17,10,24,0.2916666666666667,0.4166666666666667,0
15723995,TIMECulture,30,38176,948,15679,0,0,9,15,what good bad breaking music movies tv,john mayer hospitalized emergency appendectomy^comedian hannibal buress was arrested disorderly intoxication miami^i was angry. taylor swift what powered her sexual assault testimony^gwyneth paltrow says brad pitt threatened kill harvey weinstein over alleged sexual harassment^here how katy perry responded taylor swift superfan american idol^why hoda kotb is revolutionary pick replace matt lauer^lindsay lohan i was racially profiled airport wearing headscarf^oprah is intrigued idea running president best friend gayle king says^here how katy perry responded taylor swift superfan american idol^james franco denies sexual misconduct allegations interview with stephen colbert^ed sheeran is engaged girlfriend cherry seaborn^jeopardy host alex trebek is recovering from surgery remove blood clots his brain^country music star tim mcgraw collapses onstage during performance ireland^i pray he is peace. chef eric ripert speaks out after finding best friend anthony bourdain dead^stranger things season everything we know so far^nasa says astronauts will see star wars the last jedi space^blac chyna was just granted temporary restraining order against rob kardashian^jimmy fallon makes emotional return tonight show after his mother death^everything we know about return twin peaks^gossip girl star ed westwick denies raping actor kristina cohen^nina simone bon jovi are among rock roll hall fame inductees^richard simmons hospitalized severe indigestion^ben affleck jennifer garner officially file divorce^morning joe co hosts joe scarborough mika brzezinski are engaged,9,15,6,24,0.375,0.25,0
2798221806,hot933hits,2562,7553,245,36453,0,0,10,14,hot mornings :30a-10a a-1p p-3p p-7p hot nights p-12a requests -787-1933,west texts with jenner gt^maddiepoppe wins season american idol gt^does picture confirm back together^did already get married^canceled honeymoon find gt^almost released upbeat album before his split with^katy perry throwing shade taylor swift american idol^woah kanye west rumored judge american idol^get ready eat opening restaurant^katy perry throwing shade taylor swift american idol^teases new details about her reputation tour gt^breaks his silence on engagement to gt^found guilty of sexual assault in retrial gt^ex up about their break up and her engagement gt^prince harry meghan markle official wedding portraits revealed^bachelor paradise season cast revealed^brand new release fall line listen now^clarkson perform together first time open amas this sunday /7^ariana grande open billboard music awards^taylor swift latest surprise has amber rose wiz khalifa son freaking out^will smith just won in my feelings challenge and even drake agrees^are set to headline coachella gt^lands no spot maxim hot list gt^kevin hart takes his cheating scandal j. cole new music video,10,14,4,24,0.4166666666666667,0.16666666666666666,0
21053475,People_Parents,1327,227511,604,19027,0,0,11,13,celebrating hollywood newest parents little stars,pregnant khlo kardashian shuts down baby name rumors that 'so cute but 'not my list^mom who suffered same morning sickness princess kate shares her survival tips it miserable^dad george clooney getting ready welcome twins amal excited nervous^why kylie jenner is 'very protective stormi how her baby is bonding cousin chicago^new year eve baby jessica alba cash warren welcome son hayes alba see his adorable first photo^rob kardashian blac chyna reach custody agreement over baby dream^kylie jenner 'misses parts her old life is ready for things return 'normal source^pregnant says she misses sister she nests cleveland^it boy see official royal baby announcement outside buckingham palace^jennifer lopez alex rodriguez celebrate christmas miami their families^pregnant kylie jenner 'looked great family christmas eve party source says^teen mom jenelle evans admits she used drugs while pregnant daughter ensley^surprise bachelor paradise carly waddell evan bass are eecting their first child together^aaron paul says his baby girl is due 'any minute now 'i 'm over moon excited^serena williams will return competitive tennis months after giving birth daughter^new mom kylie jenner makes second post pregnancy outing celebrate her friend baby shower^john stamos fianc e caitlin mchugh debuts baby bump instagram while wearing sports bra^rob kardashian blac chyna reach custody agreement over baby dream^enrique iglesias says 'i love my babies he talks about his twins first time^bachelor paradise carly waddell evan bass reveal baby girl name^chris stapleton wife morgane eecting twins 2 more way^naya rivera ex ryan dorsey celebrates christmas his 'main man son josey^justin timberlake wants have 'as many kids he can wife jessica biel^josh charles wife sophie flack are eecting baby no,11,13,2,24,0.4583333333333333,0.08333333333333333,0
180306960,htshowbiz,616,172976,495,86853,0,0,16,8,entertainment news gossip tips lifestyle one-stop shop everything make day lighter fresher,are georgeclooney wife amal headed 300 million rs crore divorce^upset sees former gf hailey baldwin^miley cyrus liam hemsworth call wedding decide kids^he got gun left terrified man jumps stage concert^after split selena gomez the weeknd spotted kissing ex girlfriend bella hadid cannes^i enjoy single says angelinajolie bradpitt divorce moving ahead^angelina jolie takes kids hike amid brad pitt custody battle see pics^emma stone says imagine life without la la land co star ryan gosling^angelina jolie takes kids hike amid brad pitt custody battle see pics^daniel craig rachel weisz welcome baby girl^angelina jolie takes kids hike amid brad pitt custody battle see pics^brad pitt spends father day london kids amid custody battle angelina jolie^will meghan markle attend priyanka chopra nick jonas wedding she excited says report^justin theroux opens heartbreaking divorce jennifer aniston^here furious nicole kidman^selenagomez opts mental health treatment emotional breakdown^he humiliated demeaned dustin hoffman accused sexual misconduct third woman^i dare call racism jada pinkett smith rants twitter girls trip ignored golden globes^whiplash actor teller arrested allegedly drunk public^starwars thelastjedi director rian johnson reveals the last jedi^eddie redmayne wife hannah bagshawe eecting second child together^merylstreep joins reesewitherspoon nicolekidman tribe fierce women big little lies season^stephen colbert jokes emily blunt might sociopath show^call it what you want releases new song reputation,16,8,-8,24,0.6666666666666666,-0.3333333333333333,1
18942418,1075theriver,3016,41363,385,126169,0,0,18,6,live life love music an station,ed sheeran did not 'break friendship code with taylor swift^beyonce not demanding silent delivery room despite report^selena gomez vogue cover story see interview highlights^justin bieber one pursued selena gomez vice versa ...^lady gaga taylor kinney not secretly dating despite late and wrong report^proof already married coming ay w celebrity stuff.^hailee steinfeld responds to justin bieber dating rumors^totally called bully^beyonce birth twins still hospital 'minor issue^is demi lovato upset about meghan trainor performing the 'smurfs movie song^is early start getting ready holidays nope hooking tickets to^get holiday shopping done early tickets coming next listen li^justin bieber did not attend vanity fair oscars after party^are mariah carey amp joe jonas feuding^kanye west is not rebooting 'american idol^is early start getting ready holidays nope hooking tickets to^get holiday shopping done early tickets coming next listen li^mariah carey not dating both nick cannon and bryan tanaka despite report^from woman recreating celebrity instagram posts ...^harry styles announces intimate world tour see the dates^beyonc made surprise appearance present colin kaepernick sports illustrated muhammad ali legacy awar^alex rodriguez year old daughter sings for jennifer lopez photos^the bachelor ben higgins and lauren bushnell break up^april giraffe pregnant again work productivity die spring,18,6,-12,24,0.75,-0.5,1
71585918,KissChattanooga,1822,38457,291,46972,0,0,20,4,new music station heard ww app supporter beliebers swifties directioners bts army ot7,amber rose i did not laugh at molestation victim^report kim kardashian is having 'divorce docs drawn up is 'miserable with kanye west^sharon osbourne apologizes to justin bieber 'i was wrong to 'attack you^ed sheeran did not 'break friendship code with taylor swift^are selena gomez amp the weeknd working on a movie together^my wig is gone *books ticket see vegas* vmas^selena gomez vogue cover story see interview highlights^celebrities react to hurricane irma^chris brown slammed by judge for skipping karrueche tran court hearing^no drake is n't 'lusting after rihanna despite new rumors^lady gaga taylor kinney not secretly dating despite late and wrong report^hailee steinfeld responds to justin bieber dating rumors^nope justin bieber is not dating hailee steinfeld^robert pattinson amp katy perry are not dating^is demi lovato upset about meghan trainor performing the 'smurfs movie song^justin bieber did not attend vanity fair oscars after party^joe jonas sophie turner 'already thinking of having kids is made up story^flo rida not performing at donald trump inauguration despite report^icymi complete list grammy winners^no zayn is not 'desperate to defend girlfriend gigi hadid^harry styles announces intimate world tour see the dates^taylor swift teases new song 'gorgeous on instagram listen to a snippet^taylor swift teases new song 'gorgeous on instagram listen to a snippet^justin timberlake announces february release new album 'man woods,20,4,-16,24,0.8333333333333334,-0.6666666666666666,1
7745002,intouchweekly,1263,235487,570,41991,0,0,23,1,providing fun informative coverage celebrity news fashion beauty relationships lifestyle,it jenniferaniston justintheroux went wrong^exclusive kimkardashian miserable marriage kanyewest get details gt^angelinajolie crushing another oscar winner bradpitt any guesses^kristenstewart throws major shade ex robertpattinson newest interview gt^click see jessica simpson best baby bump fashion^kateupton slams kardashians getting plastic surgery gt^baby news jenniferaniston justintheroux gt^congrats jenniferaniston pregnant miracle baby age see baby bump gt^kimkardashian super annoyed irritated close family member ...^exclusive channing tatum jenna dewan divorce is getting ugly^revenge see st pic miranda lambert new beau take blake shelton^oh no mileycyrus liamhemsworth reportedly cancelled honeymoon gt^oh no mileycyrus liamhemsworth reportedly call honeymoon gt^exclusive angelinajolie snubs bradpitt get details gt^other women angelinajolie finally breaks silence bradpitt gt^find kimkardashian ready divorce kanyewest gt^kim kardashian latest move proves jealous really kylie jenner gt^scott disick shocking confession getting back together kourtney kardashian gt^kendall jenner breaks tears opening father transition^katie holmes joshua jackson say dawson creek reunion see pair turned james van der beek^justin theroux finally breaks his silence on 'heartbreaking jennifer aniston divorce^remember beckywiththegoodhair see biggest celebrity scandals gt^'alaskan bush people is back and somehow more popular than 'keeping up with the kardashians'^jenelle evans claims mtv wo n't let her quit 'teen mom even though she wants take other offers,23,1,-22,24,0.9583333333333334,-0.9166666666666666,1
18028893,JesseRodriguez,9120,31170,948,23672,0,22,1,0,director booking e-mail jesse.rodriguez.com,our joe interview today new broadway show^nyt in october interview fox amp friends mr. trump said i tell matt whitaker great guy i mea^a statement president different kind celebration white house tomorrow as^start week joe gov chris christie amp fmr gov mike huckabee join us tomorrow show^coming joe fmr gov mike huckabee carly fiorina gov chris christie sen lindsey graham amp^tomorrow joe elise jordan nyc mayor bill de blasio fmr gov mike huckabee gov john kasich amp^in am joe huckabee challenge growing national campaign grass roots^next joe fmr gov mike huckabee^tomorrow joe fmr ar gov mike huckabee^on joe huckabee sounds money politics^wednesday joe donald trump gov chris christie mike huckabee sen lindsey graham amp^tomorrow joe fmr gov mike huckabee iapolitics^fmr gov mike huckabee joe we war islam^white house vice president biden deliver statement rose garden :10pmet live^nbc news president trump european commission president jean claude juncker making joint statement in^our joe interview today syria^an iconic moment joe exclusive interview monday morning trum^our joe interview overnight developments syria syriastrikes^so many details interview indictment r^here full interview daily^white house press secretary robert gibbs daily briefing live right msnbc^an iconic moment joe exclusive interview monday morning trum^here list major winners emmy awards,1,22,21,23,0.043478260869565216,0.9130434782608696,0
32871086,kylegriffin1,890,622189,7216,53174,2,18,1,2,senior producer msnbc opinions mine do congratulate,nine states history racial discrimination aggressively removing registered voters rol^federal prosecutors charge nyc subway bomb suspect say wrote facebook trump failed protect you^in light sarah sanders new statement regarding jim acosta video trump praising greg gianforte fo^here full transcript stormy daniels interview minutes^putin gave annual foreign policy speech thursday used hail end us dominated world '^michael moore calls governor rick snyder arrested powerful interview still time tune msnbc flint^rudy giuliani interview buzzfeed news says last talked trump couple weeks ago^despite saying eected decision july whether trump would sit interview mue^two sources tell nyt trump displeased rudy giuliani conducted first interview^kathleen clark eert legal ethics said rudy giuliani interview abc reminded garden hose th^some trump advisers tell wapo fear rudy giuliani may waived right assert conversatio^conspiracy theorist jerome corsi becoming key figure mueller builds case abc news reports corsi met w^just letter chaffetz cummings oge wh counsel conway statements appear violate federal ethic^never forget michael cohen also deputy finance chair republican national committee^crew suing epa refusal release inventory items referenced scott pruitt financial di^richard burr russia conducted coordinated cyberattack state election systems hacked critical infras^whca statement all americans recoil president praise violent assault reporter doing^in three politically important midwest states michigan wisconsin minnesota trump job approval rating is^the white house held press briefing since monday there press briefing since monday afternoon^aclu it un american unlawful president eel reporter white house briefing room for^omarosa alleges new memoir trump frequently used n word host 'celebrity apprent^beyonc made surprise appearance present colin kaepernick sports illustrated muhammad ali legacy award^mila kunis makes monthly donations planned parenthood mike pence name pence office gets thank lett,3,20,17,23,0.13043478260869565,0.7391304347826086,0
17498747,AsburyParkPress,1312,148791,1108,149581,0,13,4,6,the asbury park press cover monmouth ocean counties jersey shore,americans eat romaine lettuce amid concerns new e. coli outbreak centers disease con^watch drug deaths u.s. fallen first time opioid epidemic according provisional^the centers disease control prevention investigating mysterious polio like disorder ris^a survey centers disease control prevention suggests nearly percent americans eat fast food^fox news host chris wallace went president donald trump attacks news media interview tha^newsbreaks healthcare listening session president trump impending blizzard^fox news host chris wallace went president donald trump attacks news media interview tha^nj high school cross country meet all shore teams^nj girls soccer meet all shore team^americans eat romaine lettuce amid concerns new e. coli outbreak centers disease con^the centers disease control prevention investigating mysterious polio like disorder ris^a survey centers disease control prevention suggests nearly percent americans eat fast food^hillary clinton scheduled appear jersey city monday evening closed door fundraiser sen. bob me^reports brad pitt accused child abuse investigation^katie couric breaking silence former today show co host matt lauer month firing^bruce springsteen e street band a new york city serenade producer intrigue via^watch billy bush confirms trump 'access hollywood tape^million tune april giraffe finally gives birth^the best memorial day sales home appliances^watch north dakota cara mund crowned miss america^here popular halloween candy every state^most popular candy halloween trick treating year here state state ranking^watch among rock roll hall fame inductees,4,19,15,23,0.17391304347826084,0.6521739130434783,0
17387823,WLTX,3282,119382,1125,415806,0,2,5,16,news wltx on your side breaking news weather sports columbia sc retweets endorsement,republican voters gather watch first presidential debate| news19 scnews sctweets^live vice president joe biden making statement rose garden white house^emmy awards the winners list^channing tatum jenna dewan announce separation^prince harry meghan markle apologize delayed royal wedding 'thank you cards^prince harry meghan markle apologize delayed royal wedding 'thank you cards^prince harry meghan markle apologize delayed royal wedding 'thank you cards^koko gorilla knew sign language dies^ex 'dance moms star abby lee miller sentenced year prison^walmart remove 'cosmopolitan magazine checkout lines amid me too movement^walmart remove 'cosmopolitan checkout lines says 'business decision^the best memorial day sales home appliances^veep actress julia louis dreyfus diagnosed breast cancer^best july th sales july4th thofjuly independenceday^'nypd blue creator steven bochco dead^lady gaga announces las vegas residency dates^lady gaga announces las vegas residency dates^cardi b confirms she secretly married offset september before they were 'engaged^wwe star vader dead age^wwe star vader dead age^look leaving 'ncis seasons actress pauley perrette news19^april giraffe pregnant^april giraffe pregnant,5,18,13,23,0.21739130434782608,0.5652173913043478,0
228866701,TheLiveFeed,433,13465,390,40177,1,0,6,16,read feed breaking news tv team,'the daily show michelle wolf lands her own netflix late night show exclusive^'the bachelorette engaged rachel lindsay reveals her winner historic season finale^'live duo kelly ripa ryan seacrest inspire abc scripted comedy 'work wife^'live duo kelly ripa ryan seacrest inspire abc scripted comedy 'work wife^'live duo kelly ripa ryan seacrest inspire abc scripted comedy 'work wife^'live duo kelly ripa ryan seacrest inspire abc scripted comedy 'work wife^julie bowen says 'modern family has n't killed any characters yet^'walking dead promotes pair series regular season exclusive^'fear walking dead promotes colman domingo series regular season^'walking dead promotes trio series regular season^'walking dead promotes series regular season exclusive^'walking dead promotes three series regular season^'walking dead promotes trio series regular season^pink nick jonas fall out boy read mean tweets 'jimmy kimmel live^katy perry jennifer lopez join james corden 'carpool karaoke primetime special^'star trek discovery renewed season cbs all access^jennifer lawrence drinks rum with stephen colbert calls harvey weinstein horrible ass boil^'outlander renewed seasons starz^fuller house renewed for season by netflix^james corden parodies 'a quiet place 'the late late show^'rent set fox next live musical^'13 reasons why officially renewed season netflix^kelly clarkson host billboard music awards,7,16,9,23,0.3043478260869565,0.39130434782608703,0
211620426,dailydot,17582,173387,3593,253448,0,1,9,13,bringing best worst internet since tweets staff send us tips tips.com,sarah huckabee sanders goes defense trump following sexist morning joe tweets^did lindsay lohan convert islam^did lindsay lohan convert islam^meghan markle nephew made special strain royal wedding weed^meghan markle nephew made special strain royal wedding weed^meghan markle nephew made special strain royal wedding weed^meghan markle nephew made special strain royal wedding weed^meghan markle nephew made special strain royal wedding weed^did lindsay lohan convert islam^did lindsay lohan convert islam^'stranger things officially renewed season^'stranger things officially renewed season^'stranger things officially renewed season^'star wars director rian johnson finally reveals last jedi really^justin timberlake announces new album man woods^justin timberlake announces new album man woods^justin timberlake announces new album man woods^lcd soundsystem gavin russom comes transgender^lcd soundsystem gavin russom comes transgender^taylor swift announces new album reputation^jonathan cheban changing legal name foodgod^jonathan cheban changing legal name foodgod^jonathan cheban changing legal name foodgod,9,14,5,23,0.39130434782608703,0.21739130434782608,0
104650279,kost1035fm,1382,17979,187,47833,0,0,9,14,nan,comedian leslie jones made it to the olympics ... again^john mayer has been hospitalized emergency appendectomy^american music awards nominations amas nominees full list^jennifer garner ben affleck file for divorce amid false reconciliation rumors^celebrities react to hurricane irma^kim kardashian sued for allegedly stealing lighting technique for selfies^beyonce birth twins still hospital 'minor issue^justin bieber fan arrested trespassing at singer beverly hills home^fans react u2 cancels st. louis concert amid police protests^'dance moms abby lee miller sentenced to one year in prison^taylor swift teases new song 'gorgeous on instagram listen to a snippet^did you know ralphie from 'a christmas story also starred in 'elf^the complete list of winners from the sag awards^rachel mcadams is reportedly pregnant with her first child^alex rodriguez year old daughter sings for jennifer lopez^taylor swift teases new song 'gorgeous on instagram listen to a snippet^the narwhal frappuccino is here it tastes like pink starburst^watch harry styles kiss james corden in christmas themed 'carpool karaoke^wendy williams reveals graves disease diagnosis^taylor swift announces new album 'reputation see the cover art^grey anatomy spin off is coming to abc^star wars the last jedi is dedicated to 'our princess carrie fisher^selena gomez honored as billboard woman of the year,9,14,5,23,0.39130434782608703,0.21739130434782608,0
14780915,RollingStone,322,6293896,38694,116936,1,1,10,11,the latest news rolling stone magazine got tip share,he called wimp he overcompensated people went jail died matt taibbi brief history george h.w.^see president trump praise kanye west genius interview 'fox friends^john mayer hospitalized emergency appendectomy forcing dead company postpone concert^best movies tv stream september maniac quincy jones documenary sean penn space^from transcendent ones sucked see ranked list superbowl halftime shows^all apologies times justin bieber said sorry^all apologies times justin bieber said sorry^ed sheeran weighs taylor swift katy perry feud^ed sheeran weighs taylor swift katy perry feud^hear mariah carey blame producers new year eve gaffe they foiled^kanye west returned social media post video rant decrying mind control publishing rights^inside avril lavigne death hoax wo n't die^neil diamond retires touring parkinson disease diagnosis^tim mcgraw collapses onstage ireland country country festival concert^ariana grande first person named honorary citizen manchester following terror attack^claire danes says 'homeland end season^ashley judd sues harvey weinstein sexual harassment defamation it time mr. weinstein held accou^watch christina aguilera jimmy fallon busk disguise nyc subway fallontonight^see christina aguilera jimmy fallon busk disguise nyc subway fallontonight^watch jessica chastain show jimmy fallon like female role hollywood fallontonight^jennifer hudson join thevoice coach season^lcd soundsystem gavin russom comes transgender^see ariana grande roots jimmy fallon perform no tears left cry nintendo labo instruments,11,12,1,23,0.4782608695652174,0.043478260869565216,0
256596567,ComplexPop,2044,406167,1237,69050,0,0,11,12,never watching,blac chyna attempt trademark angela renee kardashian shut^chris pratt files divorce anna faris^get raunchy steven klein racy bondage themed photo shoot^kim kardashian rumored pursuing real music career^matt lauer officially replaced hoda kotb 'today^peep reported details angelina jolie brad pitt temporary divorce agreement^peep reported details angelina jolie brad pitt temporary divorce agreement^lord scott disick tells everyone getting back together kourtney kardashian trolling nah^california teenager gets turned prom shows kylie jenner instead^peep reported details angelina jolie brad pitt temporary divorce agreement^peep reported details angelina jolie brad pitt temporary divorce agreement^'stranger things officially renewed season^jada pinkett smith calls golden globes following tiffany haddish snub^'house cards producers thinking killing kevin spacey frank underwood^a joker harley quinn spinoff movie works via^kylie jenner gives birth child first travis scott^jennifer lawrence says drunk masculine alter ego named gail^'game thrones stars rose leslie kit harington married^fergie josh duhamel announce split years marriage^gwyneth paltrow denies becky good hair amber rose suggests^home holidays plans binge watch hell shows^'game thrones final season premieres first half hbo boss reveals^chris pratt files divorce anna faris,11,12,1,23,0.4782608695652174,0.043478260869565216,0
226061405,bollywood_life,598,639507,374,106296,0,0,12,11,know trending bollywood catch latest celebrity news gossips movie reviews much,chris pratt files divorce anna faris separation^george clooney wife amal alamuddin heading 300 million divorce^jennifer aniston justin theroux split twitterati ca n't stop thinking get back together brad^miley cyrus liam hemsworth call wedding due fights topic 'children^ellen degeneres portia de rossi get counselling save marriage^video justin bieber hailey baldwin steamy make session gets us questioning justin really ove^halloween angelina jolie misses brad pitt feels lonely spooky holiday^critics choice awards full winners list the shape water darkest hour three billboards bag top ho^ellen degeneres portia de rossi get counselling save marriage^angelina jolie brad pitt call custody battle six children^george amal clooney hire baby bouncers less one week old daughter ella son alexander^brad pitt 'devastated shock tragic death close friend chris cornell^second suspect arrested rapper xxxtentacion murder^ed sheeran gets engaged girlfriend cherry seaborn announces social media^kelly clarkson when i really skinny i wanted kill^vanessa hudgens joins season so you think you can dance judge^second suspect arrested rapper xxxtentacion murder^x men actress ellen page marries long time girlfriend emma portner view pics^ariana grande new break anthem 'thank u next speaks pete davidson mac miller watch video^prince harry meghan markle royal wedding live updates prince charles walk bride aisle instead of^beyonce bags major trophies bet awards check complete winners list^carrie fisher autopsy report reveals cocaine heroin methadone ecstasy system^chris pratt files divorce anna faris separation,12,11,-1,23,0.5217391304347826,-0.043478260869565216,1
6038642,Canoe,2159,8748,510,166099,0,0,13,10,news sports entertainment lifestyle travel tech one canada largest general interest websites,jennifer aniston denies brad pitt houlder cry justin theroux split^calls claim insulted muslim woman concert 'fake media story^nicole kidman trump 'we country need support whoever president^is feud throwing shade katyperry says 'loves 'as songwriter'^hoda kotb replace matt lauer 'today^meghan markle prince harry 'practically living together report^angelina jolie brad pitt part bizarre plot capture warlord joseph kony report^meghan markle considered bond girl role royal engagement report^khloe kardashian tristan thompson cheating scandal plays kuwtk^are darren aronofsky suki waterhouse dating^jennifer lawrence swears sex terrified getting sti^selena gomez reveals kidney transplant^is feud throwing shade katyperry says 'loves 'as songwriter'^surprise enrique iglesias anna kournikova welcome twins^amy schumer hospitalized horrible kidney infection^michael fassbender alicia vikander reportedly married^'storm chasers star joel taylor dead^7th heaven star jeremy london arrested alleged domestic violence^the weinstein company file bankruptcy^jersey shores mike 'the situation sorrentino pleads guilty tax fraud case^actress anika noni rose reveals sexually assaulted plane^actress anika noni rose reveals sexually assaulted plane^pauley perrette leaving ncis seasons,13,10,-3,23,0.5652173913043478,-0.13043478260869565,1
5695632,BuzzFeed,2894,6577535,23883,233365,0,2,14,7,check new store score sign newsletter,here are the victims of the chicago hospital shooting^obama is right mccain was wrong john mccain responds words obama debate charges wa ...^reese witherspoon refused to reveal what happens in legally blonde but i think we all know the truth^so blac chyna wo n't able use name angela kardashian^rupaul throws some serious shade at kristen stewart and robert pattinson^liam hemsworth scared miley cyrus and her reaction is basically all of us^liam hemsworth scared miley cyrus and her reaction is basically all of us^there a tennis player who looks like liam hemsworth and i need to talk about it^sarah jessica parker hinted ellen still might sex city^john krasinski travelled miles every weekend to see emily blunt and their kids when they were separated for fi^john krasinski talking about emily blunt and their daughters will make your heart melt^britney spears terrified man rushed onto stage vegas show^people trolling ivanka trump why i disagree with my dad cover story us weekly^kim kardashian left a very tmi comment on kanye west instagram and people are losing it^kylie jenner got turned pic bill nye the science guy i 'm screaming^jennifer lawrence says still terrified nude photo hack^the live action beauty and the beast coming netflix september mark calendars^here the most popular halloween candy in your state^prince charles walk meghan markle aisle royal wedding^aly raisman sues the us olympic committee and usa gymnastics over nassar abuse^here freeform official nights of halloween schedule for everyone who loves october^here the complete nights of halloween freeform schedule and spoiler it spooky and amazing^priyanka chopra and nick jonas are officially engaged and have the roka ceremony pics to prove it,14,9,-5,23,0.6086956521739131,-0.21739130434782608,1
16608381,TheWindsorStar,15497,134285,617,124790,0,1,17,5,the voice southwestern ontario since,cathy cooke linda qin want improve learning schools low test scores cooke also believes schools sho^actress leslie jones called fans give comedians pass insensitive old jokes insisting job^wendell pierce advised former onscreen daughter meghan markle call pressure ever got m^wendell pierce advised former onscreen daughter meghan markle call pressure ever got m^hailey baldwin shot reports justin bieber already married.the stars sparked rumours suggesting^hailey baldwin shot reports justin bieber already married.the stars sparked rumours suggesting^wendell pierce advised former onscreen daughter meghan markle call pressure ever got m^wendell pierce advised former onscreen daughter meghan markle call pressure ever got m^jennifer garner particularly happy estranged husband ben affleck dating playboy model splitt^want know cozy a star born bradley cooper lady gaga selfie toronto intern^kanye west back twitter choosing reactivate account series bizarre videos including m^rachel weisz daniel craig proud parents baby girl.the year old actress james bond star^rachel weisz daniel craig proud parents baby girl.the year old actress james bond star^the spice girls reunion cancelled according reports.the famous female group teasing hotly a^the spice girls reunion cancelled according reports.the famous female group teasing hotly a^jennifer aniston insisted heartbroken following split husband justin theroux.the form^kourtney done keeping kardashians as feud sisters kim khloe grows nastier tha^kourtney done keeping kardashians as feud sisters kim khloe grows nastier tha^breaking don rickles legendary comedian actor dies^breaking don rickles legendary comedian actor dies^swedish dj avicii found dead^prince harry brings girlfriend meghan markle pippa middleton wedding reception^relive meghan markle prince harry big day the best royal wedding photos,17,6,-11,23,0.7391304347826086,-0.4782608695652174,1
19136331,J14Magazine,1929,265707,1504,60759,0,0,19,4,u.s. teen entertainment magazine follow us snapchat instagram subscribe youtube channel,robert pattinson ex girlfriend shares first photo baby^justin bieber reportedly extremely proud selena gomez putting mental health first gt gt^it seems like kristen stewart threw more shade twilight twihards^the real reason might go see concert^the real reason justin bieber wo n't happy selena gomez^liam payne putting debut album hold could split cheryl cole blame gt gt^we 've finally got gossip one way selena gomez would take justin bieber back^hailey baldwin justin bieber reportedly married already 're shook gt gt^hold fans convinced justin bieber amp hailey baldwin married already gt gt^tfw see pic kendall jenner ... baby bump^oh no miley cyrus liam hemsworth reportedly cancelled honeymoon^hailee steinfeld opened up about justin bieber dating rumors^kristen stewart opened chose come gay saturday night live gt^tfw see pic kendall jenner ... baby bump^did liam payne diss one direction side zayn malik^get pretty friendly really fast set new movie^did secretly get engaged lovatics^omg did get engaged^are jake gyllenhaal dating get scoop^jennifer lawrence split boyfriend darren aronofsky dishing plans get farm goat^nick jonas priyanka chopra reportedly engaged dating two months get details gt gt^cue wedding bells nick jonas finally confirmed priyanka chopra engaged gt gt^everything know far '13 reasons why season spoilers,19,4,-15,23,0.8260869565217391,-0.6521739130434783,1
23613479,KrisJenner,256,10486250,11139,12479,0,1,22,0,mom manager momager lover of life lover of christ,do n't miss episode 'objectified sunday p et fox news channel^obsessed new kkwbody fragrances live now^rt vote us thank guys therealityshow keepingupwiththekardashians pcas^vote khlo kim therealitytvstar^rt vote keeping up with the kardashians win pcas therealitytv show^rt vote us thank guys therealityshow keepingupwiththekardashians pcas^vote khlo kim therealitytvstar^rt vote keeping up with the kardashians win pcas therealitytv show^you also submit vote tweeting choicerealitytvshow keeping up kardashians kuwtk rt^keeping up kardashians nominated award vote us thank you^tonight new keeping up kardashians /8c e^turn e east coast brand new keeping up kardashians starts right kuwtk^new keeping up kardashians starts east coast kuwtk rt watching^have beautiful sunday and forget brand new episode keeping up kardashians airs tonight /^rt vote keeping up with the kardashians win pcas therealitytv show^you also submit vote tweeting choicerealitytvshow keeping up kardashians kuwtk rt^keeping up kardashians nominated award vote us thank you^tonight new keeping up kardashians /8c e^turn e east coast brand new keeping up kardashians starts right kuwtk^new keeping up kardashians starts east coast kuwtk rt watching^have beautiful sunday and forget brand new episode keeping up kardashians airs tonight /^rt vote keeping up with the kardashians win pcas therealitytv show^rt we mins away live red carpet e tune east coast we go live hours grammy,22,1,-21,23,0.9565217391304348,-0.9130434782608696,1
3625561817,ShutterstockNow,706,3847,66,6799,0,0,22,1,the photos may missed ... need see,meghan duchess sussex princeharry attend nelson mandela centenary launch southbank centre londo^princeharry meghan duchess sussex argentine polo player nacho figueras arrive sentebale isps handa^meghan duchess sussex watches princeharry participates sentebale isps handa polo cup^catherine duchess cambridge meghan duchess sussex royal box semi final match no^meghan duchess sussex princeharry attend nelson mandela centenary launch southbank centre londo^meghan duchess sussex attends wellchild awards london l tim rookef shutterstock meghanmarkle^princeharry meghan duchess sussex argentine polo player nacho figueras arrive sentebale isps handa^meghan duchess sussex watches princeharry participates sentebale isps handa polo cup^catherine duchess cambridge meghan duchess sussex royal box semi final match no^a photo made catherine duchess cambridge shows daughter princesscharlotte kissing brother^welcome prince louis arthur charles prince william catherine duchess cambridge reveal name thi^the royalbaby sleeps leaves hospital parents catherine duchess cambridge prince william|^catherine duchess cambridge prince william leaving hospital newborn baby boy royalbaby^prince william catherine duchess cambridge royal box men final wimbledon^catherine duchess cambridge meghan duchess sussex royal box semi final match no^a photo made catherine duchess cambridge shows daughter princesscharlotte kissing brother^welcome prince louis arthur charles prince william catherine duchess cambridge reveal name thi^the royalbaby sleeps leaves hospital parents catherine duchess cambridge prince william|^catherine duchess cambridge prince william leaving hospital newborn baby boy royalbaby^prince william catherine duchess cambridge royal box men final wimbledon^catherine duchess cambridge meghan duchess sussex royal box semi final match no^judges derek hough jennifer lopez jenna dewan tatum ne yo^miss district columbia usa kara mccullough reacts crowned new miss usa photo ap/shutterstock,22,1,-21,23,0.9565217391304348,-0.9130434782608696,1
14692385,Militarydotcom,741,193541,2636,37104,1,21,0,0,the official twitter follow breaking military news videos exclusive military content,retired gen. shelton george h.w bush nearly died skydiving accident^pentagon slashes gi bill transfer eligibility window^moh recipient saved tiger sawed off shotgun^israel evacuates white helmets face syrian advance^trump talks up air force one design 'top line^veterans association aims remember uss liberty^us army reverses course discharging immigrant recruit mavni^new hbo documentary profiles uso favorite robin williams^trump corrects his quote says misspoke russian meddling^blue angels fat albert flies again after yearlong grounding^icymi trump supporting tiny nato ally montenegro could start wwiii^pentagon slashes gi bill transfer eligibility window^commissary recalls its bottled water^legend ted williams marine pilot recounted pbs show^post /11 gi bill transferability update questions answered^trump award medal honor marine hue city heroism^trump supporting tiny nato ally montenegro could start wwiii^how john wayne got rid kgb agents hired kill him^boeing pitches 'f x fighter concept us air force report^reasons why marines hate air force^defense bill would curb cabinet control nuclear agency^army chief us military can afford lose future arms race,1,21,20,22,0.045454545454545456,0.9090909090909092,0
288277167,atrupar,999,157605,2111,63576,0,21,1,0,journalist,opening statement pompeo you come group senators filled serious dou^trump tries pack record number exaggerations one statement now best economy the^marco rubio fox news interview he n't face single question cohen tape^during interview fox news mitt romney downplays trump tweets significant i 'll speak matters^completely misrepresents ig report interview fox news the evidence pointing to^george w bush subtweeted trump isolationist foreign policy speech^during interview trump lawyer rudy giuliani says comfortable michael cohen coo^asked russian meddling meet press says campaign noticed suspicious accounts flocking^trump speech vfw convention kansas city begin minute follow video thread^attacked hillary clinton last week still talking brings hillary clinton wi^during interview focused civility criticized hillary clin^president trump attorney begins interview lying russia investigation^devoted interview slathering praise eric charity work bashing anyone^attacking pocan wants abolish ice n't personally^on west virginia u.s. senate candidate big message loves trump lov^the seal trump criticized admiral mcraven released statement saying i back hillary clinton anyone els^bolton cnn interview concludes refusing condemn white house aide tasteless joke john mccain^cnn put together video gorsuch roberts carefully crafted comments roe vs. wade respectiv^lolol trump says still believes mexico pay border wall currently asking congress 18 bi^the white house first press briefing since july begin minute follow video thread^the first white house news briefing week starting moment follow video thread^trump jimmy fallon the guy screws hair he disappointed find real could n't believe i,1,21,20,22,0.045454545454545456,0.9090909090909092,0
15458694,HuffPostPol,8851,1425895,16908,301141,0,18,2,2,the latest political news huffpost politics team need help huffpost login membership tweet,u.s. senate appointee michael bennet launches campaign site says intends win election co ...^a report u.s. energy information administration projected tuesday would see lowest u.s. coal c^sarah palin cpac speech might well next dr. seuss book^a report u.s. energy information administration projected tuesday would see lowest u.s. coal c^ads we never saw in interview time sen. john mccain advertising guru fred davis detai.. huffne ...^iraq refugees statistics un high commission refugees rjeskow^latest stf post holding those at the top accountable today column paul krugman forgive a.. dcjohnson^president trump delivers remarks national federation independent business^i n't know matt whitaker trump told reporters friday but kellyanne conway told fox news su^sweet blog barack obama john mccain third final presidential debate what questions would.. lynnsweet^the obama campaign wooing hispanic voters feel good tv radio ads^the obama campaign wooing hispanic voters feel good tv radio ads^political news cq transcript robert gibbs first daily briefing white house press secretary cqpolitics^rudy giuliani baffled fox news hosts attempted clarify comments made cnn earlier day about^a report u.s. energy information administration projected tuesday would see lowest u.s. coal c^nyt the early word troopergate friday an alaska state legislature inquiry whether sara.. huffnewswire^white house press secretary sarah huckabee sanders gives daily press briefing president trump says wor^president trump delivers remarks national electrical contractors association convention philadelphia pen^what words pentagon papers government still classifying via^gayle king says oprah intrigued idea running president^everything need know prince harry meghan markle engagement^everything need know prince harry meghan markle engagement,2,20,18,22,0.09090909090909093,0.8181818181818182,0
7309052,YahooNews,2371,1107299,14440,201767,1,9,1,11,top stories trusted sources your window news matters download app,'trump failed protect nation nyc bombing suspect wrote facebook akayed ullah faces federal char^rudy giuliani trump wo n't interview mueller get spygate report^bernie sanders campaign adviser dnc new rules we came devastating presidential loss in^trump campaign data analytics firm says popular ad^trump says top us intelligence officials loved summit performance helsinki director national intelligen^watch live vice president joe biden delivers statement rose garden^gop sen. dean heller republican senator running another term state hillary clinton^at white house wednesday cnn jim acosta pressed president comments caravans it n^at today white house press briefing sarah sanders accused press 'trying tear down'^us department agriculture agency told avoid using term climate change^simon cowell returning american idol^frightened rabbit frontman scott hutchison found dead^miss district columbia kara mccullough year old chemist crowned miss usa^miss district columbia kara mccullough year old chemist crowned miss usa^queen elizabeth ii visits victims manchester arena attack hospital^joel taylor star discovery channel 'storm chasers dead^andrew garfield i gay man right without physical act^miss missouri sophia dominguez heithoff crowned miss teen usa^miss missouri sophia dominguez heithoff crowned miss teen usa^richard simmons hospitalized california battling severe indigestion^the weinstein company file bankruptcy^andrea constand speaks judge declares mistrial bill cosby sexual assault case,2,20,18,22,0.09090909090909093,0.8181818181818182,0
11856032,NBCPolitics,235,509364,6654,58169,1,20,1,0,political news journalists across,full statement attorney general jeff sessions recusal investigation russian contacts tru^after florida secretary state orders recount begin ron desantis releases video statement saying stil^in latest statement white house press sec sanders says stand statement revocation journa^clinton lead over trump shrinks points new nbc news/wsj poll decision2016^president trump blasted retired adm. bill mcraven navy seal led raid killed osama bin laden^rudy giuliani tells special counsel mueller rejected trump team offer president answer w^just in the republican national committee officially selected charlotte north carolina host r^new poll trump approval rating remains steady tumultuous week poll finds^new democrats hold point advantage heading midterm elections poll finds^new democrats hold point advantage heading election day according new poll^two thirds latinos favor democratic control congress according new // poll^in tweet rep. tulsi gabbard slams president trump saudi arabia bitch president statement^in tweet rep. tulsi gabbard slams president trump saudi arabia bitch president statement^live president trump delivers remarks national federation independent business th anniversary celebration^live president trump holds campaign rally las vegas^as close special report today listen john mccain words reflecting life prepa^live white house press briefing^live white house press briefing^impeachment talk becomes cynical game^in us saudi trade goods services worth 45b top erts us including aircraft^in us saudi trade goods services worth 45b top erts us including aircraft^kim kardashian west visits white house discuss clemency reform,2,20,18,22,0.09090909090909093,0.8181818181818182,0
9544952,fox43,1095,82851,654,155036,1,15,1,5,central pennsylvania best reports local news york harrisburg lancaster lebanon,"with house representatives vote tuesday congress passed legislation could give terminally ill patients a^suicide rates increased across united states nearly two decades ending according resear^there cases possible confirmed acute flaccid myelitis united states year according^the us centers disease control prevention escalated response polio like illness struc^homicides suicides involving guns increasing according new data us centers disease c^acute flaccid myelitis affects person nervous system specifically spinal cord according centers fo^the us centers disease control prevention said thursday people gotten sick multistat^the state first probable human case west nile virus year found allegheny county pennsylvania^there cases possible confirmed acute flaccid myelitis united states year according^the us centers disease control prevention escalated response polio like illness struc^homicides suicides involving guns increasing according new data us centers disease c^acute flaccid myelitis affects person nervous system specifically spinal cord according centers fo^the state first probable human case west nile virus year found allegheny county pennsylvania^these victims chicago mercy hospital shooting^jennie o turkey store sales recalling approximately ,388 pounds raw ground turkey products may asso^with thanksgiving around corner us department agriculture food safety inspection service has^prince harry meghan markle wed may kensington palace announced today^comedian jerry lewis dies sunday morning age^'happy days star erin moran played joanie cunningham dead^nicholas duffy fudge star wicked tuna dead^kylie jenner happy snapchat new redesign snap stock closed thursday reality t^it official april giraffe pregnant",2,20,18,22,0.09090909090909093,0.8181818181818182,0
273428948,971theriver,77,2416,36,44882,1,1,4,16,atlanta classic hits station,read transcript sen. jeff flake speech comparing pres donald trump josef stalin^read transcript sen. jeff flake speech comparing pres donald trump josef stalin^prince harry meghan markle a relationship timeline^international women day stars celebrate^katie couric breaks silence news matt lauer dismissal 'today^oprah 'intrigued idea running president friend gayle king says^enrique iglesias anna kournikova reportedly welcome twins^james franco denies allegations sexual misconduct^tamar braxton files divorce husband manager vincent herbert^meghan markle maid honor royal wedding^mtv movie amp tv awards complete winners list^'superman star margot kidder dead^portia de rossi says steven seagal unzipped pants audition^photos miss nebraska sarah rose summers crowned miss usa^meghan markle dad heart surgery wo n't attend royal wedding report says^justin timberlake announces new album 'man woods^justin theroux breaks social media silence jennifer aniston split^daytime emmy awards complete winners list^storm chasers star joel taylor dead^snap inc. stock falls kylie jenner tweet snapchat redesign^man inspired als ice bucket challenge dead^michael jackson musical coming broadway,5,17,12,22,0.2272727272727273,0.5454545454545454,0
14787713,FOX29philly,6340,603315,2363,302523,0,9,6,7,we go get latest philadelphia news sports weather,time to toss if thanksgiving leftovers refrigerator time go according the^philly mayor nutter to speak at democratic national convention the democratic national convention committee ...^democratic national convention committee says everything track summer convention philly dncc^time to toss if thanksgiving leftovers refrigerator time go according the^breaking white house says vice president joe biden make statement rose garden afternoon^happening now the white house holds press briefing president trump denied russia still targeting u.^mayor nutter deliver remarks church west philadelphia sunday a.m. regarding impact ...^mayor nutter deliver remarks church west philadelphia sunday a.m. regarding impact mob attacks community^mcnabb career done with latest remarks former philadelphia eagles star donovan mcnabb back news ...^david cassidy fighting memory loss wants 'enjoy life^david cassidy fighting memory loss wants 'enjoy life^so cute an adorable princess charlotte almost stole show royal wedding saturday here he^so cute an adorable princess charlotte almost stole show royal wedding saturday here he^selena gomez eeking treatment 'tackle emotional issues head^selena gomez eeking treatment 'tackle emotional issues head^harry potter river cruise set sail summer cost serious cash^harry potter river cruise set sail summer cost serious cash^harry potter river cruise set sail summer cost serious cash^actor vince vaughn arrested suspicion dui resisting arrest manhattan beach checkpoint^bon jovi among rock roll hall fame inductees^bon jovi among rock roll hall fame inductees^confirmed april giraffe pregnant,6,16,10,22,0.2727272727272727,0.4545454545454545,0
1877831,nytimesworld,918,1954997,20015,246540,3,15,4,0,world news the new york times follow journalists,"inside fake news sausage factory this income^inside fake news sausage factory this income^inside fake news sausage factory this income^the dutch parliament upper house approved partial ban face coverings public areas spokesman s^barack obama announces supporting emmanuel macron video posted candidate twitter feed.^the canadian firm placed digital ads vote leave brexit campaign groups set discussion^the canadian firm placed digital ads vote leave brexit campaign groups set discussion^the canadian firm placed digital ads vote leave brexit campaign groups set discussion^the canadian firm placed digital ads vote leave brexit campaign groups set discussion^the canadian firm placed digital ads vote leave brexit campaign groups set discussion^read full transcript barack obama speech south africa defended international institutions^read full transcript barack obama speech south africa defended international institutions^military leaders seek ,000 more troops afghanistan^a humanitarian catastrophe looms yemen coalition led saudi arabia united arab emirates began a^your morning briefing australia edition what need know start day get email^a plane crash mumbai thursday killed four people board least one ground^the last time canada strong patriotic surge s. one sign the ontario government slapped fore^the last time canada strong patriotic surge s. one sign the ontario government slapped fore^martin luther king jr. cited wedding prince harry meghan markle the week good news^five months prince harry meghan markle wedding another royal got married windsor but time br^five months prince harry meghan markle wedding another royal got married windsor but time br^five months prince harry meghan markle wedding another royal princess eugenie got married windsor",7,15,8,22,0.3181818181818182,0.3636363636363637,0
14749520,kcranews,663,228586,1665,245208,0,2,7,13,northern california breaking news weather sports,"most popular baby names every u.s. state^us slaps 50 billion tariffs chinese goods escalating trade dispute^what roseanne barr net worth^icymi megyn kelly weighs matt lauer fired 'today show^megyn kelly weighs matt lauer fired 'today show^david cassidy fighting memory loss wants 'enjoy life^george clooney makes 27,283 every hour thanks tequila^mariah carey new year eve performance 'they foiled^caitlyn jenner latest celebrity float run office^koko gorilla knew sign language dies^james franco event canceled actor denies allegations sexual misconduct^playboy founder hugh hefner cause death revealed^icymi playboy founder hugh hefner cause death revealed^mindy kaling reportedly pregnant first child^icymi 'clueless actress stacey dash running congress california^'clueless actress stacey dash running congress california^kaley cuoco marries karl cook intimate horse ranch wedding^discovery channel 'storm chasers star joel taylor dead^billboard music awards check complete list winners^everything need know 'this is us season^billboard music awards check complete list winners^reese witherspoon confirms 'legally blonde happening",7,15,8,22,0.3181818181818182,0.3636363636363637,0
19380829,Yahoo,7936,1452605,9049,99207,0,2,8,12,yahoo official twitter sharing best network for email help,these popular baby names every state^these popular baby names state^'i was angry taylor swift what powered her sexual assault testimony^alec baldwin n't done playing donald trump yet snl^famous women waxing shaving important^not everyone thrilled taylor swift got political instagram 'be quiet sing^margot robbie confirms marriage tom ackerley ... flip finger via^selena gomez reveals kidney transplant summer via^'utterly tasteless people freaking victoria david beckham kids shooting water guns british^selena gomez leaves treatment center 'emotional breakdown reports^here popular halloween candy state^here popular halloween candy state^hugh hefner cause death revealed^monday morning email everything you need to know about prince harry and meghan markle engagement^does photo prove amelia earhart survived final flight^kirsten dunst gives birth welcomes first child fiance jesse plemons^george amal clooney donate 1 million fight hate groups^surprise ariana grande pete davidson reportedly engaged dating weeks^are ready teamjhud jennifer hudson joins thevoice coach season^bradley cooper irina shayk welcome first child^bradley cooper irina shayk welcome first child^taylor swift announces new album reputation november,8,14,6,22,0.3636363636363637,0.2727272727272727,0
27677483,Essence,13639,374142,2966,121533,0,2,8,12,the official twitter page essence follow,endorsed candidacy got backing higher heights america pac rosa pac emily^cnn fired marc lamont hill made comments people alleged anti israel hill later defended word^a comprehensive timeline prince harry meghan markle relationship^oprah stedman graham began love ever since 've one cutest couples hollywo^comedian hannibal buress arrested disorderly intoxication miami^festival fashion favorite madeinamerica looks sure find home pinterest^did former 'rhoa star confirm jamie foxx katie holmes dating^hoda kotb right choice replace matt lauer need discuss pay^she ciara welcome baby girl sienna princess wilson^oprah winfrey famous feuds^beyonc turned role 'beauty and the beast part n't big enough^new couple alert jesse williams dating sports reporter taylor rooks^jada pinkett smith calls women every race 'queens beautiful thank video^tamar braxton reportedly files divorce husband vincent herbert^mel b files divorce stephen belafonte nearly years marriage^nelly criminal investigation england sexual assault^star jones ex husband al reynolds comes bisexual^believe heard stacey dash running congress california^stacey dash actually running congress california^star jones engaged boyfriend ricardo lugo^star jones engaged boyfriend ricardo lugo^ray j princess love welcome baby girl,8,14,6,22,0.3636363636363637,0.2727272727272727,0
227347152,TVLine,93,151276,2497,75098,0,0,8,14,all tv no interference,americanidol finale poll who will win season and who should win^americanidol finale who will win season and who should win cast your vote^idolfinale recap did right singer win season americanidol^dim lights the top americanidol singers season revealed^americanidol finale who will win season and who *should* win^items willandgrace adds thecrown casts new prince charles jerseyshore sneak peek and^shannen doherty defends charmed reboot 'i would implore everybody be little bit kinder cw series^mariah carey taking 'break wake new year show 'they foiled me^this just in modernfamily renewed two seasons abc^it true jason bateman has officially signed on arresteddevelopment season^americasgottalent winner neal boyd dead^bachelorinparadise season cast revealed which 'favorites are returning^americanhorrorstory season title revealed ahscult^outlander renewed seasons *and* plus see first season photos find out when it 'll return^fullerhouse renewed season^icymi ... fullerhouse renewed season^jennifer hudson joins thevoice coach season^icymi ... theoriginals end after season^theoriginals end after season^first teaser ryan murphy slasher comedy looks bloody fun screamqueens^americanhorrorstory joins season cast yes really ahs^americanhorrorstory lena dunham joins season cast,8,14,6,22,0.3636363636363637,0.2727272727272727,0
837981504,AllThingsWSB,4840,11877,228,57814,1,2,8,11,your connection atlanta events abc primetime best city served fresh snap wsb-tv,read transcript sen. jeff flake speech comparing pres donald trump josef stalin^read transcript sen. jeff flake speech comparing pres donald trump josef stalin^how awful john dead so going take john daughter daddy daughter dance knowing tha^comedian leslie jones *not* happy eerience atlanta restaurant ...^prince harry meghan markle a relationship timeline^prince harry meghan markle a relationship timeline^international women day stars celebrate^katie couric breaks silence news matt lauer dismissal 'today^celebrities react death linkin park singer chester bennington^richard simmons sues radaronline national enquirer protect privacy^kourtney kardashian scott disick back together^james franco denies allegations sexual misconduct^portia de rossi says steven seagal unzipped pants audition^clay adler former mtv reality star dead^clay adler former mtv reality star dead^justin theroux breaks social media silence jennifer aniston split^storm chasers star joel taylor dead^labor day deals sales macy walmart best buy^bradley cooper irina shayk welcome first child reports say^celine dion donates concert proceeds victims las vegas shooting^man inspired als ice bucket challenge dead^ncis fan favorite pauley perrette leaving show seasons,9,13,4,22,0.4090909090909091,0.18181818181818185,0
78714922,IBTimes,53,123944,1901,175954,1,2,12,7,real-time news intelligence analysis forces reshaping global national economies,snapchat shutting location faking apps^attack watch reasons obama gatekeeping web site is pointless president barack obama campaign tea ...^one four sides iconic gold pyramid house severely damaged fire^do n't worry ben affleck n't suffer brain damage^do n't worry ben affleck n't suffer brain damage^do n't worry ben affleck n't suffer brain damage^miley cyrus liam hemsworth breakup rumors swirl singer cancels bora bora honeymoon^are katie holmes jamie foxx dating^details angelinajolie bradpitt parenting style following divorce news^there may already trouble paradise meghan markle prince harry^there may already trouble paradise meghan markle prince harry^details angelinajolie bradpitt parenting style following divorce news^jennifer aniston lot say divorce brad pitt will say things justin theroux^this prince charles showed support meghan markle prince harry royal wedding^is meghan markle lonely frustrated royal life^meghan markle may engaged prince harry n't mean celebrating valentine day solo^meghan markle may engaged prince harry n't mean celebrating valentine day solo^meghan markle may engaged prince harry n't mean celebrating valentine day solo^ryan seacrest kelly ripa new permanent co host live with kelly^ryan seacrest kelly ripa new permanent co host live with kelly^netflix officially renewed stranger things season here everything want see new season^here everything know americanhorrorstory season far,13,9,-4,22,0.5909090909090909,-0.18181818181818185,1
21669960,1061BLI,6530,86605,533,204846,0,0,16,6,long island for all the hits,it jennifer aniston justin theroux i blame us we never really gave good celebrity mash^it jennifer aniston justin theroux how long bradpitt sends u late night text^would watch judge says yes extremely^it official confirms new song on bli^meghan markle looking absolutely fabulous glowing announcing happy baby news toured australia^amp wedding liam got cold feet^trouble mailbu amp the couple called wedding find^is true liam hemsworth are n't calling wedding^sad hear called wedding full story^after got engaged quickly hoping gets married fast n't ha^amp argument dumbest thing ever 've ... buthttp //^i n't even know going anymore reportedly already married i can^makes gorgeous bridesmaid i wonder caught bouquet cc^amp argument dumbest thing ever 've ... buthttp //^rumor alert might pregnant baby do think true^we heard take dog work today chrispratt stepped game^parents thoughts tombrady criticized kissing year old son lips^soooo miss nebraska aka sarah rose summers crowned miss usa weekend and kiiiind love with^i want baby shower like lit^bradley cooper irina shayk welcome first child reports say^snapchat salty kyliejenner tweet nothing fall she tweeted feb 've ha^really ready pop actually.. contracting speak amp go,16,6,-10,22,0.7272727272727273,-0.4545454545454545,1
2269134614,937thebeat,1894,34916,175,62487,0,0,16,6,houston hiphop ig fb snapchat thebeathouston listen live thebeat iheartradio,karrueche tran granted five year restraining order against chris brown^celebrities react nelsan ellis dead at^beyonce not demanding silent delivery room despite report^chris brown slammed by judge for skipping karrueche tran court hearing^kim kardashian slams cocaine claim 'i do not play with rumors like this^halle berry not pregnant at despite reports^watch kim kardashian first interview since robbery on 'ellen degeneres show videos^watch kim kardashian first interview since robbery on 'ellen degeneres show videos^beyonce birth twins still hospital 'minor issue^karrueche tran granted five year restraining order against chris brown^mary j. blige hacked did not write kendu isaacs hate tweet^oprah not running for president says gayle king^grammy awards see the full winners list^grammy awards see the full winners list^a bentley belonging blac chyna repossessed week despite claims circulating online^mariah carey not dating both nick cannon and bryan tanaka despite report^beyonc made surprise appearance present colin kaepernick sports illustrated muhammad ali legacy awar^alex rodriguez year old daughter sings for jennifer lopez photos^here the complete list of bet awards winners^billboard music awards nominations see full list of bbmas nominees^billboard music awards nominations see full list of bbmas nominees^are khloe kardashian tristan thompson ready get harry meghan walk aisle,16,6,-10,22,0.7272727272727273,-0.4545454545454545,1
18086050,DanaCortez,905,23042,205,112294,0,3,19,0,we syndicated morning drive i get talk first highly imperfect hardworking chicana sharing story help women danacortezshow,rt on way cbs tape interview face nation bob schieffer^most popular baby names state did name make click link bio audio^rt rt watch john king interview former presidents george w. bush bill clinton today a.m et^says retired shoulder dress last year *ha^kanyewest kimkardashian dining calabasas word couple marriage counseling^currently looking kelly ripa danacortezshow live abc headquarters ny^brad pitt channels bob marley amp dishes family daily dirt w/dana cortez ddwdc best gossip^brad pitt states publicly legalize drugs daily dirt w/dana cortez ddwdc best gossip^brad pitt says amp angelina jolie marry soon daily dirt w/dana cortez ddwdc best gossip^brad pitt opens family amp wedding angelina jolie daily dirt w/dana cortez ddwdc best gossip^brad pitt signs contract world war z pt ii daily dirt w/dana cortez ddwdc best gossip^brad pitt/angelina jolie marrying tomorrow daily dirt with dana cortez ddwdc best gossip^brad pitt marrying angelina jolie amp favorite role dad daily dirt w/dana cortez ddwdc best gossip^matt damon reveals gq mag brad pitt called bastard daily dirt w/dana cortez ddwdc best gossip^brad pitt says 'll marry angelina jolie soon daily dirt w/dana cortez ddwdc best gossip^brad pitt amp angelina jolie got married christmas day daily dirt w/dana cortez ddwdc best gossip^brad pitt states publicly make drugs legal daily dirt w/dana cortez ddwdc best gossip^matt damon reveals brad pitt called bastard daily dirt w/dana cortez ddwdc best gossip^brad pitt set return world war z pt ii daily dirt w/dana cortez ddwdc best gossip^brad pitt/angelina jolie marrying saturday daily dirt with dana cortez ddwdc best gossip^kimkardashian throwin shade sis kyliejenner are siblings sometimes jealous^kyliejenner misses selena i need shirt danacortezshow ddwdc,19,3,-16,22,0.8636363636363636,-0.7272727272727273,1
16510838,sugarscape,523,425682,1176,161256,0,0,20,2,nan,kim kardashian defends kylie jenner lip fillers admission 'she n't lie^kim kardashian defends kylie jenner lip fillers admission 'she n't lie^taylor swift tom hiddleston 'desperate make relationship red carpet official^katy perry madonna team raunchy s amp m inspired v magazine shoot pics^justin bieber selena gomez spotted actual date sacre bleu confirm 're back^justin bieber selena gomez spotted actual date sacre bleu confirm 're back^lady gaga taylor kinney split five years together^taylor swift admits 'jealous people relationships oh shuddup snogged harry styles^ridiculous story day taylor swift hoping invite zerrie wedding make harry styles jealous^abercrombie trouble poking fun taylor swift serial dater reputation errr eect call^no big deal kendall jenner showing nipple piercing tiny little baby bump^no big deal kendall jenner showing nipple piercing tiny little baby bump^miley cyrus 'cancels honeymoon bora bora liam hemsworth we 'll go instead^kristen stewart uspicious robert pattinson new girlfriend fka twigs^no big deal kendall jenner showing nipple piercing tiny little baby bump^no big deal kendall jenner showing nipple piercing tiny little baby bump^kourtney kardashian feeling 'betrayed khloe refuses cut ties scott disick^kourtney kardashian says scott disick always family lt 3^liam neeson clare balding singing justin bieber serious voice amazing stuff^jennifer aniston selena gomez officially new fave bffs also 're jealous^it halloween weekend aka time watch hocus pocus repeat cast look like omg tha^one direction miley cyrus katy perry lead billboard music awards nominations see full list,20,2,-18,22,0.9090909090909092,-0.8181818181818182,1
811972460560019456,republic,3,696796,1264,203956,0,17,3,1,official handle republic media network digital tv media,hindupakistancomment when congress said modi becomes pm india become hindu pakistan how^congrafalelie the sort lies alliance parties congress congress spreading condemnable a^modiemergencyattack if taking statement subramanian swamy gospel truth case you^hindupakistancomment when congress said modi becomes pm india become hindu pakistan how^vvipassaultcoverup if father accused member ministry immediately eelled f^sacredgamesdebate if rahul gandhi statement 'sacred games controversy official stand p^mystery girl 'eid viral hug video comes forward says wrong intention here full statement^mobsforvotes why mob violence picking heels share views using hashtag join th^karnatakafloortest watch arnab elains circle insecurity the debate^rahulattackspmvideo is bizarre rahul gandhi politicised vajpayee hospitalisation bizarre that^shahiimam2019campaign watching the debate missed details shahi imam controversy get your^in brand new episode the realty+ show join debate land vs flat^italykesaudagar watch should yogi adityanath elain referring 'merchants italy share^tuticorinunrest videos violence emerge tuticorin responsible share views using th^chaiwalachallenge both sides brought debate public level sonia gandhi also faced lot abu^gauri lankesh murder case cops probe another murder plot link^live congress news briefing cwc meeting^a tanned justin theroux recently spotted hanging year old model erika cardenas^a tanned justin theroux recently spotted hanging year old model erika cardenas^american vocalist selena gomez seeks mental health treatment emotional breakdown read know^in pictures prince harry newly engaged fiancee meghan markle going different royal here,3,18,15,21,0.14285714285714285,0.7142857142857143,0
28123142,12NewsNow,2611,38887,448,120223,1,8,2,10,we local news leader southeast texas see news happening call us 409 -1212 email us news.com news eect more,"breaking president george hw bush died age^i self proclaimed sock man bush said email republican national committee the louder t^i self proclaimed sock man bush said email republican national committee the louder t^shooting chicago hospital leaves multiple victims^the right try measure let patients exhausted options access drugs early stages fda r^it one donald trump repeated campaign promises not would build wall along u.s. souther^the life senator john mccain words next daybreak^recall alert jennie o turkey store sales recalled ,388 pounds raw ground turkey products may linked^breaking no one killed aeromexico plane crash mexico there passengers four crew members boa^gma day starts today noon kbmt abc starting today two familiar faces michael strahan sara haines will^gma day starts today noon kbmt abc starting today two familiar faces michael strahan sara haines will^former dance moms abby lee miller sentenced one year day prison^'glee alum lea michele engaged boyfriend zandy reich shows huge ring social media^scott baio wife renee reveals microvascular brain disease diagnosis^scott baio wife renee reveals microvascular brain disease diagnosis^scott baio wife renee reveals microvascular brain disease diagnosis^bristol palin joins cast mtv teen mom og via^i added video playlist bristol palin joins cast mtv teen mom og^lady gaga announces las vegas residency dates^cardi b confirms secretly married offset september 'engaged^prince william prince harry best man royal wedding",3,18,15,21,0.14285714285714285,0.7142857142857143,0
27251427,1067WTLC,4476,8996,113,120081,0,0,4,17,indy r b listen amazon echo enable wtlc amazon alexa once enabled say alexa play wtlc '' tlcisindy,"kanye west amp kim kardashian have one embryo left^beyonce birth twins still in the hospital with minor issue^these pictures have people speculating about a rihanna pregnancy^kim kardashian arrives in nyc with massive security detail still terrified^how to get rid of scratches on your sunglasses in easy steps^kevin hart and wife eniko parrish eecting their first child together^why rachel lindsay was able to announce she engaged before the bachelorette even started^serena williams admits she accidentally announced her pregnancy news social media^drake makes history billboard music awards lets love his life nicki minaj steal show^khloe kardashian plans give birth her tristan thompson baby cleveland^tina turner firstborn son craig turner dead of an apparent suicide^tyrese gibson wife samantha are eecting a baby girl^halle berry goes buck naked for instagram^beyonc pregnancy style costs least 53,000 so far^kim kardashian west shares first photo of daughter chicago photos^rob amp big star christopher big black boykin dead at^will smith in talks to play the genie disney live action reboot of aladdin^eva longoria gives birth to a baby boy see the first picture^janet jackson is in good spirits as she prepares to resume tour as a single mom^john legend reveals he tried to break up with chrissy teigen years ago and she was not having it^serena williams withdraws from australian open i will need a little more time",4,17,13,21,0.19047619047619047,0.6190476190476191,0
3260518932,TwitterMoments,10,740377,4568,66422,1,1,4,15,the best happening twitter instant,the us house representatives intelligence committee unanimously voted declassify release democratic^conway huckabee sanders comeyfiring exchanges lit morning shows^could confirmation jamie foxx katie holmes dating^the first official photographs prince louis captured mother catherine duchess cambridge^the first official photographs prince louis captured mother catherine duchess cambridge^to relive moments incredibly difficult emotionally. shared thoughts^celebrity chef mario batali fired the chew following allegations sexual misconduct^matt damon fire controversial comments sexual misconduct hollywood^with engaged prince harry reporting spend christmas the^miles teller denies reports arrested drunk public san diego^a third suspect murder robert allen arrested central georgia^the dark tower first trailer drops mixed reactions^congrats reportedly pregnant first child^meghan markle confirms father attend royal wedding^after getting makeover tom jackson marrie^it official karlie kloss engaged boyfriend joshua kushner six years dating^mila kunis revealed makes monthly donations planned parenthood mike pence name^janelle mon e comes pansexual latest cover story says eeriences^prince harry audi sale online he seen driving pippa middleton wedding reception meghan m^nearly two weeks going missing actress arielle kebbel sister julia found safe sound^good morning here happening weinstein company file bankruptcy gun control debate continues,5,16,11,21,0.2380952380952381,0.5238095238095238,0
243163874,ComplexMusic,968,925774,4132,99644,0,0,6,15,never listening,get raunchy steven klein racy bondage themed photo shoot^joey fatone denies rumors *nsync reunion super bowl^katy perry appears give taylor swift backhanded compliment 'american idol^katy perry appears give taylor swift backhanded compliment 'american idol^katy perry appears give taylor swift backhanded compliment 'american idol^katy perry appears give taylor swift backhanded compliment 'american idol^katy perry announces release date tour new album 'witness^helped buy house pregnant homeless fan^third suspect arrested murder xxxtentacion^fourth suspect xxxtentacion murder case arrested^third suspect arrested murder xxxtentacion^justin timberlake announces man woods tour^justin timberlake announces release date new album 'man woods^kanye west writing philosophy book real time twitter^kanye west writing philosophy book real time twitter^kanye west writing philosophy book real time twitter^fergie josh duhamel announce split years marriage^gwyneth paltrow denies becky good hair amber rose suggests^gwyneth paltrow denies becky good hair amber rose suggests^gwyneth paltrow denies becky good hair amber rose suggests^beyonc eminem weeknd headline coachella,6,15,9,21,0.2857142857142857,0.42857142857142855,0
25067168,euronews,1093,356255,7560,130914,3,15,3,0,all views all voices all welcome we tweet languages choose you dm us contact newsroom,rawpolitics we care matter irish mep marian harken discusses european reaction us^nancy pelosi wednesday nominated fellow democrats speaker us house representatives pelo^breaking the us senate house representatives passed bill end brief government shutdown whi^rawpolitics she incredibly resolute political editor gives us analysis following theresa^rawpolitics throughout statement n't mention leadership challenge uk prime minister^watch uk home secretary sajid javid statement house commons amesbury poison incident.^space what risk asteroids done onasteroidday meet dinosaurs mete^space what risk asteroids done as asteroidday approaches meet din^space what risk asteroids done as asteroidday approaches meet din^state union parliament clashes rule law^for interview sen mccain ask qs viewers can please promote askmccain followers^french president emmanuel macron arrive washington later today three day state visit a^thecube a trump victory senate shows conservative policies ... support populati^thecube i hope also glimpse brighter future transatlantic friendship we spoke^gme what started extraordinary act bravery sparking fresh row immigration france.^state union parliament clashes rule law^'us stand saudis despite khashoggi murder says trump it could well crown prince k^one u.s. soldier killed four wounded somalia operation^just in italian media report actor george clooney hospitalised involved minor acci^euronewsnow britain getting welcome distraction brexit another royal baby way princ^fairy tale castle host prince harry meghan markle modern royal wedding,6,15,9,21,0.2857142857142857,0.42857142857142855,0
24432463,ActionNewsJax,763,107949,927,231541,1,1,5,14,action news jax cbs47/fox30 no source news northeast florida southeast georgia,read transcript sen. jeff flake speech comparing pres donald trump josef stalin^read transcript sen. jeff flake speech comparing pres donald trump josef stalin^prince harry meghan markle a relationship timeline^amal george clooney welcome twins^celebrities react death linkin park singer chester bennington^oprah 'intrigued idea running president friend gayle king says^richard simmons sues radaronline national enquirer protect privacy^enrique iglesias anna kournikova reportedly welcome twins^tamar braxton files divorce husband manager vincent herbert^'superman star margot kidder dead^meghan markle confirms dad attend royal wedding^meghan markle dad heart surgery wo n't attend royal wedding report says^clay adler former mtv reality star dead^justin timberlake announces new album 'man woods^labor day deals sales macy walmart best buy^bradley cooper irina shayk welcome first child reports say^celine dion donates concert proceeds victims las vegas shooting^man inspired als ice bucket challenge dead^michael jackson musical coming broadway^watch miley cyrus gives emotional performance 'malibu billboard music awards^kylie jenner pregnant according reports,6,15,9,21,0.2857142857142857,0.42857142857142855,0
27745484,CBS8,1745,148061,1831,88245,1,3,8,9,local san diego news coverage cbs news follow us,nancy pelosi fights regain house speaker role la auto show keystone xl things know wednesday^suicide drug overdose rates continued rise helping drive number u.s. deaths highest t^suicide drug overdose rates continued rise helping drive number u.s. deaths highest t^shooting chicago hospital leaves multiple victims^kendall jenner majorly shades scott disick over photo with sofia richie his kids^emily blunt dwayne johnson jack whitehall attempt each other accents while working out^everything jennifer garner has said about ben affleck since their split^everything jennifer garner has said about ben affleck since their split^everything jennifer garner has said about ben affleck since their split^meghan markle attends reception with prince harry after missing first event^meghan markle attends reception with prince harry after missing first event^meghan markle attends reception with prince harry after missing first event^'this is us star justin hartley marries chrishell stause^watch father goose attack unsuspecting police officer gt gt gt^miles teller reportedly arrested san diego drunk public^miles teller reportedly arrested san diego drunk public^watch luke skywalker returns millennium falcon new 'star wars the last jedi trailer.^britain prince harry meghan markle requesting understanding respect markle father cel^simone biles claims she was also sexually abused former usa doctor larry nassar^reasons why renewed season selena gomez shares teaser^it official april internet favorite pregnant giraffe pregnant,9,12,3,21,0.42857142857142855,0.14285714285714285,0
1652541,Reuters,1091,20744145,118986,441081,2,7,8,4,top breaking news pictures videos reuters,u.s. house representatives calls myanmar release journalists^nancy pelosi top democrat u.s. house representatives agrees term limits smoothing road ho^ethiopia prime minister calls multiparty democracy chief staff^george w. bush promoting memoir defends decisions president interview oprah^thursday morning briefing white house receives fbi report kavanaugh john bolton trump tough guy iran^wednesday morning briefing white house hit staff upheavals house democrat probe census citizenship que^cia says white house block director briefing senate^thursday morning briefing white house struggles contain summit outcry subscribe news^china says choice retaliate new u.s. trade tariffs risking trump may impose duties o^duchess cambridge kate middleton makes first official solo engagement since giving birth third child^kate middleton visits london wildlife garden first official solo engagement since giving birth thir^amal george clooney welcome boy girl twins^dakota johnson trained '50 shades shoot 'suspiria dances^see pictures prince louis taken catherine duchess cambridge^catherine duchess cambridge arrives windsor castle prince harry meghan royalwedding^see pictures prince louis taken catherine duchess cambridge^catherine duchess cambridge arrives windsor castle prince harry meghan royalwedding^former rep. anthony weiner wept court sentenced months prison sexting minor^meghan markle walk aisle without father royal wedding^the weinstein company file bankruptcy^road royal wedding prince harry best man older brother prince william see royalwedding co,10,11,1,21,0.4761904761904762,0.047619047619047616,0
1101997326,CindyLSchroeder,698,1255,51,43297,2,4,8,7,freelance writer former journalist enquirer media/community press wife mother animal lover bargain hunter opinions,melania trump undergoes kidney surgery walter reed medical center^things know november stocks zuckerberg e. coli saudis nancy pelosi cnn^trump exclusive interview suggests turning acosta camera reveals obama private guidance greatest t^in cincinnati speech vice president mike pence talks taxes trump omarosa via^fact check president donald trump speech greater cincinnati via^in cincinnati speech vice president mike pence praises ice tax cuts trump ohio via^prince harry meghan markle wed may cnn^jennifer aniston justin theroux split 'lovingly after two years marriage people^north korea vows strikes us trump warns 'fire fury^jennifer aniston justin theroux split 'lovingly after two years marriage people^katie couric opens up about matt lauer firing today show people^channing tatum jenna dewan tatum announce separation^jennifer aniston justin theroux split 'lovingly after two years marriage people^what covfefe trump tweet unites bewildered nation the new york times^meghan markle dad wo n't attend royal wedding after it was revealed he staged photos report people^mariah carey all i want christmas is you finally reaches billboard hot top after two decades e^ashley judd sues harvey weinstein sexual harassment defamation the hollywood reporter^tony awards full list winners the washington post^meghan markle dog mystery sparks social media frenzy e news^taylor swift announces new album 'reputation mtv news^pregnant april giraffe calf due march via,10,11,1,21,0.4761904761904762,0.047619047619047616,0
972651,mashable,2784,9816475,126954,354257,0,1,11,9,mashable superfans we casually curious obsess us,papa john founder former ceo john schnatter resigned chairman board^solange tweets serious shade grammys beyonc snub^gwen stefani blake shelton official cue tweets^these shapeshifting bots walk fold catch things^dining never shapeshifting plates^this shapeshifting furniture blow mind^no beyonc get lip injections rep calling 'cowards^chlo grace moretz shocked 'red shoes ...^chlo grace moretz shocked 'red shoes ...^donald trump impressed stephen colbert 'filthy jokes^kim kardashian donald trump talked prison reform rails^katie holmes joshua jackson looked very lovey dovey 'dawson creek reunion^ryan seacrest kelly ripa new 'live co host many jobs one guy^tessa thompson says attracted men women happy pride^tessa thompson says attracted men women happy pride^josh brolin joins 'deadpool sequel beefcake mutant cable^leonardo dicaprio reportedly star new quentin tarantino movie charles manson^leonardo dicaprio star new quentin tarantino movie charles manson^kylie jenner mkbhd question snapchat future post redesign^harry styles facetimes james corden announce week long 'late late show residency^april giraffe pregnant 're already tired,11,10,-1,21,0.5238095238095238,-0.047619047619047616,1
30857481,etimes,150,571130,762,122147,0,0,11,10,latest news videos photos reviews world bollywood regional tamil telugu malayalam kannada bengali bhojpuri marathi punjabi gujarati hollywood,chris pratt files divorce anna faris^says daughters impressed portrayal wonderwoman^i saddened disgusted false allegations circulated^it crazy dating rumours^dakotajohnson talks film 'suspiria^divorce court judge lynn toler wants bradpitt angelinajolie stop nasty divorce battle^divorce court judge lynn toler wants bradpitt angelinajolie stop nasty divorce battle^angelinajolie reps clarify proceedings ongoing custody battle bradpitt^divorce court judge lynn toler wants bradpitt angelinajolie stop nasty divorce battle^meghanmarkle excited attend wedding^seeks mental health treatment emotional breakdown^robertpattinson nearly fired 'twilight^rachelmcadams reportedly pregnant first child^pic reprises role 'se7en halloween^eminem announces official release date 'revival album^ed sheeran shares secret struggle substance abuse^wants time travel day lost virginity^shuts wonderwoman body shaming^edsheeran settles million plagiarism lawsuit hit song 'photograph^oscars complete winners list thacademyawards^chris pratt files divorce anna faris,11,10,-1,21,0.5238095238095238,-0.047619047619047616,1
84424885,KUWTK,421,527691,1188,29280,0,0,11,10,the official twitter handle keeping up with kardashians e kuwtk,talks struggling infertility kris humphries divorce marrying kktm^would kourtney kardashian *consider* getting back together scott disick kuwtk^breaking craziest rumors kylie jenner since turned kuwtk^sisters always kuwtk^why would n't watching kuwtk^21 kuwtk^holding special memory take look kuwtk bonus scene^always sisters lean kuwtk^dolls finalist therealitytvstar kuwtk finalist therealityshow^rt send love world^west coast time getting ready welcome baby true kuwtk starting right n^kris jenner alleged stalker arrested hidden hills home today giving bit peace mind^kim kardashian standing critics makeup swatches you 're stressing f k out.^kendall jenner wants sexual photo shoots ''i n't get hot often ''^kim kardashian answers big question met gala where kanye west^khloe kardashian epic fourth july party included gold dipped everything^he love koko tristan thompson throws khloe kardashian surprise birthday party^a ap rocky grabs kendall jenner butt met gala family snaps photos^inside kourtney kardashian scott disick family vacation^a naked kourtney kardashian gets wet wild nsfw video mexico^khloe kardashian ready marry tristan thompson,11,10,-1,21,0.5238095238095238,-0.047619047619047616,1
331057915,EliteDaily,476,198352,2115,139301,0,0,11,10,,these pics of jennifer aniston amp justin theroux over the last years will make you cry^i waited outside of the hospital for kate middleton baby amp it was the best day of my life^the weeknd is reportedly upset selena gomez has been spending time with justin bieber^here the complete timeline of prince harry amp meghan markle relationship^princess eugenie gigantic engagement ring is double the price of meghan markle^this one final detail about the weeknd amp selena gomez split is honestly so sad^brody jenner broke his silence on caitlyn skipping his wedding with a shady af response^congrats jessica simpson gives birth second child^kris jenner texted ryan seacrest on live tv about kylie jenner reported pregnancy^kylie jenner baby zodiac chart reveals how she 'll feel about the spotlight^here how kylie jenner daughter stormi will handle being in the spotlight based on her birth chart^donald trump almost played the president in sharknado amp no this is n't a joke^donald trump almost played the president in sharknado amp no this is n't a joke^mindy kaling is reportedly pregnant with her first child and the internet ca n't handle it^intense royal rules meghan markle has to follow now that she duchess^royal fashion rules meghan markle has to follow now that she a duchess^blac chyna granted temporary restraining order against rob kardashian reports confirm^roger ailes former ceo of fox news is dead^ryan murphy gives fans first look at billie lourd american horror story character^khlo kardashian says she ready to marry tristan thompson so sorry lamar^here everything we know about the possibility of a '13 reasons why season,11,10,-1,21,0.5238095238095238,-0.047619047619047616,1
1068121346,BuzzFeedUK,941,181405,2040,91699,1,1,10,9,british buzz tweets find us facebook,george h.w bush died friday age placed capitol rotunda period mourn^here victims chicago hospital shooting^liam hemsworth gets way much joy scaring miley cyrus^kim kardashian left ~dirty~ comment kanye west instagram people freaking^liam hemsworth gets way much joy scaring miley cyrus^john krasinski travelled miles every weekend see emily blunt kids separated fi^john krasinski talking emily blunt daughters make heart melt^netflix revealed bunch new faces appearing the crown season including play princ^kim kardashian left ~dirty~ comment kanye west instagram people freaking^people think katy perry shaded taylor swift american idol awkward af^people think katy perry shaded taylor swift american idol awkward af^if n't received invite prince harry meghan markle wedding 're probably g^drew barrymore spray painted ex boyfriend car yeah n't cross drew barrymore^drew barrymore confessed '90s drew barrymore spray painted ex boyfriend car^harvey weinstein arrested charged rape criminal sex act sex abuse^the best tv show donald trump ever create and readers viewers consuming russia^celebrity fashion trends sadly make comeback^ryan reynolds opened blake lively helped reconcile dad died^kanye west writing philosophy book twitter^tom daley dustin lance black eecting first child^the weinstein company is set to file for bankruptcy,11,10,-1,21,0.5238095238095238,-0.047619047619047616,1
25053299,FortuneMagazine,506,2268699,24094,204537,0,7,12,2,defining design arresting photography award-winning writing want succeed business life,read full transcript first presidential debate hillary clinton donald trump debates2016^read full transcript third presidential debate donald trump hillary clinton^read full transcript second presidential debate hillary clinton donald trump^read full transcript first presidential debate hillary clinton donald trump debates2016^bernie sanders possible presidential bid feature bigger campaign^bernie sanders possible presidential bid feature bigger campaign^read full transcript final presidential debate donald trump hillary clinton debatenight^meet celebrity divorce lawyer helping angelina jolie split brad pitt^brad pitt says cheap eggs buy costco contribute animal cruelty^watch brad pitt christian bale steve carell the big short trailer^watch brad pitt christian bale steve carell the big short trailer^brad pitt edges george clooney film rights chevron donziger story^in law jungle winner brad pitt sorry george^meet celebrity divorce lawyer helping angelina jolie split brad pitt^get ready brad pitt coming netflix stream near^brad pitt bill maher say costco supporting animal cruelty selling eggs caged hens^here every major lawsuit investigation donald trump faces^here every major lawsuit investigation donald trump faces^hoda kotb replace matt lauer nbc today show^melania trump trapped hotel room g20 protesters^lady gaga announces two year residency las vegas,12,9,-3,21,0.5714285714285714,-0.14285714285714285,1
1965236834,TheTrentOnline,140,47763,103,306727,0,1,15,5,nigeria internet newspaper,john oyegun valendictory speech at the apc national convention full text^chris rock in trouble over september jokes^new post chris rock in trouble over september jokes^hackers target sony music twitter account send britney spears death hoax^hackers target sony music twitter account send britney spears death hoax^new post hackers target sony music twitter account send britney spears death hoax^hackers target sony music twitter account send britney spears death hoax^hackers target sony music twitter account send britney spears death hoax^new post hackers target sony music twitter account send britney spears death hoax^hackers target sony music twitter account send britney spears death hoax^hackers target sony music twitter account send britney spears death hoax^hackers target sony music twitter account send britney spears death hoax^hackers target sony music twitter account send britney spears death hoax^hackers target sony music twitter account send britney spears death hoax^hackers target sony music twitter account send britney spears death hoax^hackers target sony music twitter account send britney spears death hoax^breaking prince harry is engaged to american actor meghan markle^breaking judge declares mistrial in bill cosby sexual assault case^breaking judge declares mistrial in bill cosby sexual assault case^breaking judge declares mistrial in bill cosby sexual assault case^new post breaking judge declares mistrial in bill cosby sexual assault case,15,6,-9,21,0.7142857142857143,-0.42857142857142855,1
34258758,GlamourMagUK,4933,486255,3272,145900,0,0,16,5,beauty style entertainment fabulous things think like glamour hq instagram glamouruk,brad pitt stepped ny getting married angelina jolie let say married life suits^is harry styles dating 'naked chef blogger tess ward^katy perry reveals prayed boobs raunchy shoot us gq^baftas winners list^miley cyrus liam hemsworth cancel honeymoon ...^sharon ozzy osbourne split years marriage^selena gomez opens split the weeknd^it official katie holmes jamie foxx are dating^it official katie holmes jamie foxx dating^katie holmes mystery man named sadly towie james 'arg argent ...^moving already katie holmes mystery man^angelina jolie breaks silence marriage rumours ...^omg jennifer aniston john mayer back together^the roles actors amp actresses *nearly* played^the roles actors amp actresses *nearly* played^the roles actors amp actresses *nearly* played^because ca n't resist treating another amazing discount midday tomorrow buy o^see stars join rosie huntington whiteley week best dressed edit^kylie jenner pregnant according reports^mila kunis surprises parents home makeover^who joe alwyn things need know taylor swift new boyfriend,16,5,-11,21,0.7619047619047619,-0.5238095238095238,1
24994219,HouseBeautiful,2356,535298,4075,38563,0,0,18,3,life begins home,what is roseanne barr net worth^kris jenner humongous closet craziest thing you 'll see today^kris jenner humongous closet craziest thing you 'll see today^kris jenner keeping up kardashians house is for sale^kris jenner keeping up kardashians house is for sale^pippa middleton announces her pregnancy fitness column^meghan markle prince harry will reportedly have baby soon they can^the crown season coming princess diana introduced^the crown season coming princess diana introduced^the crown season coming princess diana introduced^the crown season coming princess diana introduced^the crown season coming princess diana introduced^meghan markle will take over one queen elizabeth royal duties^your official guide where prince harry meghan markle are moving now that they 're married^prince harry meghan markle rumored be moving countryside^prince harry and meghan markle are moving to windsor castle^everything you need to know on how flip or flop came to be according to tarek el moussa^meghan markle prince harry will reportedly have baby soon they can^freeform just announced its '31 nights halloween schedule it bigger better than last year^kaley cuoco marries karl cook intimate horse ranch wedding^the best labor day sales furnish your entire home,18,3,-15,21,0.8571428571428571,-0.7142857142857143,1
217478984,YahooMoviesUK,2660,61959,394,48074,0,0,19,2,be know movies pop culture live without like us facebook,reese witherspoon teases legally blonde^reese witherspoon teases legally blonde^margot robbie might playing elizabeth i people happy^josh o connor play prince charles s3 thecrown^tom cruise 'diabolical says former scientologist leah remini^tom cruise 'diabolical says former scientologist leah remini^tom cruise 'diabolical says former scientologist leah remini^german actress sues harvey weinstein alleged rape cannes film festival^german actress sues harvey weinstein alleged rape cannes film festival^german actress sues harvey weinstein alleged rape cannes film festival^golden globes the full list winners^golden globes full list year winners^golden globes full list year winners^pamela stephenson calls michael parkinson 'daft old fart billy connolly comments^pamela stephenson calls michael parkinson 'daft old fart billy connolly comments^charlie hunnam robert pattinson n't speak lost city z set^charlie hunnam robert pattinson n't speak lost city z set^charlie hunnam robert pattinson n't speak lost city z set^brad pitt quit acting three years what make news^harry potter star matthew lewis marries girlfriend angela jones^harry potter star matthew lewis marries girlfriend angela jones,19,2,-17,21,0.9047619047619048,-0.8095238095238095,1
19746411,danirohs,3130,4175,103,17887,0,0,20,1,starting sweatpants cult,dani dirt alec baldwin may seek money play donald trump snl find much gets paid snl^dani dirt jennifer garner told paparazzi dating brad pitt bradpitt^dani dirt minutes find brad pitt stinks bad listen live yeg danisdirt^dani dirt what band brad pitt want wedding it could surprise find dirt gt^dani dirt brad pitt cheating angelina justin bieber ex wtf^dani dirt who planning brad pitt angie wedding ... surprise^dani dirt brad pitt amp angie breaking over health ...^dani dirt brad pitt voluntarily submitted drug alcohol test brangelina^dani dirt could brad pitt next season true detective hbo rumor get info^dani dirt who george clooney best man brad pitt matt damon pat^dani dirt brad pitt amp angelina jolie where honeymoon take guess^dani dirt how much brad pitt paying per day stay booze^dani dirt how much cash angelina want brad pitt per month bradpitt^dani dirt nkotb engaged pay hang brad pitt amp bruno mars dirt live yeg^dani dirt what singer wants date brad pitt and lot younger^dani dirt is brad pitt dating sandra bullock bradpitt^dani dirt brad pitt says caused divorce angie brangelina^dani dirt what cast member friends jennifer aniston two timing brad pitt^dani dirt angelina blocks brad pitt cell number angelinajolie bradpitt^dani dirt nkotb engaged pay hang brad pitt amp bruno mars yeg^dani dirt renewed season netflix reasonswhy,20,1,-19,21,0.9523809523809524,-0.9047619047619048,1
119593082,FOXSoccer,1659,1331099,6505,120173,0,19,1,0,always season,how panama fifa world cup showing make usmnt feel what wrong messi argentina all a^we may never know happened paolo guerrero least 'll able see fifa world cup^strap mls fans decisionday upon us subscribe state union pod^u.s. soccer world cup zidane catch latest episode state union podcast^oldies goodies zlatan rooney done anything hurt mls finishing careers subscribe t^do international legends like wayne rooney deserve farewell games elains feels farewell ap^the latest episode state union podcast listen^atlanta united become mls super club two seasons breaks club must to^n'golo kante one obviously who else makes top premier league midfielders for subscribe^one last episode fifa world cup final be sure check state union podcast^no country may better able come terms world cup without home team united states^another episode state union podcast^strap mls fans decisionday upon us subscribe state union pod^oldies goodies zlatan rooney done anything hurt mls finishing careers subscribe t^do international legends like wayne rooney deserve farewell games elains feels farewell ap^the latest episode state union podcast listen^atlanta united become mls super club two seasons breaks club must to^n'golo kante one obviously who else makes top premier league midfielders for subscribe^another episode alexi lalas state union available^name crest confirmed say hello david beckham mls franchise inter miami cf,1,19,18,20,0.05,0.9,0
14662354,WashTimes,1848,364248,8451,236057,0,17,1,2,reliable reporting hard-hitting analysis breaking news plus rts writers reporters also,bradley a. blakeman the white house reporting according recent report card american s^green groups look buy senate firewall trump fossil fuels agenda league conservation voters law^robert redfield director centers disease control prevention says opioid epidemic even bi^in reality year prior roe centers disease control prevention abortion surveillance repor^fox news prime time host sean hannity present exclusive television interview roseanne barr thursda^white privilege ballot trump says michael moore interview^white privilege ballot trump says michael moore interview^republican national committee raked nearly 15 million may ahead midterm elections^looking immigration policies foreign countries shows lax america immigration system really sa^the legitimacy question opinion mr. giuliani offered six times colleague bill hemmer fox news sund^your cause resonates far beyond borders land goal justice democracy respect human r^in interview bound go history classic dropped f bomb in^in interview bound go history classic dropped f bomb in^watch live white house press briefing sarah sanders^news marriage fox news john roberts abc kyra phillips share briefing white house first^statistics us department agriculture show nearly million americans gotten food stamp^statistics us department agriculture show nearly million americans gotten food stamp^david cassidy fighting memory loss wants 'enjoy life davidcassidy dementia^stormy daniels husband glendon miller crain files divorce cites adultery^ben affleck jennifer garner officially file divorce report,1,19,18,20,0.05,0.9,0
14361260,WFMY,755,132749,982,258743,0,1,3,16,news delivers breakingnews headlines triadtraffic ncwx wfmysports piedmont triad north carolina,years later war poverty^confirm split two years^channing tatum jenna dewan announce separation^channing tatum jenna dewan announce separation^koko gorilla knew sign language dies^scott baio wife renee reveals microvascular brain disease diagnosis^scott baio wife renee reveals microvascular brain disease diagnosis^just in steven bochco tv creator hill street blues nypd blue dead^'nypd blue creator steven bochco dead^lady gaga announces las vegas residency dates^lady gaga announces las vegas residency dates^wwe star vader dead age^wwe star vader dead age^wwe star vader dead age^here emma stone gained pounds muscle 'battle sexes^prince william prince harry best man royal wedding^prince william prince harry best man royal wedding^prince william prince harry best man royal wedding^april giraffe pregnant^april giraffe pregnant,3,17,14,20,0.15,0.7,0
22924867,Z1035Toronto,2872,39606,436,123909,0,0,3,17,the radio station dares different top dance waybacks lots call text us -798-1035 listen,selenagomez mom may approve justinbieber mom said none us perfect never will^nfl season six weeks away already nfl list artists super bowl halftime show van ...^nfl season six weeks away already nfl list artists super bowl halftime show van ...^this is us star justin hartley marries soap actress chrishell stause foxkatz1035^will elsa get girlfriend frozen^rachel mcadams is reportedly pregnant with her first child^hugh hefner cause death revealed^mindy kaling is reportedly pregnant with her first child^read prince harry meghan markle royal wedding vows^video announces opening act for man of the woods tour foxkatz1035^rihanna wants time travel day she lost her virginity^vid the assassination gianni versace american crime story finally has a premiere date amp tease^will smith in talks to play genie in disney live action reboot of aladdin^queer eye tom jackson marries abby parr again^video fuller house renewed for season^lena dunham joins season of americanhorrorstory^video 13 reasons why renewed for season foxkatz1035 reasonswhy^video will smith just won in my feelings challenge and even drake agrees^icymi kelly clarkson to host billboard music awards^cheryl burke and matthew lawrence are engaged,3,17,14,20,0.15,0.7,0
15819466,bellanaija,2802,1616098,924,161833,0,2,4,14,we love fashion music nollywood weddings everything fab african join us twitter updates bn squad,chimamanda ngozi adichie gives keynote speech convention national council teachers english^british man arrested attempting kill donald trump his las vegas campaign rally^meghan markle mother very happy daughter pregnancy^duchess kate middleton makes official return maternity leave wildlife garden^priyanka chopra really excited friend meghan markle royal baby^meghan duchess sussex prince harry duke sussex arrive ireland two day official visit^kim kardashian says north west would make better president donald trump news^kim kardashian says north west would make better president donald trump news^selena gomez opens kidney transplant amp justin bieber covers billboard woman year issue^selena gomez opens kidney transplant amp justin bieber covers billboard woman year issue^ryan seacrest announced kelly ripa new co host abc live tv show^prince harry asks brother prince william best man^mtv movie amp tv awards ditch best actor/actress categories gender neutral see full list nominees^tina turner eldest son craig raymond turner dead apparent suicide^rapper craig mack dead living^rapper craig mack dead living^taylor swift announces release date album reputation new single thursday music^taylor swift announces release date album reputation new single thursday music^next year going shonda rhimes releases official statement scandal ending season^next year going shonda rhimes releases official statement scandal ending season,4,16,12,20,0.2,0.6,0
17194257,News4SA,3502,189063,1145,213898,0,5,6,9,we news san antonio your source latest news weather traffic we also san antonio first tv station nbc affiliate,preempted today show meet press^watch live hillary clinton host campaign rally las vegas nv^watch live white house press briefing^watch live white house press briefing^four bodies recovered one still missing san marcos apartment fires^report ryan phillippe 'devastated 'false allegations domestic violence^report ben affleck jennifer garner settle divorce^angelina jolie split brad pitt 'i n't enjoy single^mariah carey new year eve performance 'they foiled^report angelina jolie named bizarre lax terror threat sent police^former miss utah trump accuser holding press conference salt lake city^on news tonight starts live results america got talent featuring performance bts then f^james franco denies sexual misconduct allegations^steve martin martin short 'colonoscopy parties tom hanks^former fox news ceo roger ailes dead^fergie josh duhamel announce split years marriage^richard simmons hospitalized severe indigestion^oscars the complete list nominations winners^reports kylie jenner pregnant^april giraffe pregnant,6,14,8,20,0.3,0.4,0
33517296,wsyx6,5694,156618,1234,178175,2,3,4,11,news weather traffic central ohio beyond breaking news tips call -481-6659,two people found dead flipped car ohio canal^three people including toddler found dead apartment huber heights ohio neighbors reported bad sm^president trump delivers remarks national electrical contractors association convention philadelphia^breaking says multi vehicle crash sent four adults one child area hospitals the crash happened^amber alert an amber alert issued cleveland mom accused kidnapping four children one th^john mayer hospitalized emergency appendectomy according rep^report ben affleck jennifer garner settle divorce^angelina jolie split brad pitt i n't enjoy single^in honor meghanmarkle wedding nephew oregon cannabis grower developed royal strain called '^koko gorilla knew sign language dies^icymi koko gorilla knew sign language dies^koko gorilla knew sign language dies^james franco denies sexual misconduct allegations^suspect arrested murder rapper xxxtentacion^just in kensington palace says prince charles walk meghan markle aisle royal wedding.^meghan markle dad reportedly wo n't attend royal wedding staging photos^just in danielle herrington cover model sports illustrated swimsuit issue she became thir^breaking former ceo roger ailes dead^msnbc confirmed morning joe co hosts joe scarborough mika brzezinski engaged.^giraffe watch back aprilthegiraffe pregnant due around march,6,14,8,20,0.3,0.4,0
81167207,THRtv,756,13474,535,77153,1,0,5,14,television news reviews the hollywood reporter,'the daily show michelle wolf lands her own netflix late night show exclusive^'the bachelorette engaged rachel lindsay reveals her winner historic season finale^jennifer aniston reveals struggles with dyslexia anger shrugs off oscar snub^when steven spielberg steven bochco worked same tv show with sean penn dad noam chomsky cousin^'the crown casts its prince charles queen mother season exclusive^beverly hills high school turns carrie fisher carpools angelina jolie goth phase revealed oral histor^'walking dead promotes pair series regular season exclusive^'walking dead promotes trio series regular season^'walking dead promotes three series regular season^pink nick jonas fall out boy read mean tweets 'jimmy kimmel live^katy perry jennifer lopez join james corden 'carpool karaoke primetime special^'star trek discovery renewed season cbs all access^jennifer lawrence drinks rum with stephen colbert calls harvey weinstein horrible ass boil^'outlander renewed seasons starz^watch 'queer eye cast react tom jackson abby parr wedding^fuller house renewed for season by netflix^'how get away with murder star karla souza alleges she was raped director mexico^james corden parodies 'a quiet place 'the late late show^'rent set fox next live musical^'13 reasons why officially renewed season netflix,6,14,8,20,0.3,0.4,0
19212009,WhoWhatWear,1703,2159438,10914,147137,0,0,7,13,your download matters fashion,angelina jolie strapless naked dress naked heels could n't chicer^justin bieber hailey baldwin already got married here everything know^justin bieber hailey baldwin already got married here everything know^angelina jolie strapless naked dress naked heels could n't chicer^angelina jolie strapless naked dress naked heels could n't chicer^angelina jolie strapless naked dress naked heels could n't chicer^angelina jolie strapless naked dress naked heels could n't chicer^celeb inspired ways wear flare jeans 3 cute^who excited cannes fashion look back best red carpet moments brigitte bardot^congrats mindy kaling reportedly pregnant first child^sophie turner joe jonas engaged see gorgeous ring^surprise ariana grande pete davidson engaged here know^irina shayk bradley cooper welcome first child^we challenge try celeb inspired holiday outfits^from sequin dress la lbd c/o kate moss celeb inspired holiday outfits^the best celeb inspired holiday outfit every age^the best street style looks cannes film festival^how wear maxi dress winter according olivia palermo gigi hadid^happy superbowl sunday the best halftime shows ever^shop best cyber monday sales,7,13,6,20,0.35,0.3,0
380285402,DailyMail,1844,211248,3027,159807,0,8,7,5,latest news us daily mail team we facebook,"stormy daniels spills details affair donald trump here transcript elosive m^emma liam jacob emily america popular baby names state revealed^emma liam jacob emily america popular baby names state revealed^breaking vice president deliver statement rose garden 0pm est^presidential turkey shows white house briefing room^white house press briefing reduced angry exchange cnn contributor demands answers race politics^us department agriculture recall ,000 lbs jennie o ground turkey^us department agriculture told staff censor use term 'climate change^nascar owners threaten fire drivers protest national anthem^matt lauer former today co host katie couric says pinched 'on a** lot interview^matt lauer former today co host katie couric says pinched 'on a** lot interview^tom cruise 'diabolical 'good person says leah remini^abc michael strahan 'refused return good morning america greek vacation cover hurricane harvey^blake griffin ex tears nba star lawsuit claims 'abandoned family fawn kendall jenner^oprah winfrey 'intrigued idea running president says best friend gayle king^walmart remove 'graphic degrading cosmopolitan checkout lines^jetblue kick family plane confrontation mom birthday cake 'deemed security risk'^former fox news ceo roger ailes dead^weinstein company file bankruptcy^morning joe co hosts joe scarborough mika brzezinski reportedly engaged",7,13,6,20,0.35,0.3,0
14861004,KCTV5,821,166639,1692,224798,3,5,4,8,kctv5 news stands you we dig deeper uncover truth tell stories,president tweets congratulations debbie lesko us house representatives speci^federal prosecutors charge nyc subway bomb suspect say wrote facebook trump failed protect nation^melania trump undergoes kidney surgery walter reed medical center gt gt^video president trump ended speech tuesday national federation independent business bi^take look president concluded speech tuesday washington dc he speaking^death rates liver cancer increased american adults according report released t^watch live sarah sanders holding briefing pres earlier i^watch live sarah sanders holding monday press briefing speculation continues ov^david cassidy fighting memory loss wants 'enjoy life^comedian hannibal buress arrested miami disorderly intoxication^says embarrassed kanye west visit pres^icymi here complete list winners emmy awards^james franco denies sexual misconduct allegations^aly raisman sues us olympic committee usa gymnastics^sadly father attending wedding i always cared father hope given the^priyanka chopra nick jonas confirm engaged^billboard music awards check complete list winners^billboard music awards check complete list winners^billboard music awards check complete list winners^billboard music awards check complete list winners,7,13,6,20,0.35,0.3,0
46326721,KENS5,509,151865,1036,158726,1,7,6,6,breaking news local stories kens san antonio,texas agriculture commissioner sid miller endorsed kid rock run united states senator facebook^the centers disease control prevention investigating tick spreading widely across united s^nationwide oct. measles cases reported according federal centers disease control^transcript stormy daniels '60 minutes interview^here check statements made tuesday first address joint session congress^president donald trump sat fox news interview aired sunday^the centers disease control prevention investigating tick spreading widely across united s^nationwide oct. measles cases reported according federal centers disease control^emmy awards the winners list^channing tatum jenna dewan announce separation^channing tatum jenna dewan announce separation^channing tatum jenna dewan announce separation^redundancies faulty capitalization lack clarity specificity but mason n't grading student paper s^kevin hart confesses cheating pregnant wife^koko gorilla knew sign language dies^walmart remove 'cosmopolitan magazine checkout lines amid me too movement^scott baio wife renee reveals microvascular brain disease diagnosis^former fox news ceo roger ailes dead^veep actress julia louis dreyfus diagnosed breast cancer^april giraffe pregnant,7,13,6,20,0.35,0.3,0
18748145,GoldDerby,6101,32336,639,49483,0,2,7,11,predict win oscars emmys grammys tonys thevoice showbiz competitions eerts win prizes facebook,michelle yeoh crazy rich asians asian actors able getting roles like complete int^ben foster leave no trace trauma specific war complete interview transcript^in seasons females americanidol will th^jack nicholson movies greatest films ranked worst best include cuckoo nest chinatown the shining^blake shelton savvily steals colton smith jennifer hudson the voice fierce battle patrique for^the voice coaches rank kelly clarkson jennifer hudson adam levine blake shelton amp poll^the voice season top which coach best team kelly clarkson jennifer hudson adam levine blake^dancing stars season pro dancers announced the pros include reigning champ rookie more^lady gaga amp bradley cooper would third a star is born duo score matching golden globes^tony awards complete list nominations the th annual edition top theater kudos ...^tony awards complete list nominations the th annual edition top theater kudos ...^who die next 'the walking dead odds glenn abraham ... who die next the walkin ...^who die next 'the walking dead odds abraham tara ... who die next the walking ...^who die next 'the walking dead odds maggie sasha ... who die next the walking ...^who die next thewalkingdead tv odds maggie sasha ...^who die next thewalkingdead odds glenn abraham ...^who die next thewalkingdead tv odds abraham tara ...^maggie /1 odds dying next 'the walking dead have you voted who die next the w ...^who die next thewalkingdead tv odds maggie sasha ...^daytime emmy awards complete list winners winners st annual daytime emmy awards rev ...,7,13,6,20,0.35,0.3,0
35972659,RizzShow,1071,29650,154,53607,1,0,6,13,you catch the rizzuto show the point a-10a monday friday,rizznews melania trump undergoes kidney surgery walter reed medical center^craponcelebrities john mayer hospitalized yesterday emergency appendectomy more gt^craponcelebrities earlier month johnnydepp sued former business managers million ...^craponcelebrities as i sure heard royal family announced yesterday prince harry en^craponcelebrities time list '11 most controversial moments super bowl halftime shows'..^craponcelebrities arnoldschwarzenegger leaving the new celebrity apprentice one season ...^craponcelebrities are jamie foxx katie holmes dating details blog ...^craponcelebrities former tennis star anna kournikova singer enrique iglesias welcome twins gt^craponcelebrities as i sure heard royal family announced yesterday prince harry en^rizznews walmart remove 'cosmopolitan checkout lines says 'business decision gt^rizznewsextra it boy april giraffe finally gives birth ...^craponcelebrities donald trump star hollywood walk fame vandalized ...^foodnews spicy skittles spicy starbursts are totally thing now^craponcelebrities stacey dash running congress california ... info here gt^craponcelebrities actor patrick boll five men arrested florida prostitution sting ... her^craponcelebrities one day undergoing emergency surgery initially thought spinal infect^craponcelebrities john dickerson replaces charlie rose cbs this morning gt^craponcelebrities jeremy london arrested domestic violence gt^craponcelebrities it coming seth he announced knocked wife let known that^craponcelebrities hopper penn year old son sean penn robin wright arrested nebras,7,13,6,20,0.35,0.3,0
44599458,Nobsdaslushhkid,1063,88329,239,233073,0,0,8,12,marketing/creative director instagram noble igwe payporte fashion ambassodor lfdw fashion ambassador,fergie and husband josh duhamel split after years of marriage^ellen degeneres agrees to go to marriage therapy to save marriage to portia de rossi^ellen degeneres agrees to go to marriage therapy to save marriage to portia de rossi^here are the winners of the critics choice awards full list^ellen degeneres agrees to go to marriage therapy to save marriage to portia de rossi^ellen degeneres agrees to go to marriage therapy to save marriage to portia de rossi^kim kardashian kanye west secretly got married^kim kardashian kanye west secretly got married^black panther stranger things infinity war among nominees for mtv movie amp tv awards see full list^new post beauty tutorial achieve an everyday makeup look in less than minutes^beauty tutorial achieve an everyday makeup look in less than minutes via^cma awards here the complete list of winners^bill cosby found guilty sexual assault retrial^complete nomination list for the tony awards as bradley cooper helen mirren and carey mulligan lead the pack^sag awards here the complete list of winners^fergie and husband josh duhamel split after years of marriage^the originals comes to an end after seasons^serena williams withdraws from australian open^reasons why renewed season by netflix^kylie jenner denies that she pregnant for tyga recent reports suggest kylie jenner pregnant f ...,8,12,4,20,0.4,0.2,0
38228095,theGrio,3046,102328,2030,84441,0,3,9,8,black culture amplified,i still believe angela told man dc office plans jimenez you met man^obama campaign going first radio ad targeting african americans^political figures including barack obama hillary clinton sen. kamala harris rep. maxine waters eric holder w^nascar owners threaten fire drivers protest national anthem^nascar owners threaten fire drivers protest national anthem^video surfaces comedian hannibal buress arrested miami disorderly intoxication^indefinitely cancelled meeting president elect trump towers today^booked busy michael strahan add rd hour good morning america resume^kim kardashian west faced major backlash posted video showing using slur she upset people d^booked busy michael strahan add rd hour good morning america resume^meghanmarkle nephew developing strain cannabis named soon royal aunt day^nothing new taylor swift still butt hurt kanye west amp kim kardashian calling lying.^ryan seacrest takes seat new co host live^jada pinkett smith calls alleyezonme film inaccuracies depicting relationship tupac^kenya moore months eecting first child marc daly rhoa^a judge granted blac chyna request temporary restraining order rob kardashian^a judge granted blac chyna request temporary restraining order rob kardashian^we always friends rye confirms break^serena williams withdraws australian open eressing birth ready compete tha^they packed ready go reports say baby true heading ohio with,9,11,2,20,0.45,0.1,0
18088038,djvlad,1058,154225,1759,222688,0,0,11,9,ceo business evan.com -927-1110,kanye west performs gold digger american idol audition^kanye west performs gold digger american idol audition^kim kardashian defends kylie jenner forbes list says we are all self made^exclusive godfrey meghan markle married money looks miserable w/ prince harry^godfrey meghan markle married money looks miserable w/ prince harry part via^hannibal buress arrested disorderly intoxication miami^kevin hart eniko parrish welcome baby boy kenzo kash^kanye us yeezy tour postponed indefinitely after car crash^music video shoot tekashi ix9ine kanye west amp nicki minaj gets shot up^kanye west struggling to sell out upcoming concert shows^nbc trying hire kanye for american idol return^jane elliot calls herself faded black person talk jada pinkett smith^jay z releases second snippet new song adnis teases new album^rosario dawson comedian eric andre break up^third xxxtentacion murder suspect arrested georgia^another suspect xxxtentacion murder case has been arrested^barack obama during prince harry interview do i need british accent^gwyneth paltrow denies amber rose saying she 'becky good hair^weinstein company file bankruptcy^venus williams files emergency protective order car crash lawsuit,11,9,-2,20,0.55,-0.1,1
16803602,Daily_Record,2997,121364,1391,216797,0,0,11,9,the official daily record twitter account real news real time also sport,jennifer aniston justin theroux split 'bologna incident furious fights sources claim^as kate middleton emerged lindo wing st mary hospital given birth third child everyone^meghan markle 'frustrated strict royal rules 'learning hard way life inside family^cheryl reveals heartache liam payne split first time emotional new comeback song^is real reason drake hooking jennifer lopez^drake ecretly hooking walsall singer jorja smith spotted local co op^billy connolly wife pamela hit back michael parkinson talk show host said comedian failed recog^sir billy connolly parkinson battle taking toll sadly trouble recognising pals^kim kardashian et divorce kanye west fight custody children troubled rap star^david beckham accused hirking responsibility role model speeding charge^meghan markle set hen party ahead wedding prince harry big names missing^margot kidder dead superman star passes away home^breaking meghan markle dad attend royal wedding due major heart surgery^rushed hospital accident home^jay z admits marriage wife beyonce 'was n't totally built percent truth^pippa middleton nubbed prince harry meghan left wedding reception list^game thrones stars kit harington rose leslie 'getting married say friends^gameofthrones stars kit harington rose leslie getting married scotland today^breaking bad star aaron paul announces wife lauren eecting first child together^sir roger moore dead james bond star dies short cancer battle,11,9,-2,20,0.55,-0.1,1
2896294831,ComicBookNOW,10506,256919,2364,253712,0,0,14,6,the official comicbook now twitter account we leading source news comic books movies tv shows things hype,shannen doherty reveals what she thinks 'charmed reboot^shannen doherty reveals what she thinks 'charmed reboot^shannen doherty reveals what she thinks 'charmed reboot^original charmed star shannen doherty defends the cw reboot^oscar isaac carrie fisher is still with us star wars episode ix filming^oscar isaac carrie fisher is still with us star wars episode ix filming^aquaman movie reveals first look nicole kidman atlanna^aquaman movie reveals first look nicole kidman atlanna^icymi selena gomez responds 'sabrina casting rumors^icymi selena gomez responds 'sabrina casting rumors^selena gomez responds 'sabrina casting rumors^could charlize theron get a role in 'wonder woman^icymi could charlize theron get a role in 'wonder woman^icymi could charlize theron get a role in 'wonder woman^miles teller reportedly arrested drunk public^guardians of the galaxy stars chris pratt zoe saldana break silence james gunn s firing^guardians of the galaxy stars chris pratt zoe saldana break silence james gunn s firing^'happy days star erin moran dead^icymi spider man homecoming post credits scenes elained^spider man homecoming post credits scenes elained,14,6,-8,20,0.7,-0.4,1
15823855,Screendaily,3929,107660,2242,56212,0,2,14,4,the voice international film industry follow team,stephen frears direct rosamund pike chris o'dowd nick hornby tv series 'state of the union'^stephen frears direct rosamund pike chris o'dowd nick hornby tv series 'state of the union'^'god own country star josh o'connor play prince charles 'the crown^'god own country star josh o'connor play prince charles 'the crown^'god own country star josh o'connor play prince charles 'the crown^gerard butler thriller 'keepers bought exclusive^gerard butler thriller 'keepers bought exclusive^'a star is born documentary water vince vaughn teaming mel gibson som^out competition venezia75 titles include 'a star is born bradley cooper 'dragged across co^cannes film festival dates announced^korean film sales cannes film festival hit record high 10m^mary harron returns story charles manson acolytes 'charlie says venice75 biennale review^charlie hunnam robert pattinson n't speak 'the lost city of z^charlie hunnam robert pattinson n't speak 'the lost city of z^charlie hunnam robert pattinson n't speak 'the lost city of z^charlie hunnam robert pattinson n't speak 'the lost city of z^meryl streep rose mcgowan i know weinstein crimes^meryl streep rose mcgowan 'i know weinstein crimes^meryl streep rose mcgowan 'i know weinstein crimes^meryl streep joins cast 'big little lies season,14,6,-8,20,0.7,-0.4,1
35733687,BroBible,6894,140367,1126,231359,0,0,15,5,keeping internet chill since,nascar owners threaten to fire drivers who protest the national anthem^katy perry had the best response to the false rumors that she dating ryan phillippe^katy perry had the best response to the false rumors that she dating ryan phillippe^katy perry had the best response to the false rumors that she dating ryan phillippe^the rock worked out with and talked trash to his 'jungle cruise castmates emily blunt and jack whitehall videos^kanye west blasts drake for not denying rumor about hooking up with kim kardashian^kanye west apologizes to drake on twitter just days after rumors swirled of kim and drake hooking up^kanye west apologizes to drake on twitter just days after rumors swirled of kim and drake hooking up^kanye west blasts drake for not denying rumor about hooking up with kim kardashian^kanye west blasts drake for not denying rumor about hooking up with kim kardashian^kanye west apologizes to drake on twitter just days after rumors swirled of kim and drake hooking up^rt laughed ass nph throwing major shade jennifer aniston couple seconds ago whatadick^man claims he allergic kim kardashian vomits when he sees her^man claims he allergic kim kardashian vomits when he sees her^man claims he allergic kim kardashian vomits when he sees her^'star wars director rian johnson reveals who the last jedi is sorta plus new pics of snoke^'star wars director rian johnson reveals who the last jedi is sorta plus new pics of snoke^the best cyber monday sales and deals of so far^the best cyber monday sales and deals of so far^the best cyber monday sales and deals of so far,15,5,-10,20,0.75,-0.5,1
426802833,AP_Politics,616,361396,5834,78089,0,18,1,0,highlights ap coverage u.s. politics government words photos video managed washington bureau,"rudy giuliani says robert mueller indicated 'pretty much finished except interview presid^bernie sanders new book where we go from here gives fresh opportunity promote ideas without going^bernie sanders presidential campaign paid 14,500 civil penalty federal election commission to^vermont u.s. sen. bernie sanders laying groundwork launch bigger presidential campaign fir^candidates rat new hampshire democratic presidential primary debate^the us department education says reopening probe alleged anti semitism rutgers university^the democratic party talking tv networks series presidential primary debates party offici^the democratic party talking tv networks series presidential primary debates party offici^french president macron gets invite address joint session congress^obama campaign woos hispanics tv radio ads focusing healthcare family issues^ap newsalert washington ap white house vice president joe biden make statement rose garden^read transcript interview president donald trump^word word the transcript president donald trump interview white house reporters^healthy debate ideas political philosophy important press secretary sarah huckabee sanders told report^the u.s. military says one u.s. special operations soldier killed four u.s. service members woun^a new analysis describes two presidential candidates tax plans mirror images^tough tariffs 40b chinese goods eected announced today could put us trade policies collisio^four days us china agree impose billions tariffs goods trump says detai^reality television star kim kardashian white house meeting president donald trump criminal",1,18,17,19,0.05263157894736842,0.8947368421052632,0
19201818,NBCConnecticut,803,278500,1739,122052,0,2,1,16,thank stopping -- place go exclusive local stories latest breaking news weather updates,percent voters approve president job performance nbc news/wall street journal poll found^tyrone moses fields jr. arrest occurred one day broward county sheriff office released surveillance video^a royal baby way prince harry wife meghan markle duchess sussex nbcct^'i obviously support my family alison brie addresses james franco allegations sag awards^'this is us chrissy metz reveals surprising connection younger kate actress^heather locklear arrested attacking cop emt^heather locklear hospitalized minor injuries car crash nbcct^howie mandel does n't remember meghan markle 'deal no deal royalwedding nbcct^portia de rossi says steven seagal unzipped pants audition nbcct^rachel mcadams accuses james toback sexual harassment vivid detail^meghan markle half sister fires back prince harry family remarks nbcct^all sag award presenters will be women^'the office revival reportedly works nbc^demi lovato sings about breaking sobriety new song 'sober^chrissy teigen says knows allegedly bit beyonce face wo n't tell nbcct^there indication warning would kate spade husband andy spade breaks silen^chrispratt apologizes sign language offending hearing disabilities^rita moreno talks about wearing same dress she wore oscars^actresses protest sexual harassment wearing only black golden globes,1,18,17,19,0.05263157894736842,0.8947368421052632,0
15050354,DeseretNews,93,95510,1593,155789,0,14,3,2,the deseret news offers news information commentary analysis award-winning eerienced team reporters editors columnists bloggers,a report u.s. energy information administration projected tuesday would see lowest u.s. coal c^brandon wentz passing nov. came near end year saw record number drug overdose deat^the centers disease control prevention officially start investigating tick first made headlines^icymi the centers disease control prevention rolling cookie dough^a report u.s. energy information administration projected tuesday would see lowest u.s. coal c^belknap elementary beaver declared blue ribbon school u.s. department education every child in^brandon wentz passing nov. came near end year saw record number drug overdose deat^the centers disease control prevention officially start investigating tick first made headlines^thursday centers disease control prevention reported suicide rates rose steadily nearly every state^icymi the centers disease control prevention rolling cookie dough^a report u.s. energy information administration projected tuesday would see lowest u.s. coal c^the u.s. department agriculture food safety inspection service issued nationwide recall turkey pro^one offer allows viewers stream four movies concurrently ultra hd the offer see current 13.9^while utah already erts billions dollars annually goods services countries around world u.s.^guests attended royal wedding prince harry meghan markle selling goodie bags upwards o^a man claims salt lake police used excessive force july arrested wednesday end press^so ex con stripper troubled teen ray gun take cross country road trip run prison^tiger woods arrested early monday dui charge jupiter florida^meghan markle father says attend royal wedding so walk meghan aisle,3,16,13,19,0.15789473684210525,0.6842105263157895,0
19687781,ScottyKOnair,13390,25081,138,48125,0,0,3,16,dad chicago grown radio mornings soyouthinkyoucandance s.1 american ninja warrior bongo player ig,kanye west shares texts with caitlyn jenner^here is complete list winners from billboard music awards so far^here is complete list winners from billboard music awards so far^amy schumer hospitalized horrible kidney infection^adele lifts celine dion spirits amid health issues^walmart remove cosmopolitan magazine checkout lines amid me too movement here^cardi b flashes her enormous carat engagement ring^taylor swift wears snake boots hugs superfans reputation secret sessions^oscars trailer pokes fun best picture winner mistake^selena gomez the weeknd split after months ''it been hard months ''^amy schumer marries chris fischer surprise wedding^kylie jenner newest photo baby stormi is her sweetest yet here^here is complete list winners from billboard music awards so far^here is complete list winners from billboard music awards so far^taylor swift latest surprise has amber rose wiz khalifa son freaking out^will smith addresses jada pinkett smith divorce rumors new song^ellen degeneres surprises jimmy kimmel with special dedication his son billy^ellen degeneres facetimes with oprah winfrey gets emotional discussing montecito disaster^kevin hart takes his cheating scandal j. cole new music video,3,16,13,19,0.15789473684210525,0.6842105263157895,0
51241574,AP,7108,13524664,95242,251161,2,4,2,11,news the associated press taste great journalism produced ap members customers managed /7 editors,breaking federal prosecutors charge nyc subway bomb suspect say wrote facebook trump failed protect nation^man found four people dead ohio home told dispatcher knew identity shooter^he war hero congressman ambassador united nations envoy china chairman republica^a world of pollution ap photos illustrate global challenge reducing emissions nations meet un cli^obama campaign woos hispanics tv radio ads focusing healthcare family issues ab^breaking white house vice president joe biden make statement rose garden^on twitter president trump blames arnold schwarzenegger low ratings 'the new celebrity apprentice^update jennifer holliday backs performance inauguration president elect donald trump^comedian kevin hart wife eniko parrish eecting baby boy first child together^video actor comedian jerry lewis dies age^among ap10thingstoknow jerry lewis dies age spanish town struggles reconcile locals extremist cell^the latest laura dern wins supporting actress limited series emmy 'big little lies role^the latest prince charles walk meghan markle aisle royal wedding kensington palace says^britain prince harry meghan markle request 'understanding respect markle father celebrity^prince harry says wanted british royal family^monica lewinsky slams upcoming hln special affair president bill clinton led impeachment^british actor daniel craig confirms widely eected play james bond^britain royal palace says prince harry asked elder brother prince william best man wedding next^'ncis star pauley perrette says leaving cbs crime drama season following years show,4,15,11,19,0.21052631578947367,0.5789473684210527,0
778704734,DiamondCelebs,14782,26384,52,31319,0,0,5,14,the official twitter account of diamond celebrities magazine award-winning international magazine based in germany london nigeria,blac chyna hires infamous lisa bloom as attorney for restraining order case against rob kardashian^revenge this may real reason drake hooking jennifer lopez^revenge this may real reason drake hooking jennifer lopez^hurt kanye west slams mentor jay z kim kardashian robbery ordeal^hurt kanye west slams mentor jay z kim kardashian robbery ordeal^tristan thompson benched nba playoff game amid khloe kardashian cheating scandal^chrissy teigen trolls president donald trump over twitter blocking ruling^cardi b gives birth welcomes first child with offset^how kim kardashian plans celebrating her th birthday today^bobbi kristina brown ex nick gordon arrested again domestic violence^kylie jenner kanye west amp rihanna among time most influential people internet^selena gomez very upset over demi lovato overdose^kardashian family not surprised blac chyna six flags fight^khloe kardashian celebrates her luxurious baby shower with family friends photos^morgan freeman responds multiple sexual harassment allegations^disappointed serena williams withdraws australian open^she my life birdman opens up about fianc e toni braxton^paris hilton says sex tape leak was like being raped^inside selena gomez relationship with justin bieber mom,5,14,9,19,0.2631578947368421,0.4736842105263158,0
23655688,OttawaCitizen,266,205336,2860,222144,0,1,6,12,the biggest daily nation capital,house speaker paul ryan formally invited president donald trump deliver first state union address^'the key know stedman graham talks investing self leadership oprah^the complete list winners golden globes^meghan markle considered bond girl role royal engagement report^meghan markle considered bond girl role royal engagement report^meghan markle considered bond girl role royal engagement report^meghan markle considered bond girl role royal engagement report^'he like pig actress paz de la huerta accuses harvey weinstein raping twice^'he like pig actress paz de la huerta accuses harvey weinstein raping twice^matt damon apologizes comments sexual misconduct^don rickles legendary comedian actor dies^superstar dj avicii found dead^prince harry brings girlfriend meghan markle pippa middleton wedding reception^prince harry brings girlfriend meghan markle pippa middleton wedding reception^bradley cooper girlfriend irina shayk welcome first child^relive meghan markle prince harry big day the best royal wedding photos^relive meghan markle prince harry big day the best royal wedding photos^relive meghan markle prince harry big day the best royal wedding photos^oscars the complete list nominees winners happen,6,13,7,19,0.3157894736842105,0.3684210526315789,0
28390516,KMOV,374,120626,1400,137459,2,1,4,12,bringing latest st. louis news weather traffic sports computer mobile device for download kmov mobile app,recall alert recalling water absorbing easter amp dino toys due serious ingestion hazard.^melania trump undergoes kidney surgery walter reed medical center^a latina immigrant barred running state office even though us citizen year^comedian leslie jones advice victims cyberbullying^the latest 'three billboards wins best drama film globe^the latest 'three billboards wins best drama film globe^rapper travis scott pleads guilty disorderly conduct^koko gorilla learned sign language dies^james franco denies sexual misconduct allegations^james franco denies sexual misconduct allegations^james franco denies sexual misconduct allegations^james franco denies sexual misconduct allegations^'dancing stars pros jenna johnson val chmerkovskiy engaged^matt damon apologizes comments sexual misconduct^priyanka chopra nick jonas confirm engaged^billboard music awards check complete list winners^most talked moments super bowl history^billboard music awards check complete list winners^colin trevorrow back direct jurassic world,6,13,7,19,0.3157894736842105,0.3684210526315789,0
3873984133,CanadaMoments,12,42601,411,54635,1,0,5,13,the best happening twitter instant,the us house representatives intelligence committee unanimously voted declassify release democratic^people happy chosen describe^could confirmation jamie foxx katie holmes dating^the first official photographs prince louis captured mother catherine duchess cambridge^the first official photographs prince louis captured mother catherine duchess cambridge^to relive moments incredibly difficult emotionally. shared thoughts^celebrity chef mario batali fired the chew following allegations sexual misconduct^matt damon fire controversial comments sexual misconduct hollywood^with engaged prince harry reporting spend christmas the^miles teller denies reports arrested drunk public san diego^a third suspect murder robert allen arrested central georgia^congrats reportedly pregnant first child^meghan markle confirms father attend royal wedding^after getting makeover tom jackson marrie^it official karlie kloss engaged boyfriend joshua kushner six years dating^mila kunis revealed makes monthly donations planned parenthood mike pence name^janelle mon e comes pansexual latest cover story says eeriences^prince harry audi sale online he seen driving pippa middleton wedding reception meghan m^nearly two weeks going missing actress arielle kebbel sister julia found safe sound,6,13,7,19,0.3157894736842105,0.3684210526315789,0
2985942701,GlobalsNewsroom,166,5878,215,75140,2,5,4,8,breaking news biggest stories global newsrooms around uk,prosecutors revealed new york subway bomb suspect wrote facebook trump failed protect na^the man accused trying blow new york subway station mocked president trump failed attack ban^theresa may declared brexit negotiations endgame in speech foreign policy lord^some lush stores taken controversial ad campaign accusing police officers lying the cosmetics^police chicago say reports multiple victims shooting hospital city^boris johnson says sadiq khan needs take responsibility knife crime london the former foreign secretary^four palestinians killed israel attacked hamas targets gaza following fatal shooting so^this prince harry meghan markle leaving buckingham palace christmas lunch royal family hoste^david beckham prosecuted speeding charge celebrity lawyer nick freeman dubbed mr loophol^david beckham face trial alleged speeding offence west london january year^david beckham wo n't prosecuted speeding fine his lawyer known mr loophole argued penalty w^ed sheeran revealed got engaged girlfriend cherry seaborn christmas he says 're happy^kensington palace confirmed prince charles walk meghan markle aisle royal wedding tomorrow^it understood prince charles walk meghan markle second half aisle tomorrow royal w^prince harry admits 'wanted royal family^game of thrones stars kit harington rose leslie reportedly getting married today the year old actors ar^prince harry best man prince william shaking hands well wishers outside windsor castle ahead^prince harry best man prince william walked windsor castle shake hands wellwishers ahea^reality tv star kylie jenner pregnant first child according us reports,6,13,7,19,0.3157894736842105,0.3684210526315789,0
205770556,theipaper,4332,104351,2023,186199,1,1,6,11,your essential daily briefing follow us facebook instagram,senate house representatives what difference us midterms changed things^donald trump escalated trade war us china imposing new import tariffs 200bn chine^kim kardashian retired public life something care^kim kardashian retired public life sad thing^kim kardashian retired public life sad thing^it crown lose prince charles control political meddling writes^billy connolly make major new bbc tv series scotland^former manchester united footballer david beckham prosecuted speeding charge celebrity law^stranger things everything know season far^everything know season stranger things far^stranger things everything know season far^everything know strangerthings season far^stranger things everything know season far^stranger things season everything know far^emma watson donates 1 million anti sexual harassment campaign^emma watson donates 1 million anti sexual harassment campaign^meghan markle father attending royal wedding walk aisle^meghan markle father attending royal wedding walk aisle claimed aft^everything need know return twin peaks,7,12,5,19,0.3684210526315789,0.2631578947368421,0
1684907262,HOT1037Seattle,896,3120,35,21333,0,0,9,10,the new hot plays throwbacks an entercom station listen live app,deanna dirt brad pitt is not being investigated for child abuse via^brad pitt under investigation for alleged child abuse details :40am deanna dirt^deanna dirt brad pitt cleared of wrongdoing in child abuse investigation via^deanna dirt brad pitt spotted out in first time since split via^brad pitt cleared in child services investigation details :40am deanna dirt^deanna dirt did brad pitt cheat via^first brad pitt chris brown what two common details :40am deanna dirt^are jamie foxx and katie holmes dating we clear longtime rumors :40am deanna dirt^icymi complete list grammy winners^ryan seacrest kelly ripa new co host 'live sources say^miley cyrus jimmy fallon go undercover subway singers^mtv movie amp tv awards full list nominees^kylie jenner surprises high school students their prom^mistakes american idol revival abc has avoid^rob amp big star christopher ''big black '' boykin dead^bradley cooper irina shayk welcome first child via^the girls hbo 'girls star golden girls parody^fierce women who run music world^richard simmons hospitalized severe indigestion says manager,9,10,1,19,0.4736842105263158,0.05263157894736842,0
1870397263,dnaAfterHrs,0,68500,192,52315,0,0,10,9,daily lifestyle supplement tour guide news bollywood hollywood television the authoritative source entertainment,nobody works harder sisters mom kim kardashian west defends elf made billionaire kylie jenner^selena gomez upset family negative opinion justin bieber^thecrown casts new faces play prince charles queen mother^i n't enjoy single angelinajolie^jason momoa game cameo aquaman co star nicole kidman biglittlelies^kendalljenner makes confession latest episode 'keeping up kardashians^angelina jolie rubbishes split lawyer custody battle brad pitt^the overnight fame thehungergames terrified jenniferlawrence^masabagupta madhumantena a timeline relationship writes iyer^no spotlight kyliejenner baby birth^singer enrique iglesias former tennis star anna kournikova welcome twins^till coasts us apart here real reason behind jenniferaniston justintheroux split^eminem announces official release date revival album^rapper cardi b confirms secretly married beau offset nine months ago^watch ellen degeneres hilariously spoofs taylor swift 'look what you made me do video^kelly clarkson host billboard music awards^princeharry meghanmarkle wedding florist flowers revealed^oscars here complete list winners^jennifer garner ben affleck officially file divorce,10,9,-1,19,0.5263157894736842,-0.05263157894736842,1
289998339,HuffPostCanada,2261,395426,3670,240914,0,0,12,7,informing engaging amplifying canadians breaking news analysis opinion dms open or email us canada.com,here kate middleton left hospital soon giving birth^the internet happy margot robbie interview^the internet happy margot robbie interview^trump defends beautiful confederate statues taken^a timeline meghan markle prince harry relationship^gwen stefani 'went white blake shelton revealed split^gwen stefani 'went white blake shelton revealed split^channing tatum jenna dewan tatum announce separation love filled note^nikki reed nina dobrev squash bad blood rumours^paris fashion week attendees blame kim kardashian robbery^prince harry meghan markle got many australians very excited^prince harry helped meghan markle pick tiara royal wedding^portia de rossi says steven seagal unzipped pants audition^ashley judd sues harvey weinstein defamation sexual harassment^joel taylor star discovery channel storm chasers dead^prince harry wanted royal family^meghan markle brings blue jays pride pippa middleton wedding^katharine mcphee david foster originally met american idol engaged^weinstein company file bankruptcy sale talks collapse,12,7,-5,19,0.631578947368421,-0.2631578947368421,1
15735744,marieclaireuk,3246,291529,2525,231367,0,0,13,6,breaking news inspiring fashion provocative features luxurious beauty hottest insider info welcome marie claire uk,jennifer lawrence elains split darren aronofsky^why queen apparently livid prince william kate middleton^prince harry revealed considered leaving royal family^you believe actor officially set play prince charles the crown^robert pattinson kristen stewart fail avoid paparazzi secret la date ...^check pics robert pattinson amp kristen stewart secret wedding date^i tried kim kardashian diet two weeks results i eected^chris pratt anna faris still living together despite divorce^hermione granger made clear donald trump welcome harry potter cursed child^the internet freaking kate middleton subtle hint babies^angelina jolie brad pitt love high street shopping spree much next person ...^angelina jolie brad pitt love high street shopping spree much next person ...^selena gomez feeling empowered completing treatment anxiety depression^david schwimmer wife zoe buckman taking time apart^kensington palace addresses rumours meghan markle dad may attend royal wedding^kensington palace addresses rumours meghan markle dad may attend royal wedding^is meghan markle n't pippa middleton wedding^ben affleck moves family home shared jennifer garner^ben affleck jennifer garner officially file divorce,13,6,-7,19,0.6842105263157895,-0.3684210526315789,1
25977992,Pressparty,1685,26191,656,522589,0,0,15,4,global music entertainment press releases register,justin bieber admits life road 'lonely depressing^justin bieber admits life road 'lonely depressing^justin bieber admits life road 'lonely depressing^justin bieber admits life road 'lonely depressing musicnews^justin bieber admits life road 'lonely depressing^justin bieber admits life road 'lonely depressing^justin bieber admits life road 'lonely depressing^justin bieber admits life road 'lonely depressing^justin bieber admits life road 'lonely depressing^justin bieber admits life road 'lonely depressing^justin bieber admits life road 'lonely depressing^justin bieber admits life road 'lonely depressing^the crown reveal play queen mother prince charles^country singer carrie underwood wed ice hockey star mike fisher lavish ceremony georgia saturday july^john mayer taken aim thehuffingtonpost.com publishing article suggesting jennifer aniston back together^official press release announces the man of the woods tour^official press release grammy award winning superstar announces year las vegas residency starting dec^meryl streep joins big little lies season^the e people choice awards air countries month,15,4,-11,19,0.7894736842105263,-0.5789473684210527,1
9235982,dailytelegraph,14700,192654,2494,218135,0,1,16,2,follow breaking news sydney nrl news sport entertainment business we retweet journalists,four eateries one sydney area named shamed nsw food authority breaches cleanliness^she posh spice last time dropped sydney spiceworld the movie victoria beckham designe^prince harry reveals wanted leave royal family struggled leaving army^sofia richie hitting harbour city week representatives forced backflip ridiculo^meghan duchess sussex gets discount designer duds say fashion industry insiders via^sofia richie hitting harbour city week representatives forced backflip ridiculo^meghan duchess sussex gets discount designer duds say fashion industry insiders via^taylor swift blasts bully kim kardashian^want little darling look like prince princess follow lead catherine duchess cambridge and^want little darling look like prince princess follow lead catherine duchess cambridge and^desperate former bachelor star tiffany scanlon hit warner bros convincing would cast t^video footage emerged moment meghan markle stunned nearly tripped wedding prince^they close kardashians seems kendall kylie jenner keeping rest fa^sofia richie hitting harbour city week representatives forced backflip ridiculo^sofia richie hitting harbour city week representatives forced backflip ridiculo^reese witherspoon furious co star nicole kidman failing promote big little lies^prince harry spoken often missing mother diana especially celebrating big moments li^prince harry asks older brother prince william best man^meghan markle prince harry starting new life together delayed honeymoon could a,16,3,-13,19,0.8421052631578947,-0.6842105263157895,1
21667364,New1027,679,13832,365,48361,0,0,18,1,on-air -10a a-3p -7p p-12a stream us w/ app,selenagomez scared drop another album i really happy revival time i te^look what you made me do hit million likes youtube this taylorswift nd video^arianagrande rattles names women inspire i '90s baby whitney mariah madonna all^arianagrande lists females inspire i baby whitney mariah madonna all^on th this month get takitaki djsnake cardib selenagomez ozuna rt 're excited for^which upcoming collab excited zedd amp katyperry dualipa amp blackpink normani amp nickiminaj^which new song excited new ladygaga bradleycooper latest prettymuch all^which upcoming song excited dinahjane bottled up prettymuch solita djsnake cardib^today year anniversary wolves the hit single sold m copies worldwide accumulated^erica hackensack says year old daughter asking 'make radio play despacito erica got you^when luke bryan asked americanidol contestant who look artist guy responded^mariah carey elains nye disaster listen guys foiled ...^get engaged wilmer valderrama birthday^on th this month get takitaki djsnake cardib selenagomez ozuna rt 're excited for^which upcoming collab excited zedd amp katyperry dualipa amp blackpink normani amp nickiminaj^which new song excited new ladygaga bradleycooper latest prettymuch all^which upcoming song excited dinahjane bottled up prettymuch solita djsnake cardib^when luke bryan asked americanidol contestant who look artist guy responded^when i really skinny i wanted kill myself. clarkson says industry execs urged weight loss early on,18,1,-17,19,0.9473684210526316,-0.8947368421052632,1
15513604,foxandfriends,1077,1338552,8255,93860,0,17,1,0,america cable morning news show,email us videos/pics your little ones reciting pledge allegiance email friends.com^we live greatest nation face earth. shares independenceday message^watch our full interview rudy giuliani^watch part president exclusive interview fox amp friends^donald trump succumb media pressure he fights right back weighs president s^ex fbi lawyer lisa page appears capitol hill closed door interview^if rod rosenstein agree record interview soon i issue subpoena^watch part president exclusive interview fox amp friends^watch part president exclusive interview fox amp friends^lisa page appear capitol hill closed door interview house judiciary oversight committees^watch part president exclusive interview fox amp friends^previews one one interview piers morgan airing tonight thestory^putin denies dirt president trump calls meddling charge utterly ridiculous foxnews interview^vp joe biden set make statement rose garden president obama attendance^the president deliver statement iran negotiations rose garden :15pm/et^who supposed support hillary clinton reacts sen. bob corker saying gop cult li^fox news alert one u.s. soldier killed four wounded enemy attack somalia^welcome clooney twins george clooney wife amal welcome twins ella alexander,1,17,16,18,0.05555555555555555,0.8888888888888888,0
16425419,ksatnews,854,236032,1304,190461,0,12,1,5,news ksat12 also see follow weather updates,the u.s. centers disease control prevention said thursday people gotten sick multist^a study centers disease control prevention found percent visits children made th^do chickens read warning us centers disease control prevention^the campaign latest quarterly federal election commission filing shows one fifth 3.9 million th^rudy giuliani said wants negotiations presidential interview special counsel robert mueller co^at republican national committee summer meeting austin controversy enshrouding president larg^the former mistress former republican national committee finance chairman elliott broidy suing failin^a study centers disease control prevention found percent visits children made th^do chickens read warning us centers disease control prevention^:30pm ksat interview former president george w. bush wife laura bush^with thanksgiving around corner u.s. department agriculture food safety inspection service h^just in four people unaccounted one person critically injured apartment fire san marcos^many social media saying kylie jenner stole spotlight super bowl released pregnanc^actor miles teller reportedly arrested drunk public ksatnews^star tv 'touched angel legendary singer della reese dead ksatnews^roger ailes former ceo fox news dead ksatnews^online reports say year old kylie jenner pregnant^the rumors true april giraffe whose pregnancy became internet sensation pregnant,1,17,16,18,0.05555555555555555,0.8888888888888888,0
16247383,abc13houston,2426,757166,3305,341970,0,3,2,13,abc13 houston news leader your number one source breaking news hours day/7 days week,according centers disease control prevention diseases tick bites rise but ar^this morning 'this week tragedy pittsburgh abc news via^this day in houston claimed victory presidential election staging speech three deca^angelina jolie brad pitt committed act united front abc13^bishop michael curry became star stirring minute sermon royal wedding prince harry and^actor james franco denies sexual misconduct allegations^actor james franco denies sexual misconduct allegations^the studio city house featured the brady bunch sale piece hollywood history yours^actor vince vaughn arrested suspicion dui california^actor vince vaughn arrested suspicion dui^vince vaughn arrested suspicion dui california^vince vaughn arrested suspicion dui california^chris cornell ended last performance life song death his final performance^meghan markle dad may attend royal wedding^meghan markle says dad attend royal wedding^richard simmons hospitalized due severe indigestion discomfort eating days abc13^richard simmons hospitalized due severe indigestion discomfort eating days abc13^richard simmons hospitalized due severe indigestion discomfort eating days abc13,2,16,14,18,0.1111111111111111,0.7777777777777778,0
7663702,fox32news,857,121283,2313,142218,1,14,1,2,fox news got covered breaking news weather traffic politics investigations join conversation fox32news,family private investigator there evidence seth rich contact wikileaks prior death^at least cases confirmed states year amp least additional illnesses states are^you would think would common sense reuse condoms apparently enough problem cen^some troubling trends emerging show life eectancy americans dropping the centers disease^heads up if thanksgiving leftovers refrigerator time throw them away according to^chicago firefighters lay walter patmon jr. rest apostolic church god today watch us live^who else ready sunday bearsunleashed break tonight fox news.^at least cases confirmed states year amp least additional illnesses states are^you would think would common sense reuse condoms apparently enough problem cen^some troubling trends emerging show life eectancy americans dropping the centers disease^heads up if thanksgiving leftovers refrigerator time throw them away according to^police report drop homicides shooting victims chicago^chicago police join candlelight vigil victims mercy hospital shooting^michelle obama referred forever first lady speech high school seniors today thoughts^breaking update new photo helicopter crashed near th bishop ford chicago south side four peopl^tmz kylie jenner pregnant travis scott baby^end of an era pioneering aol instant messenger discontinued years service^rest in peace wwe star vader dead,2,16,14,18,0.1111111111111111,0.7777777777777778,0
5988062,TheEconomist,121,24058142,113159,188435,2,15,1,0,news analysis global perspective subscribe,our predictive model november elections us house representatives updated daily^obituary george h.w bush died november th^a book excerpt interview jeffrey pfeffer stanford university author dying paycheck^in interview the economist japan prime minister shinzo abe said population declining a^what fascism an interview madeleine albright openfuture^an interview steve bannon^transcript interview general mark hicks^giuseppe porcaro imagines tinder style app replaces elections policy suggestions in book excerpt and^what john mccain legacy anne mcelvoy senior editor recalls interview political noncon^an interview bjorn abba^the output g7 summit quebec confusing say least read interview justin trudeau here^... un high commission refugees partners received less funds need th^the figure president always unstable one changed state union represented^what john mccain legacy anne mcelvoy senior editor recalls interview political noncon^is america longer shining city upon hill we sit interview listen^what john mccain legacy anne mcelvoy senior editor recalls interview political noncon^just one four americans bottom earnings receive employer provided health insurance^in press conference july th donald trump announced economy grew amazing a pinch salt is,3,15,12,18,0.16666666666666666,0.6666666666666666,0
624413,MarketWatch,190,3649257,24582,283191,0,11,3,4,news personal finance commentary marketwatch,donald trump latest description kim jong un interview fox news he speaks people sit i^trump calls kim jong un great negotiator interview fox news north korea one repressive au^the social security trustees report contains surprises^the last time trump spoke lawmakers house chamber state union like address joint ses^don overlook bush domestic legacy sununu writes beto o rourke barack obama meet^john mccain legacy words^u.s. trade deficit goods narrows uneectedly may^walmart sent letter u.s. trade ambassador robert lighthizer warning proposed tariffs 200 billion^walmart sent letter u.s. trade ambassador robert lighthizer warning proposed tariffs 200 billion^u.s. trade deficit goods widens 72.2 billion july^walmart sent letter u.s. trade ambassador robert lighthizer warning proposed tariffs 200 billion^kellyanne conway america go buy ivanka stuff ... i going give free commercial go buy today^kellyanne conway america go buy ivanka stuff ... i going give free commercial go buy today^nbc taps hoda kotb replace matt lauer 'today co anchor^tony awards full list winners^happy halloween here map popular candy state^happy halloween here map popular candy state^happy halloween here map popular candy state,3,15,12,18,0.16666666666666666,0.6666666666666666,0
3888351,fox6now,2027,80560,1192,275667,0,9,3,6,witi-tv fox6 news our twitter account managed web team have news tip e-mail fox6news.com,selection committee democratic national convention headed milwaukee visit^selection committee democratic national convention headed milwaukee visit^five takeaways democratic presidential debate new hampshire^hillary clinton orlando mass shooting americans must tand together^selection committee democratic national convention headed milwaukee visit^selection committee democratic national convention headed milwaukee visit^watch live president trump campaign rally las vegas^politics obama hits clinton on nafta support barack obama accused democratic presidenti..^politics obama hits clinton on nafta support barack obama accused democratic presidenti..^just in prince harry meghan markle wed may^david cassidy fighting memory loss wants 'enjoy life^north korea vows strikes us president trump warns fire fury^ellen degeneres cries receiving best birthday gift portia de rossi^ellen degeneres cries receiving best birthday gift portia de rossi^talked moments super bowl history^meghan markle prince harry reveal details wedding cake^fiona baby hippo dad henry dies we sad lose^reports say kylie jenner pregnant first child,3,15,12,18,0.16666666666666666,0.6666666666666666,0
16027904,TheAVClub,1141,459638,8720,140263,0,1,4,13,pop culture obsessives writing pop culture obsessed newswire,in land dinosaurs dragons monster hunter world makes apex predator^hannibal buress arrested disorderly intoxication miami last night^sean penn saddest astronaut trailer hulu the first^it p.m. batman day let watch george clooney profusely apologize killing dark knight^short fingered vulgarian donald trump thinks stephen colbert filthy^arrow colton haynes joins american horror story season^beyonc turned small role live action beauty and the beast movie^paul bettany talks the crown new prince philip^jason bateman officially signed arrested development season^portia de rossi says steven seagal unzipped leather pants private audition her^sza says may permanent vocal chord damage^we predicting die next week thewalkingdead^the originals end season^the originals end season^leonardo dicaprio star but charles manson in quentin tarantino manson family movie^leonardo dicaprio star but charles manson in quentin tarantino manson family movie^taylor swift announces new album reputation^after attempts sale weinstein company prepares file bankruptcy,4,14,10,18,0.2222222222222222,0.5555555555555556,0
28152330,fox13,6968,143007,1481,166851,1,8,3,6,fox news kstu salt lake city 801 -1313. news.com,melania trump undergoes kidney surgery walter reed medical center^the us women open two hole playoff fox news five may begin late sunday result enjoy the^note fox news five may begin late sunday could potentially air due nascar coverage th^watch fox news nine sunday latest josh holt release family anticipated return utah.^note fox news five probably begin late sunday due coverage us women open gon^note fox news five air sunday due coverage nascar cocacola600 enjoy race and^these victims chicago mercy hospital shooting^these victims chicago mercy hospital shooting^these victims chicago mercy hospital shooting^prince harry meghan markle wed may^bill cosby jurors give conflicting accounts deadlock^salt lake city police arrest man outside press conference announces excessive force lawsuit^ryan seacrest kelly ripa new co host live sources say^ryan seacrest kelly ripa new co host live sources say^former mtv vj jesse camp reported missing california^'storm chasers star joel taylor dead^'game thrones stars kit harington rose leslie married^fiona baby hippo dad henry dies,4,14,10,18,0.2222222222222222,0.5555555555555556,0
264868217,931freshradio,342,5546,123,60211,0,0,4,14,barrie hit music station your favourite song probably playing fresh right representing simcoe county let tweet,do n't worry jenniferlopez looks like mariahcarey n't know demilovato either philys^brad pitt jennifer lawrence leonardo dicaprio fighting money owed weinstein company^justin bieber says religion et free bondage shame^taylor swift alleged stalker arrested knife rope outside singer home^rachel mcadams welcomes first child boyfriend jamie linden report^kermitthefrog getting new voice years philys^prince harry meghan markle official wedding portraits revealed^john oliver blame meghan markle calling royal wedding^justin timberlake announces new album man woods^christina aguilera done the voice forever^julia louis dreyfus diagnosed breast cancer^fuller house has been renewed season^after two months dating nick jonas priyanka chopra engaged^celine dion poses naked vogue magazine^taylor swift announces new album reputation release date^the weeknd beyonce eminem headline coachella^daniel craig confirms play james bond^royal wedding prince william prince harry best man,4,14,10,18,0.2222222222222222,0.5555555555555556,0
87775422,ChinaDaily,510,4278133,5952,103590,4,12,1,1,inspiring constructive dialogue china us join conversation,"us president donald trump said willing work across aisle democrats house representati^us president donald trump told republican lawmakers would back either immigration bills making wa^the us house representatives tuesday approved another stopgap bill keep federal government shutt^latest the top republican us house representatives paul ryan said wednesday house would vote^in interview fox news mnuchin said economic trade consultations us china th^us president donaldtrump made target criticism attacking globalism touting america first^the us department education announced withdrawing series obama era documents promoting racial di^us department education office civil rights launched investigation way university south^cotton produced states texas produces followed georgia mississippi in us pro^the us department agriculture celebrated asian american pacific islander heritage month luncheon fea^as china moves contain outbreak african swine fever us department agriculture taken steps k^the passion profession consideration service attitude skills really beyond imagination^tariffs 34 billion chinese goods scheduled take effect :01 friday washington us trad^the us administration tariffs chinese products extended 200 billion goods september forc^breaking us tariffs 200 billion chinese goods take effect trade^in move step pressure japan cut trade surplus united states us vice president mike penc^a guest wedding prince harry meghan markle sold free goodie bag received ,400 pound^italian tire maker pirelli recently revealed behind scenes images calendar photo shoot model g",5,13,8,18,0.2777777777777778,0.4444444444444444,0
203123011,CTVNews,327,783283,4495,185623,0,10,5,3,tweeting breaking news ctvnews.ca ctv national newsroom rts constitute endorsement views,principal greg reeves st. michael college toronto read prepared statement took questions med^live now alberta premier rachel notley delivers speech rural municipalities alberta fall convention^the debate u.s. immigration continues even trump backed family separation policy^in words read complete transcript ap interview u.s. president donald trump^live now white house briefing press secretary sarah sanders uspoli^live soon white house briefing press secretary sarah sanders uspoli^live p.m et white house briefing press secretary sarah sanders uspoli^live now secretary state mike pompeo answers questions north korea summit white house press b^live now white house press briefing sarah sanders^former u.s. first lady michelle obama deliver speech montreal^icymi prince harry meghan markle wed may^breaking prince harry meghan markle wed may^fact vs. fiction majority 'best picture nominations year oscars based true events^mariah carey new year eve performance 'they foiled^prince harry meghan markle tied knot windsor castle four people t^jada pinkett smith calls tupac biopic 'deeply hurtful^vince vaughn arrested suspicion dui^pregnant april giraffe calf due march,5,13,8,18,0.2777777777777778,0.4444444444444444,0
13001192,kare11,672,346848,2330,165443,0,1,5,12,kare news kare app places go news weather sports traffic part teamtegna,statement bca makes clear agency intend release body camera video fatal police shoo^go buy ivanka stuff pitch lands kellyanne conway hot water btn11^want win tickets see jennifer lopez week kare sunrise covered sunriseatmoa^mom knows best congratulations patrick jack two tickets jennifer lopez concert morning^take list best things beyonce never reports say 'll diva super bowl halftime show^emmy awards the winners list^ex 'dance moms star abby lee miller sentenced year prison^ex 'dance moms star abby lee miller sentenced year prison^scott baio wife renee reveals microvascular brain disease diagnosis^report meghan markle dad longer attend royal wedding^'nypd blue creator steven bochco dead^reports priyanka chopra nick jonas engaged two months dating^reports priyanka chopra nick jonas engaged two months dating^reports priyanka chopra nick jonas engaged two months dating^wwe star vader dead age^no surprise prince william prince harry best man royal wedding^reports jennifer garner ben affleck officially file divorce^april giraffe pregnant,5,13,8,18,0.2777777777777778,0.4444444444444444,0
16285710,WISH_TV,1740,199105,1550,206999,4,11,1,2,news headlines information indianapolis central indiana,listen curious robocall seeks damaging information moore^breaking first lady melania trump undergoes kidney surgery walter reed medical center^watch ohio officials speaking people found dead including two children^watch ohio officials speaking people found dead including two children watch^the centers disease control prevention warning parents rare condition called acute flaccid myelitis^the centers disease control prevention says appears number cases polio like illness called a^the flu vaccine last year percent effective according centers disease control pre^the centers disease control prevention says popular kellogg cereal linked salmonella outb^president donald trump asked republican national committee chairwoman ronna mcdaniel serve second term.^the centers disease control prevention warning parents rare condition called acute flaccid myelitis^the centers disease control prevention says appears number cases polio like illness called a^the flu vaccine last year percent effective according centers disease control pre^according u.s. department agriculture soybean corn yields time high hoosier fa^breaking four teens shot party inside lions club clubhouse friday night lawrence police said.^facebook live news reports west side neighborhood police initially said four people^katie couric matt lauer today co host several years broke silence saturday sexual miscondu^breaking singer demi lovato hospitalized suffering apparent heroin overdose^britain royal officials say prince harry asked elder brother prince william best man wedding nex,5,13,8,18,0.2777777777777778,0.4444444444444444,0
50271716,ieEntertainment,1024,225390,356,104549,0,0,6,12,follow us latest bollywood hollywood tv south cinema web series much,angelina jolie accuses brad pitt paying enough child support children^georgeclooney wife amal welcome twins announce hilarious statement^angelinajolie split bradpitt i enjoy single^angelinajolie split bradpitt i enjoy single^kristenstewart goes romantic date girlfriend alicia cargile^selfie obsession ridiculous^willing work quentin tarantino^whiplash actor teller arrested drunk public denies claims^james woods reports retirement greatly exaggerated^mattdamon apologizes comments sexual misconduct^mattdamon apologizes comments sexual misconduct^bigbangtheory star kaleycuoco marries karlcook adorable wedding photos^michael fassbender alicia vikander married^priyanka chopra nick jonas got engaged august presently enjoying vacation texas^priyankachopra american singer nickjonas engaged here photos^throws gypsy themed birthday party^american tv show host jokes emilyblunt might sociopath^the final season gameofthrones premieres april,6,12,6,18,0.3333333333333333,0.3333333333333333,0
17526930,marcmalkin,1537,73089,1604,41285,0,0,7,11,senior film awards events lifestyle editor host the big ticket podcast,good morning princeharry meghanmarkle wed may^more comer on legally blonde world neeeds rom coms ...^angelina jolie vanity fair cover story vanity fair^angelina jolie vanity fair cover story vanity fair^matt bomer really proud wentworth miller coming out gay via^selena gomez sad about justin bieber breakup says source^robertpattinson has not canceled cosmopolis publicity because of cheating scandal says rep^eva longoria talks marriage pregnancy rumors more via^tony awards complete list nominations via tonyawards^you can own pair anna wintour signature chanel sunglasses^you can own pair anna wintour signature chanel sunglasses^why ren e zellweger disappeared from hollywood via^go jennifer hudson joins 'the voice coach season via^cool host video music awards via^omg announces dates two different las vegas residency shows via^chris pratt gushes over perfect anna faris jokes about his ''boob sweat '' via^billboard music awards nominations the full list^lena dunham joins american horror story season via,7,11,4,18,0.3888888888888889,0.2222222222222222,0
330826792,rapplerdotcom,404,3129108,4135,604321,2,9,6,1,the social news network uncompromised journalism inspires smart conversations thirst change,aklan soon two legislators house representatives presidentduterte signed ra reapportio^alvarez we undo past certainly shape future the house representatives h^watch none family members want give statement || via^sereno reacts duterte statement westphsea already possession china president duterte^watch cambe refuses make statement convicted plunder via^robredo the issues face comes west philippine sea fishermen about^friends friends enemies enemies worse enemies false friends read full speech dfa secretar^friends friends enemies enemies worse enemies false friends read full speech dfa secretar^happening now presidentduterte delivers speech th annual national convention vice mayors league^ahead sona2018 labor groups union leaders various industries convened manila give state t^ahead sona2018 labor groups union leaders various industries convened manila give state t^trump warns north korea 'fire fury full story^trump warns north korea 'fire fury full story^the philippine tax whiz answers frequently asked questions self employed individuals professionals.^prince william camilla duchess cornwall catherine duchess cambridge royalwedding live update^prince william camilla duchess cornwall catherine duchess cambridge royalwedding live update^us presenter oprah winfrey arrives wedding ceremony britain prince harry duke sussex^us reports say pregnant first child,8,10,2,18,0.4444444444444444,0.1111111111111111,0
26774034,peoplestyle,1124,932601,5927,46198,0,0,8,10,every star every t-miss style moment every day from editors instagram people style snapchat peoplestyle,sofia richie celebrated end teens neon bikini pic^sofia richie celebrated end teens neon bikini pic^kourtney kardashian post breakup girls night larsa pippen^kourtney kardashian post breakup girls night larsa pippen^kim kardashian secretly modeling kanye west jewelry line months^you asked found alessandra ambrosio flowy skirt^sofia richie celebrated end teens neon bikini pic^sofia richie celebrated end teens neon bikini pic^believe ... almost springbreak your ultimate packing list^outlander star caitriona balfe engaged see gorgeous ring^victoria secret i take clothes anymore empty cause^anna wintour daughter bee shaffer engaged late vogue italia editor son francesco carrozzini^anna wintour daughter bee shaffer engaged late vogue italia editor son francesco carrozzini^how princess eugenie wedding dress compares kate middleton meghan markle gowns^billionaire matthew mellon ex husband jimmy choo tamara mellon dies mexican rehab report^billionaire matthew mellon ex husband jimmy choo tamara mellon dies mexican rehab report^all details dwts star jenna johnson must see diamond engagement ring val chmerkovskiy^celeb inspired holiday outfit idea be suit tie,8,10,2,18,0.4444444444444444,0.1111111111111111,0
27037643,oyeakd,796,5385,51,158311,0,0,8,10,blogger senior editor co-founder fan music addict,fergie and husband josh duhamel split after years of marriage^get familiar ellen degeneres agrees to go to marriage therapy to save marriage to portia de rossi^ellen degeneres agrees to go to marriage therapy to save marriage to portia de rossi^here are the winners of the critics choice awards full list^get familiar ellen degeneres agrees to go to marriage therapy to save marriage to portia de rossi^ellen degeneres agrees to go to marriage therapy to save marriage to portia de rossi^kim kardashian kanye west secretly got married^get familiar kim kardashian kanye west secretly got married^black panther stranger things infinity war among nominees for mtv movie amp tv awards see full list^cma awards here the complete list of winners^bill cosby found guilty sexual assault retrial^complete nomination list for the tony awards as bradley cooper helen mirren and carey mulligan lead the pack^get familiar complete nomination list for the tony awards as bradley cooper helen mirren and carey mulliga ...^sag awards here the complete list of winners^fergie and husband josh duhamel split after years of marriage^the originals comes to an end after seasons^serena williams withdraws from australian open^reasons why renewed season by netflix,8,10,2,18,0.4444444444444444,0.1111111111111111,0
12848262,TorontoStar,544,975635,8035,275079,1,4,9,4,get latest news alerts sports photos canada largest daily newspaper -800-279-0181 instagram thetorontostar,rt to school board shutting snapchat netflix instagram schools due network demand this https^breaking well known public face nation largest public transit agency past decade^the teamsters international brotherhood electrical workers told cprail posi^trump top economic adviser larry kudlow told fox news sunday tariff battle mere family quarrel an^since late four military pilots charged drunk driving two disciplined foll^is meghan markle already miserable royal we tongue cheek scoop tabloids^meghan markle powering bucket list become famous check marry prince check start making babie^did brad pitt jennifer aniston backyard commitment ceremony will drake marry ariana grande pete dav^summon trumpeters town criers meghan duchess sussex child you heard first that^according life amp style cover a good old fashioned feud insiders say reese witherspoon nicole kidman we^drake says victim fake media story rumours surfaced saying told fan take hijab^it epidemic marital mayhem mila kunis supposedly opens struggles julia roberts allegedly t^summon trumpeters town criers meghan duchess sussex child you heard first that^they foiled mariah carey speaks says new year eve performance sabotaged^tiger woods arrested dui charge florida^actress paz de la huerta accuses harvey weinstein raping twice^in comedian said standup act bill cosby lot rape allegations ... when^did know meghan markle brief case carrying model deal no deal howie mandel ca n't remembe,10,8,-2,18,0.5555555555555556,-0.1111111111111111,1
2962207881,MediaGuide_NG,207,25045,81,122152,0,0,10,8,content guide provider nigeria media consumers || tv radio cinema event || mg.ng,kanye west shares proof that he is on good terms with caitlyn jenner gt gt^keeping kardashians red carpet.. slay mtvawards^kanye west and nick cannon squash their recent beef over kim kardashian gt gt^keeping kardashians red carpet.. slay mtvawards^live kelly ryan show hosts kellyripa amp ryanseacrest channelling inner khaleesi jaime lanni^golden globes awards full list of winners^via prince william catherine duchess cambridge appear outside st. mary hospital third^via prince william catherine duchess cambridge appear outside st. mary hospital third^the kardashians via mediaguidestyle mediaguidetv kimkardashian kourtneykardashian krisjenner^kanye west and nick cannon squash their recent beef over kim kardashian gt gt^kerry washington launches 13 eye shadow palette everyday makeup gt gt^donald trump star on the hollywood walk of fame has been vandalized yet again^khloe kardashian is distraught tristan thompson alleged cheating reports gt gt^meghan markle deletes her facebook instagram and twitter accounts gt gt^billboard music awards check complete list winners gt gt^tv host wendy williams reveals graves disease diagnosis gt gt^drake tops the nomination list of billboard music awards see full list nominees^billboard music awards check complete list winners gt gt,10,8,-2,18,0.5555555555555556,-0.1111111111111111,1
14684826,msnuk,3202,23124,248,85917,0,0,11,7,all best content msn like us facebook follow friends,files divorce from anna faris^brad pitt 'apologises jennifer aniston 'absentee husband leaving angelina jolie^josh duhamel differences were 'a factor split 'this has been long time coming says source^reveals heartbreaking reason she split taylor kinney^brad pitt 'apologises jennifer aniston 'absentee husband leaving angelina jolie^brad pitt 'apologises jennifer aniston 'absentee husband leaving angelina jolie^i enjoy single hard angelina jolie^dakota johnson chris martin are 'definitely dating details^kate middleton prince william host play dates prince george anmer hall^is kate hudson brad pitt twins^brad pitt devastated deaths close pals chris cornell brad grey^'rushed hospital accident london home^jennifer lawrence boyfriend darren aronofsky arrive italy venice film festival see pics^does photo prove amelia earhart survived final flight^the big bang theory jim parsons opened waited long get married^jennifer lawrence says she wants take break acting milk goats farm^sir roger moore james bond star dead following hort brave battle cancer^files divorce from anna faris,11,7,-4,18,0.6111111111111112,-0.2222222222222222,1
21751545,all4women,1486,9072,243,47379,0,0,11,7,south africa online women magazine competitions galore new articles day love food home fashion celeb news health much,jennifer aniston justin theroux reportedly reached agreement custody dogs.^jennifer aniston justin theroux reportedly reached agreement custody dogs.^khlo wants nothing caitlyn jenner iamcait khloe kardashian celebs^'charmed actress shannen doherty revealed elevated markers tumor scan breast cancer^yay is jennifer aniston finally pregnant^chris martin dakota johnson added fuel rumours dating spotted date mal^katy perry praised taylor swift songwriting skills responded american idol contestant apology for^kourtney kardashian set launch range cosmetics rival sisters kim kardashian west kylie^prince william really supportive duchess catherine decision home birth anmer hall norfolk^kylie jenner recharging batteries spotlight prepares welcome first child.^katy perry praised taylor swift songwriting skills responded american idol contestant apology for^enrique iglesias anna kournikova welcome twins celebbabies^khloe kardashian reportedly living newborn baby daughter true reportedly kicked he^ed sheeran gotten engaged longterm girlfriend cherry seaborn star announced social media.^a wrongful death lawsuit jim carrey suicide late ex girlfriend cathriona white dismis^julia louis dreyfus diagnosed breast cancer^khloe kardashian reportedly n't ready give romance tristan thompson accused of^sean penn robin wright son hopper reportedly arrested drug possession ...,11,7,-4,18,0.6111111111111112,-0.2222222222222222,1
156464691,7NewsSydney,224,314261,1442,208678,2,4,10,2,first for news sydney mclaughlin,former u.s president died age news^the st president united states died age he hospitalised low bloo^appearance g.7 summit world leaders canada far unifying even refusing to^statement police responding incident bourke street members public asked^a police officer two victims killed mass shooting chicago hospital earlier today poli^returned field australian soil darwin four months one year ban follo^reality star returned talk prison reform make case another con^the royal family commemorated anzac day prince william leaving wife new baby home pay his^prince philip skipped royal family traditional easter sunday service leaving queen attend with^the duchess cambridge cemented place fashion icon she named year top royal style inf^amal george clooney welcome twins ella alexander news^amal george clooney welcome twins ella alexander news^thrilled fans perth first performance taylorswift news^if royal family feeling angst wedding prince harry meghan markle would n't know b^the 'oprah president speculation continuing her close friend says winfrey intrigued^the beckhams climbed harbour bridge ticking bucket list item trip sydney david beck^judge declares mistrial sexual assault case jury says hopelessly deadlocked news^in royal wedding bombshell morning meghan markle father decided walk aisle w,12,6,-6,18,0.6666666666666666,-0.3333333333333333,1
173620667,YNaija,855,186766,472,452531,0,0,12,6,ideas issues culture smartest young nigerians read for opeds stories people helping communities -info.com,rt enough how anna wintour banned kim kadarshian mother vogue ball^new post enough how anna wintour banned kim kadarshian mother vogue ball^new post enough how anna wintour banned kim kadarshian mother vogue ball^kylie jenner pregnant travis scott baby^george clooney wife amal welcome twins^george clooney wife amal welcome twins^here full list winners golden globes awards^here full list winners golden globes awards^entertainment roundup celebrities react death linkin park singer chester bennington davido shows ...^diss justin bieber sparks outrage comments prince william balding hairline^diss justin bieber sparks outrage comments prince william balding hairline^new post diss justin bieber sparks outrage comments prince william balding hairline^the film blog complete winners list sag awards^the film blog complete winners list sag awards ynaija^everything know meghan markle engagement ring steps prince harry^entertainment roundup full list nominations year billboard music awards charly boy hospitalised^the film blog black panther most tweeted about movie all time^judge declares mistrial bill cosby sexual assault case,12,6,-6,18,0.6666666666666666,-0.3333333333333333,1
271413771,HuffPostUK,2177,207149,3580,291872,0,1,15,2,know real,watch live former us vice president joe biden london giving speech foreign policy^donald trump warns 'fire fury north korea escalates nuclear threat^thecrown confirms josh o'connor series three prince charles^katy perry ca n't resist throwing shade taylor swift mentioned 'american idol^'harry potter star noma dumezweni says donald trump welcome 'cursed child audience^prince harry meghan markle moving windsor becoming parents palace confirms^prince harry meghan markle moving windsor becoming parents palace confirms^if meghan markle shoes moving uk marrying prince harry piece advi^jennifer aniston justin theroux 'lovingly split amicable divorce^billy connolly wife pamela stephenson labels michael parkinson daft old fart suggesting comedian brain^billy connolly wife pamela stephenson labels michael parkinson daft old fart suggesting comedian brain^billy connolly wife pamela stephenson labels michael parkinson daft old fart suggesting comedian brain^billy connolly wife pamela stephenson labels michael parkinson daft old fart suggesting comedian brain^selena gomez reveals kidney transplant^angelina jolie gwyneth paltrow others say harvey weinstein harassed^katy perry ca n't resist throwing shade taylor swift mentioned 'american idol^former usa gymnastics team doctor larry nassar sentenced years prison child sexual abuse^meghan markle dad ca n't attend royal wedding heart operation reports,15,3,-12,18,0.8333333333333334,-0.6666666666666666,1
186933748,baphometx,252,4957,394,514557,0,1,15,2,net gr,is democracy safe age big data an interview christopherwylie whistleblower on^rachel weisz 'my parents refugees brexit feels like death^rachel weisz 'my parents refugees brexit feels like death^rachel weisz 'my parents refugees brexit feels like death^rachel weisz 'my parents refugees brexit feels like death^rachelweisz 'my parents refugees brexit feels like death^julia roberts jim carrey emma stone hollywood stars takeover tv^steven spielberg meryl streep trump news why 'the post had be made now everyone i know is scared^baftas full list winners film the guardian eebaftas bafta2017^destroyer review nicole kidman takes no prisoners badass detective karyn kusama twisty l.a. noir^boy erased review lucas hedges nicole kidman lead joel edgerton powerful gay conversion drama^julia roberts jim carrey emma stone hollywood stars takeover tv^suspiria review lucaguadagnino horror remake is grim glorious work madness^a star is born review lady gaga mesmerises streisand shoes bradley cooper directs co stars out^margotrobbie amp matthiasschoenaerts star world war ii thriller ruin^woody allen casts elle fanning timoth e chalamet selena gomez for new amazon feature^leonardo dicaprio star quentin tarantino charles manson movie^leonardo dicaprio star quentin tarantino charles manson movie the oscar winner play aging actor i,15,3,-12,18,0.8333333333333334,-0.6666666666666666,1
1461673338,Kiss100kenya,529,260028,139,232858,1,0,15,2,your number hit music station whatsapp no,rip former us president george hw bush died age^karrueche tran finally granted five year restraining order against ex chris brown^karrueche tran finally granted five year restraining order against ex^kylie jenner admits she made her lips too big in allure magazine interview^kylie jenner admits she made her lips too big in allure magazine interview^meghan markle fathersays miserable marriage^meghan markle father says miserable marriage^admits she jealous of sister^did cause why kanye west left social media again^miley cyrus liam hemsworth cancel honeymoon to bora bora^confirms relationship with new boyfriend the cutest way^karrueche tran finally granted five year restraining order against ex chris brown^karrueche tran finally granted five year restraining order against ex^boyfriend spotted new girl amid breakup rumors^is kourtney kardashian pregnant with baby number^rihanna feels sexy and more confident with new curves as beau hassan jameel treats her like a princess^here complete list winners billboard music awards^robin wright son hopper bae arrested drug possession,16,2,-14,18,0.8888888888888888,-0.7777777777777778,1
19665244,boston25,6739,326498,2762,276625,1,4,1,11,boston news provides complete new england news coverage matters,today pause remember life legacy former president george h.w bush died friday ag^delivers state union address joint session congress tonight p.m.^chicago hospital shooting multiple victims reported^chicago mercy hospital shooting what know victims^chicago mercy hospital shooting what know victims^oprah 'intrigued idea running president friend gayle king says^enrique iglesias anna kournikova reportedly welcome twins^a gofundme account raised 3 million help victims mass shooting las vegas here help^james franco denies allegations sexual misconduct^portia de rossi says steven seagal unzipped pants audition^justin timberlake announces new album 'man woods^justin theroux breaks social media silence jennifer aniston split^labor day deals sales macy walmart best buy^labor day deals sales macy walmart best buy^snap inc. stock falls kylie jenner tweet snapchat redesign^man inspired als ice bucket challenge dead^ving rhames says police held gunpoint home neighbor reported burglary,2,15,13,17,0.1176470588235294,0.7647058823529411,0
13918492,fox5dc,5968,282756,2426,252118,1,6,1,9,we cover breaking news washington dc maryland virginia news tips -895-3000 fox5tips.com online facebook fox dc,"exclusive family private investigator there evidence seth rich contact wikileaks prior death^live now president trump deliver remarks national republican congressional committee dinner at630 fox5dc^breaking white house vice president joebiden make statement rose garden soon watch live^watch live holds press briefing president denied russia still targeting t^watch live holds press briefing g7 summit shortly learned president^watch live holds press briefing joint press conference president japan^watch live president gives remarks gop retreat philadelphia live now^david cassidy fighting memory loss wants `enjoy life^harry potter river cruise set sail summer cost serious cash details^harry potter river cruise set sail summer cost 5,350 per muggle details^tmz 'rob amp big star christopher 'big black boykin dead^breaking richard simmons hospitalized severe indigestion fox5dc^breaking demi lovato hospitalized suffering apparent heroin overdose according tmz fox5dc^april giraffe pregnant^again yup april giraffe pregnant^april giraffe pregnant^april giraffe pregnant",2,15,13,17,0.1176470588235294,0.7647058823529411,0
36397873,FoxNewsResearch,200,65580,728,7964,1,15,1,0,information analysis research team,"code federal regulations pages added last presidents obama +23,222 gwb +18,399 clinton +9,182^american society civil engineers estimates would cost nearly 4.6 trillion adequately repair infrastructur^according american society civil engineers americans losing 3,400 year disposable income due t^otd white house announced anthony appointment new white house communications dir^us china tensions trade war new tax 200b chinese goods tax 60b us goods 9/20^u.s. trade deficit may 43.1 billion down 46.1 billion april smallest deficit since oct recor^us china trade deficit the us pace record high 382 billion trade deficit goods china^u.s. trade deficits goods china 375.6 billion european union 151.4 billion mexico 71.0 bi^u.s. trade deficit sept widens th straight month erts goods 2.5 bil^us trade deficit goods china jan apr 2018 jan 35.95b feb 29.26b mar 25.87b apr 27.96^u.s. trade deficit south korea trade goods 2014 25 billion 2015 28 billion 2016 28 billion^us trade deficit goods china 375b 347b 367b 345b 319b 31^u.s. trade deficits july 50.1 billion widest trade deficit since february monthly deficit goods chi^us trade deficit goods w/ japan 2017 68.9 billion 2016 68.8 billion 2015 69.1 billion 2014 67.6^us trade deficit goods china january may 2012 117.5 billion 2013 121.3 billion 2014 125^u.s. trade deficit june 46.3 billion up 43.2 billion may first increase months jan june^yearinreview2017 june th a mistrial declared bill cosby case jury deadlocked charges th",2,15,13,17,0.1176470588235294,0.7647058823529411,0
56470183,6NewsCTX,793,44343,512,86813,0,0,2,15,the latest news updates central texas news source,emmy awards the winners list^emmy awards the winners list^koko gorilla knew sign language dies^ex 'dance moms star abby lee miller sentenced year prison^scott baio wife renee reveals microvascular brain disease diagnosis^scott baio wife renee reveals microvascular brain disease diagnosis^scott baio wife renee reveals microvascular brain disease diagnosis^report meghan markle dad longer attend royal wedding^veep actress julia louis dreyfus diagnosed breast cancer^'nypd blue creator steven bochco dead^'nypd blue creator steven bochco dead^reports priyanka chopra nick jonas engaged two months dating^reports priyanka chopra nick jonas engaged two months dating^cardi b confirms secretly married offset september 'engaged^cardi b confirms secretly married offset september 'engaged^wwe star vader dead age^prince william prince harry best man royal wedding,2,15,13,17,0.1176470588235294,0.7647058823529411,0
109167962,DRoseTV,7028,8396,184,86465,0,1,2,14,i-team reporter p anchor storyteller x emmy nom alum clever gifs proverbs :17 tips derrick.rose.com,rt abcpolitics watch live pres donald trump makes remarks gop retreat philadelphia^abc more george clooney amal clooney welcome twins^ciara russell wilson welcome first child together sienna princess wilson^jada pinkett smith calls tupac shakur biopic 'deeply hurtful^former dance moms star abby lee miller sentenced one year day federal prison^james franco denies sexual misconduct allegations says things i heard twitter accu^top story james franco denies sexual misconduct allegations says things i heard twitter a^finally april giraffe finally gives birth baby born million watch live online^.djkhaled joins forces oprah working together weight watchers named soc^billy bush wife sydney davis separate years marriage 'to evaluate life together'^roger ailes founder former chairman ceo fox news resigned dead age^.kelly clarkson pink perform together first time open amas sunday /7c ab^prince harry says wanted british royal family^twitter officially doubling character count across world^nina simone bon jovi moody blues among rock amp roll hall fame inductees^miss missouri sophia dominguez heithoff crowned miss teen usa^richard simmons better hospitalized severe indigestion rep exclusively tells abc news,2,15,13,17,0.1176470588235294,0.7647058823529411,0
317980134,CraigCaplan,2339,13351,584,52783,3,14,0,0,capitol hill producer former chair philly fan since birth alum flyeaglesfly,:11pm et honor house representatives give us chance vote floor pelosi concludes her^gop signing daca/immigration discharge petition president trump gave us deadline to^father pat conroy sworn th chaplain us house representatives speaker boehner may^admin backtrack zte another example president weak face another nation ldr rs j^:11pm et honor house representatives give us chance vote floor pelosi concludes her^treasury sec nominee steven mnuchin public financial disclosure report office government ethics posted^treasury secretary nominee steven mnuchin page public financial disclosure report^holding final campaign rally las vegas tonight tuesday nvgopcaucus^nv senators campaign trail today democratic senator cortez masto campaigned madison wi democratic^at gop campaign rally today north las vegas speaker ryan amp nv04 rep hardy^campaign rally las vegas online^wh house passage right to try bill the president eressed support need right try le^house passes right to try bill allowing terminally ill patients try eerimental drugs w/o full fda ap^interview former president george w. bush amp laura bush dallas bush presidency library dedication amp tonight p^speaker ryan i pleased senate took action move critical legislation big bipartisan vote..no^president trump joined cincinnati tax reform speech ohio senator rob portman amp rep renacci running^thanksgiving white house press briefing room today,3,14,11,17,0.17647058823529413,0.6470588235294118,0
1326971010,Energy953Radio,2395,6285,131,46299,0,0,3,14,welcome party home `` tucker maura morning '' stream us,brad pitt jennifer lawrence leonardo dicaprio fighting money owed weinstein company^justin bieber says religion et free bondage shame^taylor swift alleged stalker arrested knife rope outside singer home^announced insta girlfriend cherry seaborn engaged is weird firs^rachel mcadams welcomes first child boyfriend jamie linden report^prince harry meghan markle official wedding portraits revealed^john oliver blame meghan markle calling royal wedding^justin timberlake announces new album man woods^christina aguilera done the voice forever^julia louis dreyfus diagnosed breast cancer^fuller house has been renewed season^time get binge watching renewed season^celine dion poses naked vogue magazine^taylor swift announces new album reputation release date^the weeknd beyonce eminem headline coachella^daniel craig confirms play james bond^royal wedding prince william prince harry best man,3,14,11,17,0.17647058823529413,0.6470588235294118,0
14216661,nationalpost,37,817771,7561,319953,0,0,4,13,news analysis commentary national post,'the key know stedman graham talks investing self leadership oprah^drake says ask woman remove hijab concert i utilized fake media story^it brave new world amal alamuddin george clooney officially welcome twins world^from jessica simpson gives birth baby boy named ace knute^after long search ryan seacrest officially kelly ripa new permanent live co host v^princess charlotte smiles mum photos first day nursery school^kelly clarkson opens body image 'when i really skinny i wanted kill^'he pig actress paz de la huerta accuses harvey weinstein raping twice via^donald trump almost played president sharknado obviously via^meghan markle half sister fires back prince harry 'tactless comment family never had'^i healing after months denial val kilmer reveals recently recovered cancer^mindy kaling reportedly pregnant first child via^bradley cooper girlfriend irina shayk welcome first child via^it brings much closer melissa etheridge reveals smokes weed kids v^icymi relive meghan markle prince harry big day the best royal wedding photos^relive meghan markle prince harry big day the best royal wedding photos^oscars the complete list nominees winners happen,4,13,9,17,0.2352941176470588,0.5294117647058824,0
17722044,FOX17,543,70588,708,141801,3,0,1,13,wxmi fox located grand rapids michigan covering west michigan muskegon battle creek,melania trump undergoes kidney surgery walter reed medical center^melania trump undergoes kidney surgery walter reed medical center^melania trump undergoes kidney surgery walter reed medical center^arnold schwarzenegger returning the new celebrity apprentice^kevin hart wife eniko parrish eecting baby boy first child together^comedy legend jerry lewis dies age^comedy legend jerry lewis dies age complete details ...^april giraffe gives birth saturday morning^in case missed former happy days star erin moran found dead saturday indiana^ellen degeneres cries receiving best birthday gift portia de rossi^ellen degeneres cries receiving best birthday gift portia de rossi^ellen degeneres cries receiving best birthday gift portia de rossi^ellen degeneres cries receiving best birthday gift portia de rossi^fiona baby hippo dad henry dies^april giraffe pregnant^april giraffe pregnant^april giraffe pregnant,4,13,9,17,0.2352941176470588,0.5294117647058824,0
2358408247,BlueDressButler,946,995,26,10606,0,0,4,13,longtime entertainment journalist united press international the irish echo yoga enthusiast book reader member women film critics circle,chris pratt officially files divorce anna faris via^maddie poppe crowned season winner 'american idol via^josh o'connor play prince charles 'the crown via^brad pitt bids 120k watch 'game thrones emilia clarke via^bill paxton family files wrongful death lawsuit hospital surgeon via^jamie foxx host bet awards show via^lea michele engaged zandy reich via^tina turner son craig dead apparent suicide via^elle king says kipped wedding andrew ferguson via^noah cyrus big sean perform sunday mtv movie amp tv awards via^'outlander renewed seasons via^jordan fisher lindsay arnold win season 'dancing stars via^bradley cooper irina shayk welcome first child via^jamie lynn spears pregnant second child via^meryl streep joins season 'big little lies via^people choice awards ceremony air e first time via^chris pratt officially files divorce anna faris via,4,13,9,17,0.2352941176470588,0.5294117647058824,0
23995748,TheRoot,14423,508513,6189,121258,0,4,5,8,the root digital magazine provides thought-provoking commentary news variety black perspectives,years later war poverty rages^former candidate az state house bernie sanders presidential campaign black outreach^marc lamont hill controversial comments israel lead termination cnn^the first lady acknowledge michelle obama referred 'forever first lady a^save date meghan markle prince harry set wed may^meghan markle nephew developing special cannabis strain markle sparkle honor royal wedding^in new rambling message kanye west blames social media mind control calls himself best living recording ar^in new rambling message kanye west blames social media mind control calls himself best living recording ar^russell wilson ciara welcome baby girl sienna princess^beyonc offered role beauty beast turned beneath her^surprise beyonc crashes sports illustrated award show present colin kaepernick muhammad ali legac^'real housewives new york star luann de lesseps accuses russell simmons groping elevator^tamar braxton files divorce vincent herbert years marriage^the newest face^roger ailes former ceo dead^a stage musical inspired life michael jackson coming broadway^fashion designer former project runway finalist mychael knight dead,5,12,7,17,0.29411764705882354,0.4117647058823529,0
12811952,Suntimes,14219,502866,6305,157771,1,9,4,3,the hardest-working paper america,just in federal prosecutors charge nyc subway bomb suspect say wrote facebook trump failed protec^the u.s. energy information administration said america likely surpassed russia june august jum^the u.s. energy information administration said america likely surpassed russia june august jum^many chicagoans contemplating heavy issues mass shooting pittsburgh synagogue and^doctors medical workers anti violence organizers gathered along handful chicago police officers f^candidates chicago crowded mayoral race offered prayers tributes mercy hospital shooting victims^a sad thanksgiving weekend ended mourners came sunday honor two victims last week fatal shooting at^a radio ad featuring president obama supporting rahm emanuel election campaign hits airwaves monday^the u.s. energy information administration said america likely surpassed russia june august jum^looking summer book recommendations here four electric fiction debuts asian american women including^kim kardashian west among invitees white house listening session clemency meeting comin^david cassidy fighting memory loss wants 'enjoy life^the american clergyman preached power love wedding prince harry meghan markle un^donaldtrump calls cbs host frequent trump roaster stephencolbert talent guy whose material filthy.^that oscars goof last year returning host jimmy kimmel hopes repeat^that oscars goof last year returning host jimmy kimmel hopes repeat^congrats katharine mcphee david foster officially engaged,5,12,7,17,0.29411764705882354,0.4117647058823529,0
18736950,FCN2go,1222,129317,1077,231726,0,1,5,11,first coast news wtlv/wjxx jacksonville fl join thousands following first coast news,changes meet press first baptist church programming sunday^reports brad pitt accused child abuse investigation^emmy awards the winners list^emmy awards the winners list^channing tatum jenna dewan announce separation^channing tatum jenna dewan announce separation^koko gorilla knew sign language dies^cute alert princess charlotte smiles first day nursery school photos courtesy duchess cambri^scott baio wife renee reveals microvascular brain disease diagnosis^scott baio wife renee reveals microvascular brain disease diagnosis^scott baio wife renee reveals microvascular brain disease diagnosis^'nypd blue creator steven bochco dead^'nypd blue creator steven bochco dead^'nypd blue creator steven bochco dead^wwe star vader dead age^wwe star vader dead age^april giraffe pregnant,5,12,7,17,0.29411764705882354,0.4117647058823529,0
21901715,KUTV2News,965,110438,1301,175255,1,7,4,5,utah source breaking news weather sports tips 801 -1222 facebook instagram snapchat,watch live george h.w bush funeral he died friday age^despite news reports centers disease control prevention n't warn people dressing c^the centers disease control prevention cdc named fentanyl america deadliest drug according a^despite news reports centers disease control prevention n't warn people dressing c^the centers disease control prevention cdc named fentanyl america deadliest drug according a^sarah sanders holds white house press briefing first time kicked virginia restaura^hosting thanksgiving year the u.s. department agriculture tips prepare safe thanksgiv^watch house minority leader nancy pelosi holds weekly press conference^updated salt lake pd held press conference elain apprehension man suspect^real salt lake press conference livestreaming^former sandy city mayor tom dolan speaks real salt lake press conference watch live^salt lake d.a hold press conference new officer involved shooting video p.m.^james franco denies sexual misconduct allegations^stand comedian charlie murphy brother actor eddie murphy dies battling leukemia.^hey gameofthrones fans kit harington plays john snow rose leslie ygritte getting married cast^fergie josh duhamel announce split years marriage^april giraffe whose pregnancy became internet sensation pregnant,5,12,7,17,0.29411764705882354,0.4117647058823529,0
22630309,InsideEdition,1304,80782,565,42217,0,0,5,12,inside edition television longest-running top-rated most-honored syndicated newsmagazine,did jennifer aniston justin theroux split live^booty lip scious did beyonce get injections plump lips^brad pitt angelina jolie release first joint statement committed act united front.^hoda kotb permanently replace matt lauer today co anchor savannahhodatoday^angelina jolie breaks silence split brad pitt we get^gives surprise commencement speech marjory stoneman douglas high school graduation it took our^watch goose attack unsuspecting police officer^legendary comedian jerry lewis dies age^zoo owner gives update april giraffe days long awaited birth^royal wedding why meghan markle will maid honor she weds prince harry .^vince vaughn reportedly arrested outside los angeles suspicion dui^pippa middleton florist predicts flowers might used meghan markle prince harry wedding.^actor bradley cooper model girlfriend irina shayk welcome first child according reports.^mel c says meghan markle prince harry n't invited spice girls royal wedding.^fitness star richard simmons hospitalized severe indigestion^despite reconciliation jennifer garner ben affleck officially file divorce^april giraffe pregnant,5,12,7,17,0.29411764705882354,0.4117647058823529,0
250556430,NewsChannel8,202,16991,491,167157,1,3,4,9,we making easier keep d.c.-area news from follow us,just in nyc subway bomb suspect faces federal charges posted trump failed protect nation faceboo^read full transcript abc7 scott thuman exclusive interview president barack obama^watch live president trump speaking national republican congressional committee march dinner^sarah huckabee sanders holding white house press briefing^stedman graham oprah partner skips royalwedding speak coppin state graduation^report ryan phillippe 'devastated 'false allegations domestic violence^report angelina jolie named bizarre lax terror threat sent police^d.c. mayor muriel bowser administration officials holding press conference farragut salt dome give^koko gorilla knew sign language dies^james franco denies sexual misconduct allegations^matt damon apologizes comments sexual misconduct^meghan markle dad reportedly wo n't attend royal wedding staging photos^steve martin martin short 'colonoscopy parties tom hanks^fergie josh duhamel announce split years marriage^meryl streep joins cast 'big little lies season^richard simmons hospitalized severe indigestion^reports kylie jenner pregnant,5,12,7,17,0.29411764705882354,0.4117647058823529,0
1375289149,NewDay,1264,325216,1950,59307,0,11,6,0,join alisyn camerota cnn weekdays -9a et latest news paul host weekends,russia released statement new military agreements us yet release details.^you put statement know statement gon na read air multiple times ... one gonn^former trump lawyers admitting dictated misleading statement the notion to^pres trump wildfire tweet at time people suffering lives lost ... entire towns burnt^rudy giuliani says special counsel agreed limit scope possible interview president tr^new day alisyn camerota conducted wide ranging interview trump lawyer rudy giuliani yesterday does t^tune :00 hour et catch president trump lawyer rudy giuliani new day before interview^the poll numbers came overnight interesting says nbc news wall street jo^trump lawyers admitted president dictated misleading statement don jr. trump tower meeting does th^the discord coming president music putin ears answer benefits says cnn'^cnn entertainment reporter melas describes eerience morgan freeman press junket as soon as^tune van jones show tomorrow saturday p et talking comedian snl cas^remember song jam turn it up neither is mrs. west pursuing career music^says catherine duchess cambridge former kate middleton meghan markle differe^catherine duchess cambridge wife britain prince william given birth son royal family a^says catherine duchess cambridge former kate middleton meghan markle differe^catherine duchess cambridge wife britain prince william given birth son royal family a,6,11,5,17,0.35294117647058826,0.29411764705882354,0
187092357,THETonyMorrison,3445,8130,192,33165,0,6,6,5,x emmy-winning producer social media guy covering music tech travel lgbtq+ formerly photography,transcript released stormy daniels interview this me i victim i 've never^full video fbi fl transporting white van connection elosive packages sent across country this^breaking law enforcement sources tell news preliminary assessment indicates th th packa^now law enforcement sources tell news preliminary assessment indicates th th package appeari^fbi fl transporting white van connection elosive packages sent across country week the^breaking deliver statement shortly rose garden president attendance^this coming gmaday a gma first best reason starts pet abc amp^baby on the way meghan markle duchess sussex pregnant kensington palace announces^more george clooney amal clooney welcome twins^putting good america morning^top searched royal family members google last days us meghan markle prince harry queen eliza^top searched royal family members google last days us meghan markle prince harry queen eliza^top story james franco denies sexual misconduct allegations says things i heard twitter a^just in anthony weiner sentenced months prison sexting case sending obscene material minor^lionel richie luke bryan officially join katy perry judges american idol americanidol^'stranger things star shannon purser publicly comes bisexual^first look 'wonder woman reveals steve trevor still alive wonderwoman ww84,6,11,5,17,0.35294117647058826,0.29411764705882354,0
31488247,nydjlive,591,59123,81,138645,0,1,7,9,broadcast journalist host rysenshyne am-9am mon fri ceo nydj live media inquiries info.com,simply cos i made reference statement president^wills stick neck say truth ai n't u unrealistic industry person knows r^billboard music awards nominations see full list^billboard music awards nominations see full list^billboard music awards nominations see full list via^blac chyna suing rob kardashian porn revenge ...^selena gomez reveals she had a kidney transplant and guess who was the donor^selena gomez reveals she had a kidney transplant and guess who was the donor ...^ed sheeran engaged long time girlfriend cherry seaborn^billboard music awards nominations see full list^billboard music awards nominations see full list^billboard music awards nominations see full list via^billboard music awards ed sheeran wins top artist complete winners list^billboard music awards ed sheeran wins top artist complete winners list^bet hip hop awards winners the complete list nydj live ...^bet hip hop awards winners the complete list via^gotham awards see the complete winners list nydj live ...,7,10,3,17,0.4117647058823529,0.17647058823529413,0
3091150576,trtworld,11,201617,1435,110291,8,9,0,0,where news inspires change features opinion video in-depth coverage follow breaking news live updates,a record number women elected us house representatives did trump effect galvanise wom^it took little longer thought you democrat conor lamb claims victory for^in setback trump democrats seized house representatives midterms2018 here reactions^us house representatives defeat republican compromise bill aimed providing long term protections drea^it took little longer thought you democrat conor lamb claims victory for^a record number women elected us house representatives did trump effect galvanise wom^after winning us house representatives democrats ability investigate trump tax returns^rt update the us house representatives approves bill fund federal government march ending th^if i may proceed without help support siri uk defence secretary apologises siri interrupts st^the leaders turkey russia france germany held talks syria summit istanbul here key poi^the eu call accountability scapegoating killing jamal khashoggi saudi consulate i^the eu call accountability scapegoating killing jamal khashoggi saudi consulate i^the eu call accountability scapegoating killing jamal khashoggi saudi consulate i^live periscope head turkey supreme election council sadi guven delivering statement on^if i may proceed without help support siri uk defence secretary apologises siri interrupts st^the trump administration issued tariffs many foreign goods name decreasing trade deficit b^the us imposed additional tariffs 200 billion worth chinese goods latest escalation heated tra,8,9,1,17,0.4705882352941176,0.05882352941176471,0
15032862,cbschicago,2354,157117,2913,121132,1,6,7,3,cbs chicago the latest news weather sports chicagoland email tips cbschicagotips.com call 99.2200,with house representatives vote tuesday congress passed legislation could give terminally ill patients a^the agreement reached president trump russian president vladimir putin helsinki finland mo^four people died result e. coli outbreak tied romaine lettuce bringing total five^at least people shot chicago since midnight.two died shooting victims poured eme^funerals begin today victims shooting massacre pittsburgh synagogue including two men ties to^cbs local bank america says plans stop lending money gunmakers produce military style firearms fo^one family southwest houston four reasons celebrate fourth july linda thomas agi welcomed ho^kim kardashian embarrassed kanye west visit trump^report jennifer garner took ben affleck back to rehab^preview chrissy teigen opens up about battling postpartum depression^preview chrissy teigen opens up about battling postpartum depression^chicago cbs kensington palace saturday released first official photos newest member briti^chicago cbs kensington palace saturday released first official photos newest member briti^the american clergyman preached power love wedding prince harry meghan markle un^it official nick jonas and priyanka chopra are engaged^tab hunter gay icon and star of damn yankees is dead at^tab hunter gay icon and star of damn yankees is dead at,8,9,1,17,0.4705882352941176,0.05882352941176471,0
18823758,BSO,1737,96663,2244,601967,0,3,10,4,bso unique take sports ent tweets ceo robert littal ..the ugly truth pod.. host tyt sports..ig bsotv fb blacksportsonline ajm buckeyealum,details lesean mccoy ex gf delicia cordon hiring attorney amp possibly making official statement soon h^watch hilarious clip of skip bayless contradictions on aaron rodgers why you should never embrace the debate seri^watch hilarious clip of skip bayless contradictions on aaron rodgers why you should never embrace the debate seri^after rumor floats that drake slept with his wife kim kardashian kanye cops pleas twitter amp asks drake forg^watch kanye ig ask why drake has n't denied having sex with kim kardashian upset nick cannon dated his wife^watch kanye ig ask why drake has n't denied having sex with kim kardashian upset nick cannon dated his wife^details rob kardashian suing blac chyna domestic violence via iphone^details rob kardashian suing blac chyna domestic violence via iphone via^steve harvey responds rumors that he leaving his wife for kris jenner how his wife will receive 400m a^steve harvey responds rumors that he leaving his wife for kris jenner how his wife will receive 400m a^like u whoopi wwe feud rt i get sick people trying create fights feuds women business do n't buy^kendall jenner gets back with the guy she told ben simmons was her brother but was actually cheated him with p^kendall jenner gets back with the guy she told ben simmons was her brother but was actually cheated him with p^danny amendola broke up with olivia culpo because he did n't like her nude si pics she confirms the breakup you ca^danny amendola broke up with olivia culpo because he did n't like her nude si pics she confirms the breakup you ca^details on how cops found and arrested another suspect in xxxtentacion murder case^details on how cops found and arrested another suspect in xxxtentacion murder case via,10,7,-3,17,0.5882352941176471,-0.17647058823529413,1
103897341,EntInsider,125,34645,534,54879,1,2,9,5,our mission inform inspire facebook instagram youtube,leonardo dicaprio says signed elon musk trip mars^everyone is talking about paul krugman column today^matt bai write the new york times the caucus blog it emergence political times column ... j ...^people freaking laura dern may snubbed reese witherspoon emmy win^trump made one biggest royal faux pas visiting queen people outraged^'he diabolical leah remini says scientology poster boy tom cruise good person^the worst hit song every year since macklemore train twice^mark hamill wants 'star wars fans campaign carrie fisher receive walk fame star early rel^'good morning america adding rd hour hosts michael strahan sarah haines 'the view^years in the life of jessica simpson^hoda kotb says matt lauer texted congratulations replaced 'today show coanchor^billy bush confirms trump voice 'access hollywood tape^ellen page accuses brett ratner 'blatantly homophobic abusive behavior^nbc next live musical 'jesus christ superstar^donald trump almost played president 'sharknado happened^justin timberlake announces release new album 'man woods^renee zellweger elains disappeared hollywood years,10,7,-3,17,0.5882352941176471,-0.17647058823529413,1
23102766,98rocktampabay,6159,14100,261,54258,0,0,11,6,tampa bay rock station since,celebrities react trump withdraws steph curry white house invitation^celebrity reaction jimmy kimmel monologue on las vegas shooting and guns^beyonce not demanding silent delivery room despite report^jimmy kimmel talks donald trump harvey weinstein on 'gma^chris brown slammed by judge for skipping karrueche tran court hearing^ryan lochte charge dropped in rio robbery case^halle berry not pregnant at despite reports^celebrities remember orlando pulse nightclub shooting victims one year later^celebrities react nfl players kneel lock arms during national anthem^fans react u2 cancels st. louis concert amid police protests^mariah carey not dating both nick cannon and bryan tanaka despite report^legendary musician tom petty dead at family confirms^tom petty dead at^neil diamond retires from touring after parkinson disease diagnosis^hugh hefner cause death has been revealed^hugh hefner cause death revealed^alex rodriguez year old daughter sings for jennifer lopez photos,11,6,-5,17,0.6470588235294118,-0.29411764705882354,1
16096416,VogueParis,0,2446829,11938,115125,0,1,12,4,vogue paris sets trends makes names dares go title your daily dose fashion style live paris,happy wedding anniversary davidbeckham years four children later duo beco^kim kardashian launching brand new kkw beauty collection line seven shimmering eyeshadows.^click see cute moments duchess cambridge children^karl lagerfeld x kaia upon us we met heir cindy crawford superheroine dna chat ca^karl lagerfeld x kaia upon us we met heir cindy crawford superheroine dna chat ca^julia roberts underwent hairstyle makeover boy got pretty woman bells ringing gt^girl power tilda swinton dakota johnson stride ahead matching red looks suspiria premier venice^brigittebardot aged splashing around th cannes film festival^happy birthday richard gere the actor turns today celebrate 've collated best pictures wit^how cute plush mouse toy meghan markle announced pregnancy morning could n't help put^nouvelles r v lations sur le royal wedding du prince harry et meghan markle d couvrir ici gt^kylie jenner n't one shy away spotlight really 'highlighted celebrity status ne^notre film du jour the lost city z avec charlie hunnam et robert pattinson^everything need know prince harry meghan markle engagement^everything need know prince harry meghan markle engagement^in anna wintour countryside dwelling long island daughter bee shaffer francesco carrozzini son f^all best street looks day paris haute couture week spring/summer landed pfw hautecouture,12,5,-7,17,0.7058823529411765,-0.4117647058823529,1
20605323,KTVOTV,986,9071,278,90111,0,4,12,1,your source ktvonews ktvosports ktvoweather information since liveonktvo kirksville ottumwa ktvogmh ktvotv instagram ktvotv,the life eectancy u.s. declined slightly last year according new data centers disease con^the life eectancy u.s. declined slightly last year according new data centers disease con^rt watch live vice president biden deliver statement rose garden^hosting thanksgiving year the u.s. department agriculture tips prepare safe thanksgiv^the iconic pyramid back new celebrities fun whole family summer hosted good morning am^the iconic pyramid back hosted good morning america co anchor michael strahan celebrity battles featuring^the iconic pyramid back new celebrities fun whole family summer hosted good morning am^the iconic pyramid back hosted good morning america co anchor michael strahan celebrity battles featuring^the iconic pyramid back hosted good morning america co anchor michael strahan liveonktvo abc pm.^the iconic pyramid back hosted good morning america co anchor michael strahan celebrity battles featuring^the iconic pyramid back new celebrities fun whole family summer hosted good morning am^the iconic pyramid back new celebrities fun whole family summer hosted good morning am^the iconic pyramid back new celebrities fun whole family summer hosted good morning am^watch aretha franklin casket arrives greater grace temple detroit ahead funeral the queen soul^celebrity battles featuring leslie jones julie bowen debra messing mario cantone liveonktvo^coming next liveonktvo abc pm ed o'neill sof a vergara julie bowen ty burrell jesse t^former fox news ceo roger ailes dead,12,5,-7,17,0.7058823529411765,-0.4117647058823529,1
82062348,TheSunTV,272,19735,211,76987,0,0,14,3,the hottest tv news soap secrets like us facebook,how old roseanne barr children net worth ex husbands^how old roseanne barr children net worth ex husbands^sarah jessica parker hints samantha could replaced sex and the city feud kim cattrall^netflix confirm the crown castings prince charles queen mother actors announced third series^the durrells josh o connor play prince charles the crown series three despite six years older than^keeping up with the kardashians spoilers khloe calls mum kris jenner w***e finding cheated fi^kris jenner terrified becoming convinced someone poisoning drinking water new keeping up with the k^keeping up with the kardashians spoilers khloe calls mum kris jenner w***e finding cheated fi^kris jenner terrified becoming convinced someone poisoning drinking water new keeping up with the k^kim kardashian left reeling kanye west tries control puts instagram huge row^keeping up with the kardashians spoilers kendall jenner reveals terrified stalker wants bu^jennifer aniston pictured smiling following split justin theroux leaves friends co star courteney cox s^david beckham splashes 3m buy london pub mate guy ritchie^pride of britain viewers swoon david beckham surprises inspirational ella chadwick raised thousand^grieving brother reveals tragic life happy days star erin moran dead battling throat cancer^mtv reality star clay adler dead taking life^kit harington fiance rose leslie flashes engagement ring spotted first time since th,14,3,-11,17,0.8235294117647058,-0.6470588235294118,1
859819810946899968,PageSixTV,240,4426,56,4120,0,0,14,3,get scoop latest celeb news insiders know best watch pagesixtv weekdays,jennifer aniston justin theroux shocked hollywood announcing separation two years marriage^did megyn kelly get matt lauer fired story today pagesixtv^will get work done face ... nose but seems want we 'll elain pagesixtv^exclusive divorce talks angelinajolie bradpitt hit new snag angelina livid what g^now jennifer aniston brad pitt single twitter begging rekindle roman^bradpitt might owe moneyball pair drivers caused three car pile la plus and^bradpitt taking angelinajolie deadbeat dad accusations lightly he claims already given milli^meghanmarkle nephew cannabis grower making strain honor royalwedding pagesixtv pays tr^crying jordan might need dab tears shoe game watch pagesixtv more.^happy birthday richard gere pagesixtv^bradpitt might owe moneyball pair drivers caused three car pile la plus and^bradpitt taking angelinajolie deadbeat dad accusations lightly he claims already given milli^bradpitt taking angelinajolie deadbeat dad accusations lightly he claims already given milli^he may years old still life party philbin spotted dining^did crack code dyed hair pink tells intervie^poor justintheroux he linked many gorgeous women since split jenniferaniston and^the king pop coming broadway a musical based life music eected hit,14,3,-11,17,0.8235294117647058,-0.6470588235294118,1
16571541,cafemom,13359,98815,1473,21213,0,1,16,0,this motherhood nofilter,the popular baby names state is favorite name list^brad pitt reportedly admits jennifer aniston 'love life amid rumors 're texting^jessica simpson shares first look her baby bump after revealing she pregnant^pregnant jessica simpson stuns new red carpet baby bump pics^jessica simpson baby bump pic has people concerned about her happiness^a lip reader decoded kate middleton prince william said outside hospital introducing world t^tom cruise makes instagram debut amid reports suri desperate see dad^jessica simpson shares first look her baby bump after revealing she pregnant^pregnant jessica simpson stuns new red carpet baby bump pics^jessica simpson baby bump pic has people concerned about her happiness^people are freaking out because prince william kate middleton broke up short time^reese witherspoon admits freaking out when she met kate middleton^reese witherspoon admits freaking out when she met kate middleton^new report about angelina jolie brad pitt custody battle has critics sounding off^tom cruise suri a timeline their estranged relationship^tom cruise suri a timeline their estranged relationship^matt roloff his girlfriend caryn chandler a timeline their relationship,16,1,-15,17,0.9411764705882352,-0.8823529411764706,1
20340510,purepeople,628,58723,293,129939,0,0,16,1,est le site le plus exhaustif du web fran ais sur l actualit des stars,vid o kanye west l'american idol soutenu par kim kardashian s duit jennifer lopez^kanye west g n reux avec la ch rie de caitlyn jenner fin de la brouille^divorce de brad pitt et angelina jolie le poids de leur fortune dans la guerre^divorce d'angelina jolie et brad pitt une fortune millions de dollars^vid o miley cyrus liam hemsworth n'en finit plus de lui jouer des tours^vid o sofia richie ans son p re lionel richie la g te pour euros^mel b bient t en rehab heidi klum lui apporte son soutien^vid o sofia richie ans son p re lionel richie la g te pour euros^katy perry american idol sa r action face un candidat fan de taylor swift^vid o le prince george change d' cole les cambridge pr ts abandonner anmer hall^alessandra ambrosio en couple le top model et son ch ri s'embrassent en public^jennifer aniston justin theroux parle de leur divorce pour la premi re fois^vid o sofia richie ans son p re lionel richie la g te pour euros^vid o sofia richie ans son p re lionel richie la g te pour euros^katy perry american idol sa r action face un candidat fan de taylor swift^julie bowen divorce finalis pour la star de modern family^anna wintour sa fille bee shaffer s'est mari e avec francesco carrozzini,16,1,-15,17,0.9411764705882352,-0.8823529411764706,1
75187941,AboutTheHouse,880,45412,618,14255,16,1,0,0,news updates official twitter account australia house representatives,icymi latest ask us anything article tackles one biggest questions australian politics th^the final qt week upon us already you watch^hi sorry wait wanted dig question bit we 've written up^on anniversary start francis forde day reign prime minister latest ask us anything discov^the final sitting day week already upon us the daily program available at^house members wo n't sitting next week see recent ask us anything article 'll still h^assembly regular ask us anything readers thrilled learn yet another pie^during september sitting fortnight parliament received remonstrances assembly^it question keeps psephologists awake night next election we n't definit^a new ask us anything evening reading pleasure what box image courtesy^it ask us anything last year found comfy chairs house the an^it question auspol loves ask 've stepped in week ask us anything look potentia^a recent electronic interjection uk got us thinking rules siri interje^for next hour find us house representatives chamber this super rare opportunity act^we 're back hunt questions history practice house representatives no questi^house representatives practice guide rules precedent guide us read^following qt speaker responded question standard dress journalists house press gall,16,1,-15,17,0.9411764705882352,-0.8823529411764706,1
750763772,phoebesaid,420,1957,49,3855,0,1,16,0,detroit free press usa today autos reporter formerly politics alum doc film producer 313 -6512 phoward.com,rip ... grateful met city gold brilliant documentary film^she year 69m contract mediocre ratings in april show fewer viewers^she year 69m contract mediocre ratings in april show fewer viewers live^megyn kelly year contract 69m modest ratings in /2018 show fewer^she year 69m contract mediocre ratings in april show fewer viewers live^she year 69m contract mediocre ratings in april show fewer viewers^she year 69m contract mediocre ratings in april show fewer viewers live^megyn kelly year contract 69m modest ratings in /2018 show fewer^she year 69m contract mediocre ratings in april show fewer viewers live^she year 69m contract mediocre ratings in april show fewer viewers^she year 69m contract mediocre ratings in april show fewer viewers live^megyn kelly year contract 69m modest ratings in /2018 show fewer^she year 69m contract mediocre ratings in april show fewer viewers live^she year 69m contract mediocre ratings in april show fewer viewers^she year 69m contract mediocre ratings in april show fewer viewers live^megyn kelly year contract 69m modest ratings in /2018 show fewer^she year 69m contract mediocre ratings in april show fewer viewers live,16,1,-15,17,0.9411764705882352,-0.8823529411764706,1
14345062,postpolitics,1693,387165,7497,79755,2,14,0,0,the latest political news analysis the washington post,first family visits d.c. shelter highlights homeless veterans plight^george h.w bush got hear eulogy died his reaction priceless^the brooklyn democratic debate transcript annotated^the fix team annotating democratic debate tonight follow transcript^the full brooklyn democratic debate transcript annotated^clinton knocks bush right rise pitch national urban league speech^donald trump featured new jihadist recruitment video^the cnn miami republican debate transcript annotated^get complete transcript final presidential debate analysis^the brooklyn democratic debate transcript annotated^the fix team annotating democratic debate tonight follow transcript^the full brooklyn democratic debate transcript annotated^a complete transcript tonight democratic debate annotated using power^transcript the democratic debate milwaukee annotated^obama campaign going first radio ad targeting african americans^fact checker clinton campaign claim trump would force schools allow guns classrooms,2,14,12,16,0.125,0.75,0
1429761,orlandosentinel,661,313805,3559,197256,0,4,2,10,the orlando sentinel founded comprehensive news source central florida,league conservation voters endorses soto^marco rubio 'face nation 'state union^rick scott fox news sunday^philando castile stopped times how many times police pulled letters^channing tatum wife jenna dewan tatum announce split^bradpitt says plans quit acting three years^julia louis dreyfus awarded mark twain prize american humor^scott hutchison frightened rabbit frontman found dead^seth meyers host golden globes^wwe star big van vader dead^taylor swift announces new album 'reputation^corinne olympios 'bachelor paradise scandal 'i really victim media^corinne olympios 'bachelor paradise scandal 'i really victim media^'morning joe co hosts mika brzezinski joe scarborough engaged^'morning joe co hosts mika brzezinski joe scarborough engaged^pregnant april giraffe calf due march,2,14,12,16,0.125,0.75,0
15650816,BroadwayWorld,789,274271,2851,127748,0,0,2,14,broadwayworld largest comprehensive theater site net featuring news videos photos email social.com,stars celebrate women day broadway^katie couric breaks silence about matt lauer departure from 'today calling situation 'disturbing distressin^tony awards nominations complete list updating live ...^icymi tony awards nominations complete list^from earlier tony awards nominations complete list an american in paris fun home lead ...^icymi tony awards nominations complete list^tony awards nominations complete list an american in paris fun home lead^icymi tony awards nominations complete list an american in paris fun home lead ...^broadway alum eecting first child fiancee caitlin mchugh^sugar butter bride star music industry legend david foster engaged^a michael jackson musical is coming broadway^a michael jackson musical is coming broadway^a michael jackson musical coming broadway^michael jackson musical coming broadway^a michael jackson musical is coming broadway^michael jackson musical coming broadway ...,2,14,12,16,0.125,0.75,0
14500743,CBS_42,1538,44976,874,126754,1,11,1,3,cbs provides local coverage you can count on central alabama -- birmingham tuscaloosa anniston beyond send photos/tips reportit.com,"listen curious robocall seeks damaging information moore^hoover city leaders release video related police shooting e.j bradford jr. today orig^water heating one largest eenses house according u.s. energy information administration^authorities say death centers disease control prevention employee whose body found river^a salmonella outbreak linked recalled beef eanding the u.s centers disease control prevention says^water heating one largest eenses house according u.s. energy information administration^a salmonella outbreak linked recalled beef eanding the u.s centers disease control prevention says^water heating one largest eenses house according u.s. energy information administration^more u.s. beef recalled may contaminated salmonella.the u.s. department agriculture^the u.s. department agriculture issuing nationwide recall nearly ,000 pounds ready eat meat and^recall nearly ,000 pounds jimmy dean sausage links recalled may contain pieces metal^hosting thanksgiving year the u.s. department agriculture tips prepare safe thanksgiv^channing tatum wife jenna dewan tatum announce split^koko gorilla knew sign language dies^britain prince harry meghan markle requesting understanding respect markle father cel^april giraffe pregnant again watch live facebook details",2,14,12,16,0.125,0.75,0
6892002,wbir,915,182067,1121,181421,0,1,3,12,news sports weather live at five :00 brought straight heart,matt lauer interview president george w. bush airs tonight :00pm channel their chat ranges waterboarding kanye^reports brad pitt accused child abuse investigation^emmy awards the winners list^emmy awards the winners list^koko gorilla knew sign language dies^koko gorilla knew sign language dies^walmart remove 'cosmopolitan magazine checkout lines amid me too movement^walmart remove 'cosmopolitan magazine checkout lines amid me too movement^wbir april giraffe livestream gives birth lifelong friendship^wbir april giraffe livestream gives birth lifelong friendship^scott baio wife renee reveals microvascular brain disease diagnosis^scott baio wife renee reveals microvascular brain disease diagnosis^scott baio wife renee reveals microvascular brain disease diagnosis^reports jennifer garner ben affleck officially file divorce^april giraffe pregnant^april giraffe pregnant,3,13,10,16,0.1875,0.625,0
2380259108,The_NewArab,199,58877,874,188958,3,13,0,0,bringing latest news current affairs middle east north africa region,when democrats take control house representatives january must make ending us support sa^comment when democrats take control house representatives january must make ending us suppor^when democrats take control house representatives january must make ending us support the^how long foreign troops stay syria^comment decision axe contributions pundit marc lamont hill comments puts c^comment decision axe contributions pundit marc lamont hill comments puts the^comment decision axe contributions pundit marc lamont hill comments puts the^comment decision axe contributions pundit marc lamont hill comments puts the^decision axe contributions pundit marc lamont hill comments puts channel on^decision axe contributions pundit marc lamont hill comments puts channel on^comment decision axe contributions pundit marc lamont hill comments puts c^decision axe contributions pundit marc lamont hill comments puts channel on^decision axe contributions pundit marc lamont hill comments puts channel on^decision axe contributions pundit marc lamont hill comments puts channel on^i want filipina housemaid anymore for go one day week that four days month who^i want filipina housemaid anymore for go one day week that four days month who,3,13,10,16,0.1875,0.625,0
33529614,fox28columbus,4843,48469,702,152852,0,5,3,8,following news weather traffic around central ohio beyond,trump blasts 'terrible chicago crime even though homicides amp shooting victims^watch live white house press briefing^president trump delivers remarks national electrical contractors association convention philadelphia^just in says multi vehicle crash sent four adults one child area hospitals the crash happened^amber alert an amber alert issued cleveland mom accused kidnapping four children one th^report ryanphillippe 'devastated 'false allegations domestic violence^report ben affleck jennifer garner settle divorce^report angelina jolie named bizarre lax terror threat sent police^koko gorilla knew sign language dies^just in kensington palace says prince charles walk meghan markle aisle royal wedding.^steve martin martin short 'colonoscopy parties tom hanks^just in danielle herrington cover model sports illustrated swimsuit issue she became thir^breaking former ceo roger ailes dead^meryl streep joins cast hbo 'big little lies season^meryl streep joins cast 'big little lies season^april giraffe pregnant aprilthegiraffe,3,13,10,16,0.1875,0.625,0
18648609,WPTV,1221,158562,1365,153268,1,7,3,5,breaking news south florida west palm beach palm beach county treasure coast follow team,two people found dead ohio swat standoff relating doctor homicide^fact checking last democratic presidential candidate debate new hampshire^obama campaign woos hispanics tv radio ads^just in vice president joe biden make statement rose garden :10 p.m^just in vice president joebiden make statement rose garden^uniform crime reports area agencies saw increase motor vehicle theft^uniform crime reports area agencies saw increase motor vehicle theft^uniform crime reports area agencies saw increase motor vehicle theft^channing tatum jenna dewan tatum announce separation^mariah carey they foiled^caitlyn jenner latest celebrity float run office^second suspect arrested murder rapper xxxtentacion broward sheriff office says^second suspect arrested murder rapper xxxtentacion broward sheriff office says^kaley cuoco marries fianc karl cook san diego horse stable^mila kunis makes monthly donations planned parenthood mike pence name^'game thrones stars kit harington rose leslie married,4,12,8,16,0.25,0.5,0
28179079,Chatelaine,2821,66554,1079,73839,0,0,4,12,food health style big ideas if matters canadian women matters chatelaine got story idea letters,it recently reported the royal family fond diana duchess cambridge sap^it recently reported the royal family fond diana duchess cambridge sap^famous women waxing shaving via^people excited meghan markle moment^courtney love warned women harvey weinstein via^canada rachel mcadams reportedly pregnant first child^this everything know far pippa middleton may wedding via^this everything know far pippa middleton may wedding gt via^everything know far pippa middleton may wedding far via^everything know far pippa middleton wedding pippamiddletonwedding via^alicia vikander michael fassbender reportedly married via^everything need know twinpeaks cult series returns tv tonight^everything need know twinpeaks cult series returns tv tomorrow^everything need know twinpeaks cult series returns tv sunday^everything need know twinpeaks cult series returns tv^did meghan markle show no then yes here actually went pippa middleton wedding,4,12,8,16,0.25,0.5,0
176439979,JackFMDFW,3054,5242,156,56179,0,0,4,12,everyoneagrees the80slivehere weekendsoundtrack mornings billykidd workdays drive home home game takemytickets,how brad pitt amp angelina jolie will split 500 million fortune^channing tatum and wife jenna dewan split after years of marriage^channing tatum and wife jenna dewan split after years of marriage^is paris jackson playing strip poker^beyonc turned down a role in the live action beauty and the beast as it was n't big enough^mario is no longer a plumber according to nintendo^pregnant serena williams poses nude vanity fair cover^julia louis dreyfus to be awarded the mark twain prize for american humor^here popular halloween candy state^kermit frog getting new voice years^priyanka chopra nick jonas are engaged^priyanka chopra nick jonas are engaged^air force veteran gets dying wish see 'star wars the last jedi granted complete escort darth vade^john cena nikki bella split six years together^beyonce eminem the weeknd headline coachella^ben affleck jennifer garner officially file divorce,4,12,8,16,0.25,0.5,0
16955991,Salon,5770,977544,15837,214973,0,6,5,5,the original online source news politics entertainment we instagram salonofficial,with barack obama soon gone white house twitter feed available a.m. tweetstorm two^with barack obama soon gone white house twitter feed available a.m. tweetstorm two^rudy giuliani says donald trump would agree interview mueller one catch^president donald trump implied could embarrass former top economic adviser gary cohn interv^the former white house press secretary sean spicer cracked top books amazon best seller^the former white house press secretary sean spicer cracked top books amazon best seller^ivanka trump why i disagree dad profile driving people crazy^ivanka trump why i disagree dad profile driving people crazy^ivanka trump why i disagree dad profile driving people crazy^amal clooney george clooney welcome twins boy girl^watch journalist joins salon discuss national geographic series america inside out tune in^rebels romantic streak lose tom petty dead^rebels romantic streak lose tom petty dead^the terrifying lena dunham joins cast american horror story season^judge declares mistrial bill cosby sexual assault case^judge declares mistrial bill cosby sexual assault case,5,11,6,16,0.3125,0.375,0
15694286,wfaa,4060,565621,3302,217806,0,0,5,11,at wfaa always pioneer we must boldly dare disrupt blaze trails untraveled celebrate lives north texans beyond,channing tatum jenna dewan announce separation^channing tatum jenna dewan announce separation^channing tatum jenna dewan announce separation^prince harry meghan markle apologize delayed royal wedding 'thank you cards^prince harry meghan markle apologize delayed royal wedding 'thank you cards^koko gorilla knew sign language dies^walmart remove 'cosmopolitan magazine checkout lines amid me too movement^walmart remove 'cosmopolitan magazine checkout lines amid me too movement^scott baio wife renee reveals microvascular brain disease diagnosis^scott baio wife renee reveals microvascular brain disease diagnosis^scott baio wife renee reveals microvascular brain disease diagnosis^legendary comedian don rickles dies age^veep actress julia louis dreyfus diagnosed breast cancer^reports priyanka chopra nick jonas engaged two months dating^cardi b confirms secretly married offset september 'engaged^april giraffe pregnant,5,11,6,16,0.3125,0.375,0
469194846,TwitchyTeam,3543,245859,3836,94080,0,3,5,8,twitchy human-powered twitter aggregator if news twitchy if news twitchy ahead,comcast cable 'hacked serves nothing sarah palin cpac speech^sit down dana loesch drops mic brian stelter total hypocrite fox news interview^breaking jim acosta loses title 'biggest turkey white house briefing room^did say purged bette midler goes full caps lock fangirl tweet hillary terrifies hellodolly cast^aging bald singer resorts cursing kim kardashian trashing rolling stone get attention^awkward chelsea clinton tries bonding megyn kelly national enquirer just embarrassing^awkward chelsea clinton tries bonding megyn kelly national enquirer just embarrassing^orwellian rewrite arne duncan take title ix reform megyn kelly make us thankful betsy devos^'weeping weiner anthony weiner sentenced months federal prison sexting minor^icymi meet ines rau playboy first transgender playmate^meet ines rau playboy first transgender playmate^donald trump star hollywood walk fame vandalized again maxine waters leads impeach chant^donald trump star hollywood walk fame vandalized again maxine waters leads impeach chant^game changer looks like gop actress stacey dash running congress california^they don t like black people leslie jones accuses ritz carlton racism^they don t like black people leslie jones accuses ritz carlton racism,5,11,6,16,0.3125,0.375,0
28595747,Chum1045,1960,31004,490,106089,0,0,5,11,kaye,it official gwen stefani amp blake shelton secretly planning surprise wedding^kim kardashian west welcomes third child^rdm coming :50 latest katy perry could dating plus robert pattinson new girlfriend shocked disgusted^aretha franklin funeral today featured performances^ed sheeran reveals 'love yourself was originally written for his new album 'divide via^lifetime has found their prince harry amp meghan markle via^nooooo scandal end after season report via^meet new cast reasons why season via^r amp m now question walk meghan aisle will walk tmz says meghan ma^nasa says astronauts will see star wars the last jedi space via^linkin park band members react chester bennington death via^north west amp penelope disick new pomeranian puppies are too cute via^george amal clooney pass out headphones flight with twins via^kendrick lamar open grammys with u2 dave chappelle via^'rent set fox next live musical via^louis tomlinson talks one direction hiatus critiques band mates via,5,11,6,16,0.3125,0.375,0
72327489,toitv,133,63429,89,86985,0,1,6,9,the official page television section tv times get latest updates favorite programs actors channels,rosamund pike chris o'dowd star state union^.a aprocky 'jealous new beau^a ap rocky 'jealous kendall jenner new beau^gets turned tyga son^gets turned tyga son^jennifer aniston n't help justin theroux prepare 'the leftovers^kylie jenner 'out spotlight till baby birth^big love star bill paxton family files wrongful death lawsuit^'this is us star justin hartley marries chrishell stause^'this is us star justin hartley marries chrishell stause^vanessa hudgens joins 'so you think you can dance judge^big bang theory star kaley cuoco marries boyfriend karl cook^big bang theory star kaley cuoco marries boyfriend karl cook^teri hatcher wants desperate housewives revival^khlo kardashian thinks getting nose job 'every day^ready tie knot tristan thompson,6,10,4,16,0.375,0.25,0
233732243,jenperos,882,3912,65,6506,0,0,6,10,two-time emmy winning entertainment journalist formerly,pics neri oxman steps out mit amid news her romance with brad pitt^she next jessica simpson shows big baby bump bridesmaid friend wedding via^exclusive kim kardashian kanye west last embryo baby no is boy is coming very soon^brad pitt angelina jolie reach new temporary custody agreement youngest children summer^this week us cover story all details brad pitt angelina jolie ongoing custody battle^exclusive brad pitt is spending quality time with his kids gets them every other day amid custody battle^breaking ronnie ortiz magro ex jen harley arrested domestic battery after allegedly dragging him with car^exclusive star jones marries ricardo lugo cruise ship bahamas^us exclusive dancing with stars pros emma slater sasha farber are married^meghan markle wants parents special role royalwedding day mother accompany^us exclusive haylie duff is pregnant with baby no^breaking amy schumer marries chef chris fischer surprise wedding after few months dating^us exclusive bachelor paradise derek peth taylor nolan are engaged bip^multiple sources confirm us michelle williams is engaged andrew youmans^brad pitt angelina jolie reach new temporary custody agreement youngest children summer^jennifer aniston spotted first time since split from justin theroux pic,6,10,4,16,0.375,0.25,0
14222518,NylonMag,1333,1174729,11381,76774,0,0,7,9,saying hello coolest people planet,x set star live action 'lady and the tramp alongside justin theroux^x set star live action 'lady and the tramp alongside justin theroux^people upset chrissy teigen egging kim kardashian latest tweetstorm^apologizes body shaming red shoes poster^apologizes body shaming red shoes poster^x set star live action 'lady and the tramp alongside justin theroux^selena gomez reportedly checked mental facility suffering emotional breakdown^share kiss new music video highly criticized track girls many found prob^great gender confirmation surgery shares first post surgery selfie^the title 'american horror story season revealed^karlie kloss engaged venture capitalist joshua kushner^karlie kloss engaged venture capitalist joshua kushner^taylor swift stalker sentenced years probation^taylor swift stalker sentenced years probation^lcd soundsystem gavin russom comes transgender^here first look ryan murphy americancrimestory,7,9,2,16,0.4375,0.125,0
158102435,979TheBox,937,183081,629,206251,0,0,7,9,houston official station interactive hip-hop r b enable alexa play -7-9 the box amazon echo,end of days trump warns north korea they will be met fire and fury^did kanye west make a diss track about donald trump^kanye west amp nick cannon squashed their beyond silly beef over kim kardashian^kanye west amp kim kardashian have one embryo left next baby will be a boy^kanye west returns to twitter with bizarre mind control video^blac chyna is suing the whole kardashian family for end of rob amp chyna^kanye west amp nick cannon squashed their beyond silly beef over kim kardashian^report scandal is coming to an end after seventh season^tom petty legendary rocker is dead^jamie foxx to host the bet awards^tamar braxton files for divorce from vincent herbert month before wedding anniversary^watch justin timberlake drops his video for say something with chris stapleton^camila cabello the roots and jimmy fallon perform havana with classroom instruments^jennifer hudson joins the voice as season coach^is phaedra parks returning to the real housewives of atlanta^bet hip hop awards the complete winners list,7,9,2,16,0.4375,0.125,0
374999591,PulseNigeria247,1233,96353,333,138519,0,2,7,7,nigeria new media publisher /7 live news videos entertainment sports lifestyle celebrities for ad enquiries contact ads.ng,a statement president senior special assistant media publicity malam garba shehu abuja satu^pulseexclusivewithkaidiekmann first interview former us president george w. bush took years get^icymi straight nysc camp davido thrilled fans energetic performance jay z made in america f^kim kardashian goes nude promotion new makeup brand^power couple kim kardashian kanye west allegedly struggling stay married kimye^odd enough kate middleton cut hair people freaking^viral video confesses cheating pregnant wife refuses blackmailed video source^the business beauty spotlight thanks kylie jenner pat mcgrath labs makes exciting annou^sexy forever ... heidi klum thin sexy body bared polka dot bikini^beauty beast beyonce turned role live action remake^pirates caribbean dead men tell no tales movie premieres nigeria photos^meghan markle dad wo n't attend royal wedding gt gt^blac chyna model granted temporary restraining order rob kardashian^bet awards check complete winners list^bet awards check complete winners list^kim kardashian shares first photo nd daughter chicago west,7,9,2,16,0.4375,0.125,0
36756075,Variety_Film,6,88062,2960,44434,0,0,9,7,film coverage variety,george clooney narrate shimon peres documentary exclusive^hollywood mourns death legendary harry dean stanton the definition cool^telluride film review nicole kidman destroyer^oscars from hugh jackman nicole kidman lead acting races take shape telluride^mamma mia here we go again director ol parker casting cher i refused contemplate anyone else^chloe grace moretz gina gershon step korea red shoes^angelina jolie breaks her silence difficult brad pitt divorce^margot robbie matthias schoenaerts star world war ii thriller ruin^lost city z director gave up completely one point charlie hunnam robert pattinson film^jada pinkett smith calls raunchiness girls trip beautiful thing^barbra streisand had her beloved dog samantha cloned meet miss scarlett miss violet^matt damon apologizes sexual misconduct comments i really wish i listened^harvey weinstein pleads not guilty additional sexual assault charges^scarlett johansson exits trans film rub tug amid backlash^first aquaman trailer makes splash comic con^colin trevorrow will return direct jurassic world,9,7,-2,16,0.5625,-0.125,1
474055087,TheEveningTimes,7818,66905,557,172601,0,0,9,7,scotland top-selling evening paper got story call us email news.co.uk,david cassidy fighting memory loss wants 'enjoy life^david cassidy fighting memory loss wants 'enjoy life^baftas here full list award winners^baftas here full list award winners^charmed star shannen doherty staying positive cancer test results^check gorgeous pics taylor swift pda packed holiday calvin harris^kris jenner defends life of kylie amid criticism^kris jenner defends life of kylie amid criticism^sir billy connolly says would recognise michael parkinson 'in diving suit 'dulled brain comments^love island star sophie gradon dead^meghan markle dad not attend royal wedding amid staged paparazzi photos storm^meghan markle dad not attend royal wedding due heart op^meghan markle dad not attend royal wedding due heart op^meghan markle dad not attend royal wedding due heart op^kylie jenner gives birth first child travis scott^billboard music awards stars pay tribute avicii,9,7,-2,16,0.5625,-0.125,1
15021918,TexasObserver,2985,56291,1677,36254,9,7,0,0,sharp reporting texas news politics culture since subscribe,in dizzying two weeks texas ag commissioner sid miller cattle spray boxes closed reopened with^in dizzying two weeks texas ag commissioner sid miller cattle spray boxes closed reopened with^in dizzying two weeks texas ag commissioner sid miller cattle spray boxes closed reopened with^for last two weeks texas agriculture commissioner sid miller choreographed dizzying si cattle^for last two weeks texas agriculture commissioner sid miller choreographed dizzying si cattle^for last two weeks texas agriculture commissioner sid miller choreographed dizzying si cattle^gop primary race texas ag commissioner far incumbent sid miller blasts challenger trey blocker stumping^gop primary race texas ag commissioner far incumbent sid miller blasts challenger trey blocker stumping^gop primary race texas ag commissioner far incumbent sid miller blasts challenger trey blocker stumping^gus dsa tends support proposals left edge democratic party like 15 minim^andr s manuel l pez obrador former mayor mexico city running third presidential campaign bernie sand^to pull largest gotv effort state history turned top architects^andr s manuel l pez obrador former mayor mexico city running third presidential campaign bernie sand^to pull largest gotv effort state history turned top architects^to pull largest gotv effort state history turned top architects^the beto campaign turned presidential bid breeding ground digital organiz,9,7,-2,16,0.5625,-0.125,1
41962111,xoxoLizza,7517,31931,1149,186356,0,1,9,6,actor/tv host/contentcreator/keynote speaker/travel vlogger/best selling author*tecla awards winner `` best live creator '' 2016 *repped icm partners,political tv ad archive preserves lies ages^justin bieber reveals real reason why his relationship with selena gomez did n't last fashionfiles^chrissy teigen plastic surgery everything about me is fake except my cheeks fashionfiles^chrissy teigen opens up first time about her postpartum depression fashionfiles^ivanka trump us weekly cover inspires 'why i disagree with my dad memes fashionfiles^everything that happened backstage after bindi irwin derek hough won dancing with stars fashionfiles^hailee steinfeld is not here those rumors that she dating justin bieber fashionfiles^taylor swift calvin harris just shared bunch gorgeous photos from their romantic vacation fashionfiles^celebrities react president barack obama farewell address fashionfiles^jenna dewan tatum will host jennifer lopez *world dance* competition show fashionfiles^lauren conrad husband william tell welcome baby boy fashionfiles^mila kunis makes monthly donations planned parenthood mike pence name fashionfiles^meghan markle was n't allowed sit next prince harry pippa middleton wedding reception fashionfiles^a 'grey anatomy spin off is coming abc fashionfiles^blake lively shuts down reporter who asked her question about fashion fashionfiles^ben affleck jennifer garner officially file divorce fashionfiles,9,7,-2,16,0.5625,-0.125,1
15250661,newscomauHQ,4287,508253,3450,221053,1,0,9,6,australia number one news site bringing latest breaking news australia around world,george w. delivered emotional eulogy tearing end praised dad died age when the^the real reason jennifer aniston justin theroux split^the reason fergie josh duhamel split^viewers tears nicole kidman message keith urban^jennifer lawrence slammed hurricane jab donald trump^jessica simpson leaving husband birthday party deeply relatable^emma husar hit back unfounded allegations replicated sharon stone move basic instinct saying sl^brody jenner slams caitlyn missing wedding^matt lauer replaced female line^caitlyn jenner liberated final surgery^khloe kardashian makes first public appearance since pregnancy news^superman star margot kidder dead^happy days star erin moran dead^revealed hugh hefner cause death^bradley cooper irina shayk welcome first child^he caught camera cheating multiple women looks like khloe kardashian might ready take trista,10,6,-4,16,0.625,-0.25,1
15727192,965tic,442,3740,133,39341,0,0,10,6,today best variety tic entercom station listen live app onair mac,son asahd pretty cool birthday party plus breakdown gon na problem for^congratulations prince harry meghan markle another royal baby way^fight ... band aid lol plus tom hardy talks deleted scene from^weighs v feud^weighs v feud^you guys get engaged bday^fight ... band aid lol plus tom hardy talks deleted scene from^when 're rich af spoil also rich af mom bday ... bought^fight ... band aid lol plus tom hardy talks deleted scene from^selenagomez emotional breakdown justinbieber haileybaldwin wedding^visited seattle children hospital sing christmas carols kids omg hearts^comes pansexual if person great person great i lik^icymi david foster engaged dirtylaundry^nikki split six years^stormy receipts plus trump jr. hooked aubrey o'day and details prince harry meghan markle w^taylor swift releases new song call it what you want,10,6,-4,16,0.625,-0.25,1
740882012,BuzzFeedCeleb,88,80662,1012,27747,0,0,11,5,celebrity buzzfeed way in gosling we trust,liam hemsworth scared miley cyrus and her reaction is basically all of us^kim kardashian left a ~dirty~ comment on kanye west instagram and people are freaking out^kim kardashian defended kanye for wearing a maga hat and yes everyone freaking out^liam hemsworth scared miley cyrus and her reaction is basically all of us^there a tennis player who looks like liam hemsworth and i need to talk about it^john krasinski talking about emily blunt and their daughters will make your heart melt^john krasinski travelled miles every weekend to see emily blunt and their kids when they were separated for fi^britney spears was terrified when a man rushed onto the stage during her vegas show^kim kardashian left a ~dirty~ comment on kanye west instagram and people are freaking out^katie holmes and joshua jackson were touchy at the dawson creek reunion and people are losing it^jennifer lawrence says she still terrified from that nude photo hack^celebrity fashion trends sadly make comeback^ariana grande just confirmed her breakup with mac miller and idk why but i 'm very sad^mac miller has broken his silence on his breakup with ariana grande and her engagement^priyanka chopra and nick jonas are officially engaged and have the roka ceremony pics to prove it^omg groot is actually dead and baby groot is his son,11,5,-6,16,0.6875,-0.375,1
39708979,CosmopolitanSA,1088,329555,461,56862,0,0,12,4,cosmopolitan south africa quintessential go-to fun fearless females reaching millions women month,kim kardashian defends kylie jenner amid controversy over her 'forbes cover^kim kardashian defends kylie jenner amid controversy over her 'forbes cover^kim kardashian defends kylie jenner amid controversy over her 'forbes cover^channing tatum jenna dewan tatum split after years marriage^channing tatum jenna dewan tatum split after years marriage^younes bendjima says 'f*ck your hollywood bullsh*t insta amid kourtney kardashian breakup news^younes bendjima says 'f*ck your hollywood bullsh*t insta amid kourtney kardashian breakup news^katy perry just shaded taylor swift 'american idol^kim kardashian just went braless sheer spandex jumpsuit date night kanye^selena gomez reveals kidney transplant^katy perry just shaded taylor swift 'american idol^this bonus keeping up with kardashians clip brings drama^cosmocelebnews enrique iglesias anna kournikova welcome twins after dating years^karlie kloss just got engaged joshua kushner love is real alive^it confirmed katharine mcphee david foster are engaged^all signs channing tatum jenna dewan were headed split,12,4,-8,16,0.75,-0.5,1
16027675,POPSUGARUK,1306,46882,509,82926,0,0,12,4,popsugar uk delivers insider access celebrity lifestyle content daily basis,angelina jolie mum it strange i never wanted baby^angelina jolie mother it strange i never wanted baby^angelina jolie brad pitt agree keep divorce private committed act united front^jennifer lopez may new boyfriend life^fifty shades darker jamie dornan dakota johnson take behind scenes^anmer hall going busy christmas^anmer hall going busy christmas^anmer hall going busy christmas^anmer hall going busy christmas^we 're excited prince harry meghan markle^fifty shades darker jamie dornan dakota johnson take behind scenes^kourtney kardashian scott disick reportedly back together^mel b files divorce stephen belafonte nearly years marriage^are nina dobrev glen powell dating their sweet friendship could something^if use dry shampoo morning 're wrong^things probably n't know disney mulan,12,4,-8,16,0.75,-0.5,1
16558491,FM98WJLB,12134,44183,339,49081,0,0,12,4,the d hip-hop r b,karrueche tran granted five year restraining order against chris brown^celebrities react nelsan ellis dead at^kanye west shares texts with caitlyn jenner amid her feud with kardashians thebushmanshow^beyonce not demanding silent delivery room despite report^chris brown slammed by judge for skipping karrueche tran court hearing^halle berry not pregnant at despite reports^beyonce birth twins still hospital 'minor issue^karrueche tran granted five year restraining order against chris brown^the weeknd split with selena gomez caused him to scrap an upbeat album thebushmanshow^shots fired at tekashi ix9ine kanye west nicki minaj music video shoot thebushmanshow^chris brown urges fans to donate to year old boy 'new legs gofundmehttp //^mariah carey not dating both nick cannon and bryan tanaka despite report^alex rodriguez year old daughter sings for jennifer lopez photos^here the complete list of bet awards winners^the narwhal frappuccino is here it tastes like pink starburst^'black panther is officially the most tweeted about movie of all time via,12,4,-8,16,0.75,-0.5,1
2817144043,NarcityCanada,733,11238,277,28752,0,0,12,4,your daily canadian news source everything breaking city,chris pratt has been spotted dating someone new after admitting that he still not over anna faris canada^meghan markle dad believes that she miserable in the royal family and here why canada^the surprising timeline of prince harry amp meghan markle relationship canada^selena gomez and justin bieber confirm relationship rumours with their first public kiss in years canada^chris pratt has been spotted dating someone new after admitting that he still not over anna faris canada^bella hadid and the weeknd have not stopped texting and facetiming since his split with selena gomez canada^caitlyn jenner ex wife just publicly shaded her for skipping brody wedding canada^brody jenner reveals his disappointment in public statement after caitlyn jenner bails on his wedding canada^caitlyn jenner reveals the real reason why she wo n't be attending her son brody jenner wedding canada^blac chyna is suing the entire kardashian family for everything they 're worth canada^kim kardashian just threw north west and penelope disick a crazy birthday party and we 're jealous af canada^fans are convinced that kourtney kardashian and scott disick are getting back together and here why^one of the women tristan thompson cheated on khloe kardashian with is now claiming she pregnant^prince harry and meghan markle are as good as engaged here when they 'll announce the news canada^here everything we know about khloe kardashian pregnancy so far canada^meghan markle has officially picked her wedding dress designer canada,12,4,-8,16,0.75,-0.5,1
20510539,Emirates247,173,492810,1147,207912,0,1,13,2,vibrant dynamic online news website provides first-rate news uae use,trade war casualty us cheap prices everyday goods ..^justinbieber 'upset selenagomez hospitalisation^fergie josh duhamel split via^samanthamarkle happy meghanmarkle pregnancy^katy perry super bowl halftime 'roaring raunchy act^superbowl halftime 'roaring raunchy act ...^brad pitt 'committed making marriage work^justinbieber 'upset selenagomez hospitalisation^brad pitt oldest son snubbed visit hour ago^kuwtk kylie jenner misses american music awards dog gives birth^kim kardashian kanye west secretly getting married week^jay z views kanye west 'pesky fly via^jennifer aniston casually dating via^brad pitt 'has crying devastated angelina jolie divorce^bradley cooper irina shayk welcome first child^ben affleck jennifer garner officially file divorce,13,3,-10,16,0.8125,-0.625,1
25242529,HotMomsClubBuzz,1054,25036,175,40177,0,0,13,3,hot moms club philosophy simple you best mom unless you are the best you business inquiries media-advertising.com,alex rodriguez might already cheating jennifer lopez^brad pitt admits jennifer aniston is love his life and wants to restart his relationship^when see someone like kate middleton stroll hospital hours giving birth looking like million^what the new ruling means in the brad pitt and angelina jolie custody case^are kourtney kardashian scott disick neglecting their kids while they cannes^i don enjoy being single angelina jolie her split from brad pitt^angelina jolie finally breaks her silence brad pitt divorce^she also bizarre connection angelina jolie^looks like moving also bizarre connection angelina jolie^looks like moving also bizarre connection angelina jolie^blac chyna is suing entire kardashian family for defamation^angelina jolie desperate to work with justin theroux after jennifer aniston split^kanye west has 'elosive fights with kris jenner and even kim kardashian ca n't 'control him^khloe kardashian gives first sneak peek at baby true thompson^simon cowell rushed hospital after accident his home^kim kardashian breaks her silence khlo kylie jenner pregnancy rumors,13,3,-10,16,0.8125,-0.625,1
227186327,kiis1011,813,12868,126,40148,0,0,13,3,change station change life morning -9am drive home -6pm kiis1011 keepkiisloud,looks like miley cyrus liam hemsworth wedding summerfling jcentertainment^there some serious evidence that justin bieber and hailey baldwin are already married read^family member confirms hailey baldwin and justin bieber are already married read m^mins jane entertainment news ... preggers does want back amp honeymoon^the top celebrity feuds v it could well biggest summe^the top celebrity feuds v it could well biggest summe^bachelor in paradise some cast members confirmed kiis1011 melbourne keepkiisloud^bachie fave brittany hockley reportedly confirmed for 'bachelor in paradise read gt gt gt^the bachelor cassandra wood brooke blunton confirmed bachelor in paradise season two read mo^g'day prince harry meghan markle the royals officially touched sydney could n't exc^back happier she checked month rehab reportedly^back happier she checked month rehab reportedly^the top celebrity feuds v it could well biggest summe^superman star margot kidder dead at head kiis1011 website details^reports meghan markle dad attend royal wedding needs major heart surgery tomorrow^icymi nick jonas and priyanka chopra are reportedly engaged after months of dating read,13,3,-10,16,0.8125,-0.625,1
17495946,carlmalamud,1188,14258,828,53695,14,2,0,0,archivist usually civil servant founder open source america operating system code swaraj,"i would delighted donate copy html work staff mi^fair use are absolutely kidding it work government u.s. congression^graphics code federal regulations converted svg mathml^aera organization sued posting standard high stakes testing incorporated cod^to clear goal post unabridged code federal regulations the whole law nothing law because public safety matters^in world pages drop bucket guess i try open code federal regulat^we use ,000 standards part code federal regulations vital functioning public safety but sell^my foia reform doc incorporated code federal regulations plead exemption^first batch graphics code federal regulations converted svg this public domain help^april update code federal regulations graphics ,072 graphics svg formulas t^looking graphics code federal regulations here random ones vein^counting ,903 gif files code federal regulations have already .svgs wondering make american regs vector^if eliminate code federal regulations guess incorporation reference code federal regulations moot point obe^standards incorporated code federal regulations force law cost purchase hurts nexteconomy^in world pages drop bucket guess i try open code federal regulat^of c span videos hearings i able find official gpo transcripts gpo congress way behind record",14,2,-12,16,0.875,-0.75,1
14094741,someecards,758,2042139,11197,81404,0,0,15,1,welcome twitter feed somewhat internationally acclaimed humor site you love unfollowing us,kim kardashian defends kylie jenner status self made billionaire 'we self made '^khloe kardashian mom shamed something 've probably done kid^twitter responds ivanka trump why i disagree with my dad cover meme ing oblivion.^twitter responds ivanka trump why i disagree with my dad cover meme ing oblivion.^channing tatum jenna dewan announce separation emotional instagram people ca n't deal.^one direction says donald trump kicked hotel refusing meet daughter.^jamie foxx friend confirms know katie holmes dating^kylie jenner destroyed rumors daughter 'real dad two words^katy perry throws subtle shade taylor swift american idol^angelina jolie faces backlash 'traumatizing impoverished kids bizarre casting scheme.^angelina jolie faces backlash 'traumatizing impoverished kids bizarre casting scheme.^rob kardashian kylie jenner suing blac chyna assault this story never ends^rob kardashian kylie jenner suing blac chyna assault this story never ends^celebrities react president obama farewell address obamafarewell^katy perry throws subtle shade taylor swift american idol^emilia clarke reveals mom pranks ruining sex life,15,1,-14,16,0.9375,-0.875,1
14412533,CillizzaCNN,3483,664358,9880,134755,0,14,1,0,`` one dumber least respected political pundits '' -- donald trump `` a f* -ing mouth breather '' -- roseanne barr,transcript the post univision democratic debate annotated^missed democratic debate last night we n't get caught annotated transcript^the brooklyn democratic debate transcript annotated^missed democratic debate check awesome annotated transcript^missed last night democratic debate no worries we annotated transcript^are nostalgic rd presidential debate take stroll annotated transcript^the cnn miami republican debate transcript annotated^here full transcript final presidential debate^the brooklyn democratic debate transcript annotated^the eye popping lines donald trump 'fox news sunday interview^i thought interview john mccain worth bookmarking^the trump speech cincinnati trumpian^leading tonight point newsletter the disappearing white house press briefing subsc^romney restore future ad spending il week million santorum red white blue fund ad spending il k. wow^the secret donald trump rudy giuliani know russia probe,1,14,13,15,0.06666666666666668,0.8666666666666667,0
15520253,news4buffalo,644,169371,1170,217346,0,14,1,0,buffalo news leader newsroom.com -876-7333,the report centers disease control prevention finds state local health departmen^a disease gotten recent attention western new york acute flaccid myelitis rise since^officials centers disease control prevention say cases polio like illness inves^midterms president trump election campaign republican national committee donating funds^election the democratic party begun conversations television networks series presidential^election the democratic party begun conversations television networks series presidential^preview tonight debate challenger watch the^video watch gov cuomo marc molinaro debate tonight pm wivb see more^the report centers disease control prevention finds state local health departmen^a disease gotten recent attention western new york acute flaccid myelitis rise since^officials centers disease control prevention say cases polio like illness inves^thanksgiving almost week away consumer reports calling u.s. department agriculture identif^a continuing investigation cdc several states us department agriculture animal plant health^zoo officials said human injuries four alpaca one emu one fox nearby habitats attac^officials holding press conference rescue miners salt mine near ithaca watch,1,14,13,15,0.06666666666666668,0.8666666666666667,0
15483453,WSBT,8348,81084,595,155545,1,14,0,0,first fast accurate welcome wsbt-tv this home twitter latest news weather notre dame sports,"many people looking back life former president george h.w bush died last week at notre dame t^the centers disease control prevention cdc warning parents summer the cdc said drowning i^should young children vaccinated an estimated ,000 young children vaccination of^despite news reports centers disease control prevention n't warn people dressing c^the centers disease control prevention says people states gotten sick e. coli outb^should young children vaccinated an estimated ,000 young children vaccination of^despite news reports centers disease control prevention n't warn people dressing c^the centers disease control prevention says farmers killing twice rate veterans.^watch live vice president joe biden make statement rose garden :10^president obama delivering speech economy today knox college galesburg ill. watch^the top democrat senate judiciary committee released transcript interview co founder^president obama delivering speech economy today knox college galesburg ill. watch^recall alert ,028 pounds jimmy dean frozen sausage links recalled may contain extraneous m^watch hosting thanksgiving feast year the u.s. department agriculture tips prepare a^watch live president trump remarks national electrical contractors assoc philadelphia",1,14,13,15,0.06666666666666668,0.8666666666666667,0
15631338,wwmtnews,331,56006,606,97110,0,13,1,1,live local breaking news,the u.s. energy information administration forecasts percent increase spending heating oil mod^we deserve answers this tightly controlled sanitized epa deq meeting unacceptable missed opp^a recent report centers disease control prevention found diseases spread mosquitoes^kellogg contacted food drug administration centers disease control prevention regard^president donald trump tweeting golf blaming predecessor election hacking hate watching cnn^trump wide ranging interview aired fox news sunday praised kelly work ethic much he^the u.s. energy information administration forecasts percent increase spending heating oil mod^the men women states run republican national committee best avoid topic of^us department education opens investigation handling larry nassar sexual abuse complain^a transcript oval office interview fri president donald trump ap white house correspondent julie pace^the u.s. energy information administration forecasts percent increase spending heating oil mod^newly allocated funding u.s. department agriculture supports michigan farming efforts marketi^the u.s. department agriculture food safety inspection service announced saturday nov. produc^royalwedding meghan markle impending nuptials prince harry inspired royal hybrid strain cannabi^prince charles walk meghan markle aisle royal wedding,1,14,13,15,0.06666666666666668,0.8666666666666667,0
585466175,uDiscoverMusic,1981,22671,429,65278,0,0,1,14,dig deeper music love ...,soundtrack album for bradley cooper a star is born co starring set for release^sad news ... frightened rabbit frontman scott hutchison found dead^sad news ... frightened rabbit frontman scott hutchison found dead^sad news ... frightened rabbit frontman scott hutchison found dead^rip swedish dj avicii dead at^rip swedish dj avicii dead at^announces las vegas residency for^announces las vegas residency for^announces las vegas residency for^announces las vegas residency for^announces las vegas residency for^announces las vegas residency for^announces las vegas residency for^announces las vegas residency for^announces las vegas residency for,1,14,13,15,0.06666666666666668,0.8666666666666667,0
17906632,WTOP,943,281604,3211,316754,1,7,1,6,news traffic weather on-air online mobile,transcript sen. jeff flake speech senate^transcript sen. jeff flake speech senate^a new report centers disease control prevention cdc finds certain occupations associate^rep. jerrold nadler d n.y. told abc news chief anchor george stephanopoulos this week sunday we could^rep. jerrold nadler d n.y. told abc news chief anchor george stephanopoulos this week sunday we could^otd first ever debate presidential nominees took place democrat john f. kennedy republ^a new report centers disease control prevention cdc finds certain occupations associate^the social security administration lists popular baby names state^mariah carey new year eve performance they foiled^james franco denies sexual misconduct allegations^brady bunch house sale nearly 1.9 million^colin trevorrow back direct jurassic world^reports say kylie jenner pregnant first child^your morning whoa msnbc co hosts joe scarborough mika brzezinski engaged^april giraffe whose pregnancy became internet sensation pregnant,2,13,11,15,0.13333333333333333,0.7333333333333333,0
15923226,cspanwj,5297,63547,1968,41186,1,13,1,0,c-span morning call-in program live every day -10am et guests taking calls texts tweets join conversation,coming up| the house representatives starts legislative business today first wj thoughts^icymi r ny pres trump correcting modifying statement yesterday summit mon^on the phone american society civil engineers casey dinges organization review u.s. infrastruc^league conservation voters victory fund president gene karpinski discusses group midterm spending supp^sat| gene karpinski discusses league conservation voters role elections tune a^report a guide social security medicare trustees reports via bipartisan^author former bernie sanders presidential campaign manager jeff weaver discusses future democratic p^watch brookings institution research amp foreign policy program director discusses deal struc^brookings institution research amp foreign policy program director michael o'hanlon discusses latest the^read on air trump delivers campaign style speech at veterans of foreign wars convention via^viewercall indiana resident weighs debate issue censorship amp speech society asking^on the phone las vegas review journal reporter ramona giwargis discusses president trump campaign rally later to^report income poverty health insurance coverage united states via^health insurance coverage united states via^trump rescinds rules bathrooms transgender students via,2,13,11,15,0.13333333333333333,0.7333333333333333,0
16686144,nytopinion,1419,704036,7876,158429,0,12,3,0,we amplify voices issues matter tell us think letters.com,the presidential campaign history debate future democratic party getting started^have heart people ca n't get writes betsy b comment column let them eat tru^why ca n't democrats convince voters plain noses faces tax cutting champio^donald trump vowed speech republican national convention protect gay transgender ameri^president trump shown unwilling unable defend america russian campaign divide un^president trump shown unwilling unable defend america russian campaign divide un^president trump shown unwilling unable defend america russian campaign divide un^president trump shown unwilling unable defend america russian campaign divide un^bonica among advanced democracies turnout national elections strong predictor income inequality^bonica among advanced democracies turnout national elections strong predictor income inequality^for white house briefing room come serve weird hybrid contraption self promotion part s^i interviewed cooper reviewed trial transcripts documents spoke innumerable people re^the wedding meghan markle prince harry sure fairy tale actually like ame^the wedding meghan markle prince harry sure fairy tale actually like ame^the wedding meghan markle prince harry sure fairy tale actually like ame,3,12,9,15,0.2,0.6,0
15553222,consequence,2305,205847,5173,149218,0,0,3,12,music film pop culture publication,donaldtrump bastion american morality blasts filthy stephencolbert you kids watching^larrydavid snl opening monologue draws ire anti defamation league offensive insensitive amp unfunny^for th anniversary americanidol revisit time kanyewest actually auditioned gold digger^following tragic death first husband heath ledger michelle williams said never gave love^katyperry announces details new album witness plus dates extensive north america tour^icymi katyperry announces fifth studio album witness along tour dates^ellen page accuses brett ratner homophobic abusive behavior set x men the last stand^comedian louisck accused sexual misconduct five women according new report^louisck accused sexual misconduct five women^justintimberlake announces new album man woods release super bowl appearance so^lady gaga announces multi year las vegas residency featuring two unique shows gagavegas^lady gaga announces date las vegas residency featuring two unique shows gagavegas^icymi eminem beyonce theweeknd set headline coachella according industry sources^sources eminem beyonce theweeknd headline coachella coachella2018^breaking demilovato reportedly hospitalized suffering apparent heroin overdose,3,12,9,15,0.2,0.6,0
17994536,KATUNews,1084,200432,2238,212629,0,7,3,5,the latest news information portland oregon sw washington livestream,according data released federal centers disease control prevention oregon residents underwent^a new study u.s. department education says kids washington schools chronically absent like never^watch live president speaks national republican congressional committee annual march di^according data released federal centers disease control prevention oregon residents underwent^live white house press briefing sarah huckabee sanders amid putin summit backlash^in progress white house holds press briefing president trump signs veterans bill pardons alice marie johnso^philadelphia ap democratic national committee offers incere apology sanders supporters 'inexcusable remarks emails^trump warns north korea 'fire fury attack guam threatened^fergie josh duhamel announce split years marriage^meghan markle half brother son oregon cannabis grower develops royal strain 'markle sparkle in^mario batali includes cinnamon roll recipe apology sexual misconduct^meghan markle dad reportedly wo n't attend royal wedding staging photos liveonk2^fergie josh duhamel announce split years marriage^britain royal officials say prince harry asked elder brother prince william best man wedding nex^reports kylie jenner pregnant liveonk2,3,12,9,15,0.2,0.6,0
15308015,WGRZ,2098,185485,1192,198160,0,3,3,9,on your side wgrz-tv buffalo ny news station holds people power accountable,the fda wants hear chronic pain patients challenges face getting treatment nation de^across nation states face similar poverty problems in new york poverty stricken city faces^speaks republican amp democratic analyst take second presidential debate^katie couric breaking silence former today show co host matt lauer month firing f^emmy awards the winners list^live video press conference salt mine rescue ithica ny^what think walmart decision remove 'cosmopolitan checkout lines^scott baio wife renee reveals microvascular brain disease diagnosis^scott baio wife renee reveals microvascular brain disease diagnosis^scott baio wife renee reveals microvascular brain disease diagnosis^it october st know means ... time freeform nights halloween click a^former fox news ceo roger ailes dead^veep actress julia louis dreyfus diagnosed breast cancer^veep actress julia louis dreyfus diagnosed breast cancer^prince william prince harry best man royal wedding,3,12,9,15,0.2,0.6,0
14708814,hartfordcourant,564,160508,1850,124867,1,1,2,11,connecticut breaking news sports politics state largest newsroom america oldest continuously published newspaper,a fake photo emma gonz lez went viral far right parkland teens villains^four injured one critically drive shooting hillside ave. hartford wednesday night^channing tatum wife jenna dewan tatum announce split^photo gallery the many feuds david letterman palin o'reilly oprah madonna ...^julia louis dreyfus awarded mark twain prize american humor^'jesus christ superstar set nbc next live musical^'jesus christ superstar set nbc next live musical^scott hutchison frightened rabbit frontman found dead^snl cast member pete davidson got hillary clinton tattoo she says 'honored^erin moran star 'happy days 'joanie loves chachi found dead indiana^erin moran star 'happy days 'joanie loves chachi found dead indiana^erin moran star 'happy days 'joanie loves chachi found dead indiana^jennifer hudson taylor swift james corden cast 'cats movie^taylor swift announces new album 'reputation first single drops tomorrow night^icymi 'morning joe co hosts mika brzezinski joe scarborough engaged,3,12,9,15,0.2,0.6,0
20402945,CNBC,729,3270143,28126,306641,0,9,4,2,first business worldwide,the united states likely succeed shutting world trade organization supreme court other^a criminal inquiry sought hillary clinton use private email^rudy giuliani conducting question answer sessions president donald trump prepare intervie^rudy giuliani conducting question answer sessions president donald trump prepare intervie^a majority voters believes inappropriate nfl players kneel playing national anthe^watch barack obama speaks las vegas campaign rally nevada democrats^melania trump make first public appearance outside white house nearly month she join presid^one four teens smartphone but hidden costs entering digital world early^china accused us bullying warned would hit back trump administration raised stakes t^here many americans watched royal wedding prince harry meghan markle^millions americans woke early tune royal wedding prince harry meghan markle million^angelina jolie accuses brad pitt paying 'meaningful child support court docs^angelina jolie accuses brad pitt paying 'meaningful child support court docs^first lady melania trump returns white house kidney surgery^the weinstein company file bankruptcy,4,11,7,15,0.26666666666666666,0.4666666666666667,0
301309392,eNCA,865,1990972,2646,318280,0,7,4,4,enca -hour news channels focusing news across sa africa live look enca youtube,president cyril ramaphosa responded pravin gordhan leaked submission statecaptureinquiry according to^opinion the french team one hundred percent french by georgina guedes^opinion the french team one hundred percent french by georgina guedes^the debate e tolls continues rage road gauteng premier makhura says anc pro^the south african jewish board deputies weighed shashinaidoo saga saying disappointed h^ahead debate democratic alliance made clear would take legal action stop moves change s^two suspects appearing court connection murder bonga mkhize anc youth league leader kw^enca trump warns north korea 'fire fury^watch missed prince harry meghanmarkle tying knot no worries you watch royalwedding yo^david beckham face trial speeding^david beckham face trial speeding^enca jennifer hudson joins the voice season coach^talk show host seth meyers host golden globes^enca taylor swift announces new album 'reputation^weinstein company file bankruptcy board,4,11,7,15,0.26666666666666666,0.4666666666666667,0
20632528,MichaelAusiello,1655,1057955,8368,59958,0,0,4,11,president editorial director,americanidol finale who will win season and who *should* win via^americanidol finale recap did right singer win season via^shannen doherty defends charmed reboot 'i would implore everybody be little bit kinder cw series^mariah carey taking 'break wake new year show 'they foiled me via^breaking modernfamily renewed two seasons abc closes deal seasons and^americanhorrorstory season photos everything we know about ahsapocalypse so far via^bachelorinparadise season cast revealed which 'favorites are returning via^americanhorrorstory season title revealed ahscult^outlander renewed seasons *and* plus see first season photos find out when it 'll return^fullerhouse renewed season via^jennifer hudson joins thevoice coach season via^theoriginals end after season via^first look glee boss ryan murphy new nbc comedy series the new normal^first screamqueens teaser slasher comedy looks bloody fun via^americanhorrorstory lena dunham joins season cast via,4,11,7,15,0.26666666666666666,0.4666666666666667,0
25626894,AOLLifestyle,1262,370508,3090,122163,0,3,4,8,aol lifestyle ultimate destination everything style food health living,the popular baby names every us state^here popular baby names every us state^most popular baby names state^couple gets shock lives exit hospital kate middleton gave birth^meghan markle broke royal protocol thigh high slit australia twitter happy^people really excited see meghan markle old style back^lindsay lohan wears hijab sparking mixed feelings social media^'fixer upper stars chip joanna gaines address reports sold texas farmhouse^princess charlotte smiles first day nursery school photos taken duchess kate^swedish royals princess sofia prince carl philip welcome baby no^check craziest billboard music awards red carpet looks time bbmas^check craziest billboard music awards red carpet looks time bbmas^meghan best friend jessica mulroney pippa middleton royal wedding^meghan markle reportedly wears black dress pippa middleton wedding reception^labor day the best sales shop,4,11,7,15,0.26666666666666666,0.4666666666666667,0
15606755,CBS12,697,112144,1037,175763,0,6,4,5,covering palm beach martin st. lucie indian river okeechobee got newstip email us newstips.com 81-0796,update woman says accidentally fell moving suv tampa her statement investigators^warning centers disease control prevention officials investigating multi state outbreak salmonell^sen. nelson wants gov scott remove florida recount process news conference response from^happening now vigil held victims chicago hospital shooting^watch live hillary clinton give victory speech campaign rally las vegas^watch live white house press briefing^angelina jolie brad pitt prenup splits properties custody battle eected future 400 million fortune..^mariah carey new year eve performance 'they foiled^mariah carey finally speaks new year eve performance 'they foiled^watch chants 'fake news protest outside broward county board elections lauderhill.^james franco denies sexual misconduct allegations^third suspect arrested xxxtentacion murder^breaking third suspect arrested xxxtentacion murder^breaking reports former fox news ceo roger ailes dead^reports kylie jenner pregnant boyfriend travis scott,4,11,7,15,0.26666666666666666,0.4666666666666667,0
2740939937,NetflixLifee,1237,84802,418,30583,0,0,4,11,twitter account netflix fan site find us facebook,the crown cast new prince charles queen mother princess anne^the crown leading ladies could play princess diana^leading ladies could play princess diana next seasons the crown^sophie turner princess diana the crown that sounds good us^beauty beast coming netflix september spreadtheword^beauty beast one best movies coming netflix september full list movies^things officially renewed season^icymi after kevin spacey firing house cards looking killing frank underwood new season^house cards eloring ways kill kevin spacey frank underwood character^following kevin spacey dismissal house cards eloring ways move without frank underwood^icymi netflix renewed season^renewed season and 're excited see new season^that '70s show cast where^icymi renewed season^shows binge watch netflix holiday break riverdale,4,11,7,15,0.26666666666666666,0.4666666666666667,0
23922797,SCMPNews,372,666566,5865,240960,2,5,3,5,the south china morning post brings news analysis hong kong china rest asia,zte punishment bill passes us house representatives^breaking former us president george hw bush died age^while retracing steps famous elorer hong kong dinosaur hunters made amazing discoverie^small plane crashes mumbai killing four board one pedestrian^china runs us goods tax so next trade war^trump sets sights increased china tariffs may tax us 500 billion chinese goods trade war rag^a large import fair begins shanghai monday aims send message china wants buy goods f^meghan markle fashionista facing royal makeover^wonder wheel film review winslet steals show woody allen miserable ensemble piece^myanmar dam overflow floods villages displaces thousands^seven things know disney mulan star liu yifei^seven things know disney mulan star liu yifei^seven things know disney mulan star liu yifei^seven things know disney mulan star liu yifei^seven things know disney mulan star liu yifei,5,10,5,15,0.3333333333333333,0.3333333333333333,0
8861182,Newsday,697,295293,1873,96795,1,0,4,10,breaking news daily discussion latest happenings long island send news tips questions join conversation,nyc terror suspect posted facebook trump failed protect nation way carry attack court^wednesday cover trump warns north korea fire fury like world never seen^lindsay lohan parents plan sue sen. john kennedy slanderous comments congress report says^lindsay lohan parents plan sue sen. john kennedy slanderous comments congress report says^sharon ozzy osbourne split years marriage reports say^patton oswalt engaged actress meredith salenger year wife death^abby lee miller dance moms sentenced year prison bankruptcy fraud^golf great tiger woods arrested dui charge florida police say^youtube star austin jones arrested child pornography charges^mindy kaling pregnant first child report says^golden globes tv predictions who win the crown game thrones^before justin timberlake takes stage super bowl lii take look best halftime shows ever^kylie jenner pregnant reports say^jennifer garner ben affleck officially file divorce reports say^morning joe co hosts joe scarborough mika brzezinski engaged according msnbc,5,10,5,15,0.3333333333333333,0.3333333333333333,0
14296548,wkyc,18981,181514,1886,281530,1,1,4,9,visit news weather sports information northeastohio nbc affiliate news,people found dead overturned car ohio canal^update the vehicle involved today amber alert located one inside police still searc^julianna margulies recalls how george clooney shut down diva guest star 'er set exclusive^emmy awards the winners list^channing tatum jenna dewan announce separation^jason momoa nicole kidman adventure under sea first 'aquaman trailer watch now^walmart remove 'cosmopolitan magazine checkout lines amid me too movement^scott baio wife renee reveals microvascular brain disease diagnosis^scott baio wife renee reveals microvascular brain disease diagnosis^kermit frog getting new voice years^veep actress julia louis dreyfus diagnosed breast cancer^jennifer aniston biggest revelations from her first major interview since justin theroux split^fiona dad henry hippo dies cincinnati zoo^khloe kardashian says ready marry star tristan thompson photo getty^reports kylie jenner pregnant,5,10,5,15,0.3333333333333333,0.3333333333333333,0
2296297326,UKMoments,167,62806,774,55655,1,0,4,10,the best happening twitter instant,the us house representatives intelligence committee unanimously voted declassify release democratic^could confirmation jamie foxx katie holmes dating^the first official photographs prince louis captured mother catherine duchess cambridge^the first official photographs prince louis captured mother catherine duchess cambridge^to relive moments incredibly difficult emotionally. shared thoughts^celebrity chef mario batali fired the chew following allegations sexual misconduct^matt damon fire controversial comments sexual misconduct hollywood^with engaged prince harry reporting spend christmas the^miles teller denies reports arrested drunk public san diego^meghan markle confirms father attend royal wedding^after getting makeover tom jackson marrie^it official karlie kloss engaged boyfriend joshua kushner six years dating^mila kunis revealed makes monthly donations planned parenthood mike pence name^prince harry audi sale online he seen driving pippa middleton wedding reception meghan m^nearly two weeks going missing actress arielle kebbel sister julia found safe sound,5,10,5,15,0.3333333333333333,0.3333333333333333,0
52293877,KYWNewsradio,1522,56671,1197,263632,0,8,5,2,all news matters around philadelphia ask alexa `` play kyw newsradio '' newstips.com,the us centers disease control prevention reported monday patients investigation t^the us centers disease control prevention reported monday patients investigation t^rudy giuliani hopes decision interview special counsel robert mueller north korea summit^the us centers disease control prevention reported monday patients investigation t^the us centers disease control prevention reported monday patients investigation t^president barack obama philadelphia today offer remarks th convention^watch live attorney general jeffsessions delivers remarks us attorney office philadelphia^icymi phillies aaronnola allowed one run four hits walk striking six he given five hits or^princeharry got cheers singing opening you 'll back joined manuel cast of^wife eniko parrish welcome baby boy^channing tatum jenna dewan tatum announce separation^channing tatum jenna dewan tatum announce separation after years marriage^princeharry got cheers singing opening you 'll back joined manuel cast of^icymi koko gorilla knew sign language dies^reveals graves disease diagnosis takes hiatus,5,10,5,15,0.3333333333333333,0.3333333333333333,0
4588114813,MomentsAU,84,28426,257,43513,1,0,4,10,the best happening twitter instant,the us house representatives intelligence committee unanimously voted declassify release democratic^could confirmation jamie foxx katie holmes dating^the first official photographs prince louis captured mother catherine duchess cambridge^the first official photographs prince louis captured mother catherine duchess cambridge^to relive moments incredibly difficult emotionally. shared thoughts^celebrity chef mario batali fired the chew following allegations sexual misconduct^matt damon fire controversial comments sexual misconduct hollywood^with engaged prince harry reporting spend christmas the^miles teller denies reports arrested drunk public san diego^meghan markle confirms father attend royal wedding^after getting makeover tom jackson marrie^it official karlie kloss engaged boyfriend joshua kushner six years dating^mila kunis revealed makes monthly donations planned parenthood mike pence name^prince harry audi sale online he seen driving pippa middleton wedding reception meghan m^nearly two weeks going missing actress arielle kebbel sister julia found safe sound,5,10,5,15,0.3333333333333333,0.3333333333333333,0
28527285,StevenWABX,1001,1158,53,59038,0,10,5,0,professional big mouth morning news anchor wabx evansville classic rock generally regarded waste dna,rock calendar cbs news show face nation premieres host ted koop interviews sen. joseph mccarthy r wis it still today^rock calendar cbs news show face nation premieres host ted koop interviews sen. joseph mccarthy r^rock calendar cbs news show face nation premieres host ted koop interviews sen. joseph mccarthy r wis it still today^rock calendar cbs news show face nation premieres host ted koop interviews sen. joseph mccarthy r^rock calendar cbs news show face nation premieres host ted koop interviews sen. joseph mccarthy r wis it still today^rock calendar congress gives final approval form us department education no.1 lp in through the out door led zeppelin^rock calendar democrat walter mondale republican bob dole face first ever debate vice presidential nominees^rock calendar democrat walter mondale republican bob dole face first ever debate vice presidential nominees^rock calendar democrat walter mondale republican bob dole face first ever debate vice presidential nominees^rock calendar house representatives passes brady bill calls five day waiting period handgun purchases^rock calendar victoria adams posh spice marries soccer superstar david beckham ok magazine pays 1million exclusive photos^rock calendar pink marries boyfriend carey hart beach costa rica more people including l^rock calendar after years nbc today show katie couric leaves anchor cbs evening news no^rock calendar after years nbc today show katie couric leaves anchor cbs evening news no.1 song sos rihanna^rock calendar katie couric formerly nbc today show debuts anchor cbs evening news host five years,5,10,5,15,0.3333333333333333,0.3333333333333333,0
10252962,KTLA,773,756341,4221,191772,1,1,5,8,ktla keeping southern california informed since have great video photos story tips share us using ktla,suspect new york subway elosion posted facebook earlier day saying trump failed protect yo^the u.s. centers disease control prevention said thursday salmonella illness cases linked recalled ke^breaking prince harry meghan markle wed may^north korea vows strikes u.s. trump warns fire fury^host opens start business amp career highlights new episode the n^teri hatcher tells star magazine report is broke homeless n't true^teri hatcher tells star magazine report is broke homeless n't true^family actor bill paxton files wrongful death lawsuit cedars sinai surgeon^former new york rep. anthony weiner sentenced months prison sexting minor^april giraffe gives birth much anticipated calf new york zoo^vince vaughn arrested manhattan beach police suspicion dui^don rickles legendary comedian actor dies age^'storm chasers star joel taylor dead family announced^the weinstein company may file bankruptcy according letter obtained^judge declares mistrial bill cosby sexual assault case,6,9,3,15,0.4,0.2,0
366606110,huffpostqueer,894,342787,3559,55860,0,0,6,9,lgbtq news culture opinion community need help huffpost login membership tweet,sarah jessica parker says ellen play samantha sex city^bette midler pretty excited hillary clinton showed watch hello dolly broadway^britney spears terrified fan rushes onstage vegas show^miley cyrus no plan leave country era trump^kendall jenner opens dad caitlyn jenner reveals mom kris knew since third date^kendall jenner opens dad caitlyn jenner reveals mom kris knew since third date^here popular halloween candy state^portia de rossi says steven seagal unzipped pants audition^stranger things star shannon purser comes bisexual^star jones ex husband al reynolds comes bisexual^where are they now catching winners^mtv road rules star danny dias one show first openly gay contestants dead^lcd soundsystem gavin russom comes transgender^meryl streep joins hbo big little lies season^jennifer lopez returning will amp grace two roles,6,9,3,15,0.4,0.2,0
2191703749,dailytimespak,216,33409,627,124258,1,3,6,5,the official feed daily times pakistan premier newspaper top stories special features,the partially redacted memos handed thursday us justice department three house representa^opinion khan foreign policy opportunities challenges insinuations aside khan ticked boxes wit^the ban remain place satisfactory corrective actions taken us department agriculture^opinion the devil details there four significant dates case read closely r^miley liam wedding called^ed sheeran weighs taylor swift katy perry feud^ed sheeran weighs taylor swift katy perry feud^meghan markle excited nick jonas priyanka chopra engagement^'devastated separation jolie^jennifer aniston brad pitt reportedly getting back together^here george clooney amal clooney hope raise twins^beyonc gives birth twins jay z^swedish dj avicii dead celebs pay tribute^kate middleton princess charlotte pretty pink trooping colour parade^oscars here complete list winners live,7,8,1,15,0.4666666666666667,0.06666666666666668,0
62768609,MummyPages,2801,31331,93,57333,0,0,7,8,the website mums ireland content reaching millions every month sister site,so poor justin theroux getting jennifer aniston^'there catfight sarah jessica parker talks kim cattrall sex city^so actor rumoured playing prince charles the crown^the crown found new prince charles queen mother^'i n't enjoy single angelina jolie speaks divorce aftermath^angelina jolie brad pitt continue custody battle court^move reese ashlee simpson latest mum show doppelganger^royal wedding prince harry asks prince william best man^alicia silverstone husband christopher jarecki split^the handmaid tale yvonne strahovski pregnant first child^cynthia nin loses democratic party nomination new york governor race^rachel mcadams welcomes first child report states^rachel mcadams reportedly pregnant first child^congrats bradley cooper irina shayk welcome first child^enrique iglesias anna kournikova share first photos twins,7,8,1,15,0.4666666666666667,0.06666666666666668,0
18682378,ParadeMagazine,1500,24732,471,28918,0,0,7,8,inspiring stories exclusive celebrity interviews bestselling authors recipes,it official dating photos^golden globes the complete list winners^jerryoconnell playing tv cop who tries solve cases real life carter^good morning america michael strahan talks snoop dogg presents the joker wild fashion more^marion cotillard making love brad pitt being non lover guns being princess spy allied^dennisquaid insurance ronaldreagan a dog purpose sequel^all juliebowen wants mother day some peace quiet^sag award winners the complete list^daytime emmy awards the complete winners list^who will play prince charles princess diana season hit tv show feud^nick jonas priyanka chopra are reportedly engaged^the mystery surrounding meghan markle presence pippa middleton wedding reception^ready binge watch holidays enter chance win yearlong netflix subscription^watch steven spielberg shifts gears eye popping ready player one trailer^oscars the complete list winners,7,8,1,15,0.4666666666666667,0.06666666666666668,0
17783278,TVInsider,2681,131198,1913,41507,0,0,8,7,we all-access pass favorite shows from latest news worth watching,in today tv news nickelodeon new streaming service trailers new shows sean penn amp elizabeth olsen^sean penn thefirst amp coming hulu september^thecrown found new prince charles amp queen mother^watch happens americanidol contestant tells katy perry loves taylor swift^big things store season 'flip flop atlanta^watch happens americanidol contestant tells katy perry loves taylor swift^modernfamily julie bowen got emotional earlier today^modernfamily julie bowen talks rumored upcoming death^jimmy kimmel returning oscar host second year^more baby news rachel mcadams pregnant first child^more baby news rachel mcadams pregnant first child^'wicked tuna star nicholas 'duffy fudge dead^pauley perrette leaving ncis after seasons^pauley perrette leaving ncis after seasons^pauley perrette leaving ncis after seasons,8,7,-1,15,0.5333333333333333,-0.06666666666666668,1
16028034,rodimusprime,1052,30155,797,176007,0,2,8,5,podcast comedian as seen all rts account endorsement views employer i host show w/ wife tbgwt,y she one hundred percent serious also i ever mad cultural appropriation you even^i know lebron man one mad warriors titles four years^jenna bush hager apologizes hidden fences mistake golden globes daily mail^meghan markle in tears over scrutiny of her royal faux pas how prince harry is supporting her hollywoodlife^american idol contestant apologizes katy perry after admitting he idolizes taylor swift people^jamie foxx katie holmes find best way battle breakup rumors actual information vanity fair^teri hatcher denies that she 'broke homeless living out her van 'it totally absurd people^teri hatcher denies that she 'broke homeless living out her van 'it totally absurd people^meghan markle in tears over scrutiny of her royal faux pas how prince harry is supporting her hollywoodlife^american idol contestant apologizes katy perry after admitting he idolizes taylor swift people^grammy winner pink graces cover people beautiful issue her two kids people^everything we know about beyonc long awaited return stage e news^surprise ariana grande pete davidson are engaged after dating few weeks people^halle berry makes her relationship with alex da kid instagram official^ben affleck jennifer garner officially file divorce vanity fair,8,7,-1,15,0.5333333333333333,-0.06666666666666668,1
46400289,guardianculture,812,104319,3005,105674,0,0,9,6,culture news reviews interviews features,rachel weisz 'my parents refugees brexit feels like death^julia roberts jim carrey emma stone hollywood stars takeover tv^vince vaughn mel gibson hollywood cops prove lives matter^baftas full list winners^actor terry crews i sexually assaulted hollywood executive^julia roberts jim carrey emma stone hollywood stars takeover tv^breathe review andrew garfield fronts poignant biopic wheelchair pioneer^i miss old kanye happened rap complex star^brad pitt quit acting 'in three years^tony awards complete list nominations^louis ck accused five women sexual misconduct new report^don rickles legendary comedian master celebrity roasts dies aged^leonardo dicaprio star quentin tarantino charles manson movie^daniel craig confirms play james bond^actor ving rhames says police held gunpoint home,9,6,-3,15,0.6,-0.2,1
44690893,AmericanTop40,684,76577,770,27482,0,0,9,6,every week heart music business hollywood ryan counts number hottest hit song america,gets matching tattoos friends see pics^are already married^selenagomez reign queen instagram^justinbieber 'not ex selenagomez despite married haileybaldwin^see photos bradleycooper astarisborn^at concert irvine tuesday night john mayer said not back together jennifer aniston^gives birth to son ace knute^report jessica simpson pregnant^amp here timeline relationship^styles announces intimate world tour see dates^breaks silence engagement^are engaged^billboard music awards nominations announced see full list bbmas nominees^here everything need know nickjonas priyankachopra relationship started^says still friends squad n't cult,9,6,-3,15,0.6,-0.2,1
24795776,Power99Philly,1625,59354,426,71312,0,0,9,6,philly station hip hop r b rngms middays afternoons nights,fergie and josh duhamel split after years of marriage rngms^fergie and josh duhamel split after years of marriage rngms^fergie and josh duhamel split after years of marriage rngms^chris brown slammed by judge for skipping karrueche tran court hearing^chris brown slammed by judge for skipping karrueche tran court hearing^matthew mcconaughey says it time embrace donald trump^hold is kanyewest going to be an americanidol judge read^mariah carey not dating both nick cannon and bryan tanaka despite report^mariah carey not dating both nick cannon and bryan tanaka despite report^'rob amp big star christopher big black boykin dead at^'rob amp big star christopher big black boykin dead at^'rob amp big star christopher big black boykin dead at^fergie and josh duhamel split after years of marriage rngms^fergie and josh duhamel split after years of marriage rngms^fergie and josh duhamel split after years of marriage rngms,9,6,-3,15,0.6,-0.2,1
18498319,JamShowbiz,938,20312,94,51286,0,0,10,5,entertainment showbiz canadian angle,leslie jones tells critics stop offended comedians old jokes^nicole kidman trump 'we country need support whoever president^reunite destiny child coachella report^brad pitt mom wants get back jennifer aniston^caitlyn jenner skips son brody jenner wedding^teri hatcher i 'm broke homeless^teri hatcher i 'm broke homeless^the spice girls reunion cancelled^are darren aronofsky suki waterhouse dating^selena gomez reveals kidney transplant^ewan mcgregor daughter calls girlfriend mary elizabeth winstead piece trash^the young and the restless actor corey sligh found guilty child molestation^steve martin martin short 'colonoscopy parties tom hanks^bradley cooper girlfriend irina shayk welcome first child // wenn^actor tab hunter star damn yankees movie dead,10,5,-5,15,0.6666666666666666,-0.3333333333333333,1
24190981,TeenVogue,2533,3359693,11713,115881,0,0,12,3,the young person guide conquering saving world,hbd^hbd favorite actress and virgo queen beyonc knowles carter^drake calls rumors fake media story^selena gomez proudly wore shirt with stains all over it^hbd^kendall kylie jenner reportedly n't respond brody jenner wedding invite yikes^kendall kylie jenner reportedly n't respond brody jenner wedding invite yikes^an american idol contestant apologized katy perry liking taylor swift^prince harry meghan markle are moving into new home thanks queen^hbd^hbd^an american idol contestant apologized katy perry liking taylor swift^wait do ariana grande pete davidson now have tiny matching breakup tattoos^super stylish good environment eco friendly labels right^valentine day gifts get beauty obsessed bestie,12,3,-9,15,0.8,-0.6,1
22870112,TerezOwens,1522,28830,484,171127,9,0,4,2,the world most famous sports gossip blogger -- real sports real dirt..,nfl lawyer who claimed super bowl is rigged found dead story scrubbed from internet^nfl lawyer who claimed super bowl is rigged found dead story scrubbed from internet^nfl lawyer who claimed super bowl is rigged found dead story scrubbed from internet^icymi nfl lawyer who claimed super bowl is rigged found dead story scrubbed from internet^icymi nfl lawyer who claimed super bowl is rigged found dead story scrubbed from internet^icymi nfl lawyer who claimed super bowl is rigged found dead story scrubbed from internet^nfl lawyer who claimed super bowl is rigged found dead story scrubbed from internet^icymi nfl lawyer who claimed super bowl is rigged found dead story scrubbed from internet^rt nfl lawyer who claimed super bowl is rigged found dead story scrubbed from internet https^alex rodriguez is cheating on jennifer lopez with this lady^alex rodriguez is cheating on jennifer lopez with this lady^alex rodriguez is cheating on jennifer lopez with this lady^gayrod dumped kate hudson love camera time dumped kate hudson love camera time/^ayesha curry is the newest face of beauty brand covergirl^khloe kardashian tristan thompson are ready for baby no,13,2,-11,15,0.8666666666666667,-0.7333333333333333,1
16461545,funkflex,1892,832533,4250,347874,1,1,13,0,buisness/booking info litdigitaldjs.com inflexwetrustfreestyle series hit link below for a chance of a lifetime,video oprah speaks on obama racism amp her movie 'the butler ifwt^photo hillary clinton releases a statement in regards to the orlando mass shooting ifwt^that deep find out the real reason why selena gomez ca n't let go of justin bieber ifwt^photos whoa katy perry wears raunchy tartan mini skirt amp fishnets ifwt^ifwt nfl katy perry dedicates raunchy song tim tebow^photos rekindling the flame justin bieber amp selena gomez confirm they 're back together ifwt^kris jenner and corey gamble are allegedly calling it quits^kris jenner and corey gamble are allegedly calling it quits^kris jenner and corey gamble are allegedly calling it quits ifwt^kanye west 'yeezus tour has been cancelled indefinitely ifwtcatchup^video kourtney kardashian is jealous that kim gets more love from scott ifwt^video could kim kardashian pregnancy hurt kanye west career^video could kim kardashian pregnancy hurt kanye west career ifwt^kanye west will not be heading to american idol ifwt^photos now that a milf heidi klum flaunts her bikini body amp shows us what she workin with ifwt,14,1,-13,15,0.9333333333333332,-0.8666666666666667,1
34713362,business,1264,5602021,53084,500116,0,8,1,5,the first word business news,she passed tests hurdles many interviews review credentials flying c^here brazil president elect jair bolsonaro pledged foreign policy economy victory speech^trump lawyer rudy giuliani said special counsel robert mueller indicated willing narrow scope a^a canadian data analytics firm spent 2 million facebook ads pro brexit campaign groups^ethiopian leader calls multiparty democracy^here white house partial transcript trump told reporters record air force one^here white house partial transcript trump told reporters record air force one^breaking trump directs u.s. trade representative identify 200 billion chinese goods tariffs^kensington palace royalbaby meghan markle prince harry appreciated support rece^brady bunch house sale 1.9 million^brady bunch house sale 1.9 million^brady bunch house sale 1.9 million^prince harry says wanted british royal family^prince harry says wanted british royal family,1,13,12,14,0.07142857142857142,0.8571428571428571,0
6134882,dwnews,789,279008,5342,265328,0,12,1,1,journalism madeforminds follow us global news analysis heart europe,in fox news interview trump said merkel unbeatable let millions people country th^jointaddress how americans reacted first address joint session congress^a video saudi woman allegedly abused husband gone viral reigniting debate violence ag^a video saudi woman allegedly abused husband gone viral reigniting debate violence ag^a video saudi woman allegedly abused husband gone viral reigniting debate violence ag^a video saudi woman allegedly abused husband gone viral reigniting debate violence ag^in interview dw john mccain called vladimir putin murderer thug^in interview dw john mccain called vladimir putin murderer thug^in interview dw john mccain called vladimir putin murderer thug^in interview dw john mccain called vladimir putin murderer thug^spanish police detained four men one minor suspicion drugging raping underage girl gran canaria^one four guns us civilian market comes europe^it boy a mere seven hours giving birth third child kate middleton emerged hospital^the world watches us giraffe april gives birth calf,1,13,12,14,0.07142857142857142,0.8571428571428571,0
16550142,indystar,478,269143,2906,269835,0,9,1,4,news matters sports thrill a city excites local journalism central indiana instagram indystar snapchat indystarsnaps,i self proclaimed sock man bush said email republican national committee the louder t^trump coming here everything need know ffa convention speech indy today^many eected trump speak tariffs impacting indiana farmers saturday morning shooting p^chicago mercy hospital shooting victims include portage native recent purdue grad^chicago mercy hospital shooting victims include portage ind. native recent purdue grad^mercy hospital shooting chicago what know victims incident^chicago mercy hospital shooting victims include portage native recent purdue grad^mercy hospital shooting chicago what know victims incident^shooting near chicago hospital leaves multiple victims^kanye west returns twitter 'mind control rant one week hiatus^walmart remove 'cosmopolitan magazine checkout lines amid me too movement^here popular halloween candy every state^oscars the complete winners list^oscars the complete winners list,1,13,12,14,0.07142857142857142,0.8571428571428571,0
9616062,10News,15695,169792,1888,160531,0,4,1,9,get major news matters san diego leading news source abc news got news tip call 619 -6383 visit,sen. john mccain warns spurious nationalism liberty medal acceptance speech^at am abc exclusive pres barack obama reflects years office this week george stephanopoulos^now 'this week george stephanopoulos exclusive interview^president barack obama reflects years office this week george stephanopoulos^channing tatum jenna dewan tatum announce separation^xxxtentacion second suspect arrested connection rapper murder^xxxtentacion second suspect arrested connection rapper murder^the brady bunch house southern california sale 1.885 million^actor vince vaughn arrested suspicion dui^announces man woods tour dates^kaley cuoco marries fianc karl cook san diego horse stable^actress mila kunis makes monthly donations planned parenthood vp mike pence name^taylor swift announces new album reputation^star trek icon george takei responds sexual assault allegation former model,1,13,12,14,0.07142857142857142,0.8571428571428571,0
14849086,KCRG,1130,94935,930,120828,0,13,1,0,your -hour news source covering cedar rapids dubuque iowa city waterloo points account managed kcrg-tv9 news staff,"a report u.s. energy information administration projected tuesday would see lowest u.s. coal c^the boy captured nation attention became unofficial face iowa wave needs little help fro^in segment interview cbs face nation released saturday night kasich says shocked that^rudy giuliani president new attorney said interview the associated press friday prep^sen. lindsey graham south carolina told abc news chief anchor george stephanopoulos this week sunday it w^i actively sought leverage contacts professor host meeting papadopoulos told abc news chi^a report u.s. energy information administration projected tuesday would see lowest u.s. coal c^sen. lindsey graham south carolina told abc news chief anchor george stephanopoulos this week sunday it w^fact checking president donald trump address joint session congress^a report u.s. energy information administration projected tuesday would see lowest u.s. coal c^voters tuesday chose reelect mike naig democrat tim gannon central iowa farmer previously worked^the u.s. department agriculture reported monday percent iowa corn crop harvested sun^the u.s. department agriculture granted nearly 500,000 three years university vermont th^kim kardashian participated listening session clemency prison reform several staffers including t",1,13,12,14,0.07142857142857142,0.8571428571428571,0
1512021254,sam_vinograd,3181,85757,1065,22555,0,13,1,0,national security analyst senior advisor nsc-er author presidential weekly briefing,statement narcissistic focus wrong thing n't mention russia great w^statement mission peace wise one every president prefer peace war t^^when hotseat got hot don blame climate change though^as discussed is^in statement following comments h^even north koreans know n't speak anyone except maybe voi^air briefing see yo^everyone supposed get briefing get job including first daugh^if happened skip ethics briefing information security briefing c^make appearance week presidential weekly briefing^if comprehensive unclassified briefing given monday^ironic choice words light michael cohen news trade w russia sanctions lifted n't going to^some fire fury eected toward tehran why iran strategy n't changed the difference that,1,13,12,14,0.07142857142857142,0.8571428571428571,0
18923480,CBS2Boise,1912,30807,520,87052,0,10,1,3,breaking news weather sports boise treasure valley follow us instagram like us facebook latest news,the energy information administration said thursday u.s. produced million barrels day in^the energy information administration said thursday u.s. produced million barrels day in^we airing gubernatorial debate tomorrow kboi2 p.m here link fa^take look president trump concluded speech tuesday washington dc he speaking t^the energy information administration said thursday u.s. produced million barrels day in^now white house press briefing^soon white house press briefing^watch white house press briefing^watch live white house press briefing^watch senator chuck schumer holds press conference following midterm elections^former miss utah trump accuser holding press conference salt lake city^'brady bunch house sale nearly 1.9 million^meghan markle dad reportedly wo n't attend royal wedding staging photos^breaking reports former fox news ceo roger ailes dead,1,13,12,14,0.07142857142857142,0.8571428571428571,0
16396368,KTNV,1722,174990,1405,150158,1,6,2,5,ktnv-tv abc affiliate las vegas snapchat actionnewslv instagram ktnv,the white house trying use statute code federal regulations undermine mueller credibility^white thanksgiving lake tahoe treated first snowfall season week |^one local law firm getting lot attention new digital billboard ad campaign around valley add^your voice your vote question breaks sides debate tonight p.m. |^joe biden visiting las vegas next week campaign rally^donald trump jr. returns las vegas campaign rally^the life character john mccain words memorable quotes late senator^amal george clooney welcome twins^caitlyn jenner latest celebrity float run office^breaking xxxtentacion murder third suspect arrested connection rapper death^justin timberlake announces 'man woods tour dates^mila kunis makes monthly donations planned parenthood mike pence name^richard simmons hospitalized evere indigestion^'april giraffe pregnant park announces viral giraffe mom due spring,3,11,8,14,0.21428571428571427,0.5714285714285714,0
21344507,factcheckdotorg,18,172754,4493,10904,3,11,0,0,a nonpartisan nonprofit consumer advocate voters,fake news alert crew air force one refuses fly obama miles just play golf. here bogus^we debunk many viral stories falsely claim application march for our lives permit made mon^the growth regulations slowed trump come beautiful halt claims the number res^in week fact checking video cnn jake tapper reviews statement president donald trump made th^have gotten email says obama banned pledge allegiance delete amp read latest ask factcheck^our managing editor lori robertson joined conversation new political tv ad archive^political tv ad archive launched partnership^our latest players guide profile outside groups seeking influence midterm elections league^the centers disease control prevention flying sick migrants caravan country a^the centers disease control prevention flying sick migrants caravan country a^the trade deficit trump promised reduce grew larger instead the total u.s. trade deficit goods serv^the u.s. trade surplus goods services canada 6.5 billion months ending june that^china retaliates tariffs 34 bil us goods including top agricultural ert soybeans ag economists^the trade deficit trump grown larger the u.s. trade deficit goods services recent,3,11,8,14,0.21428571428571427,0.5714285714285714,0
5751952,myfox8,441,142097,890,181054,1,2,2,9,the official page wghp-tv fox8 high point greensboro winston-salem piedmont triad nc,melania trump undergoes kidney surgery walter reed medical center^republican convention officially coming charlotte republican national committee votes^obama campaign woos hispanics tv radio ads^dreamgirls star jennifer holliday backs donald trump inauguration performance^jessica simpson gives birth baby boy^'this is us star justin hartley marries chrishell stause^breaking margot kidder 'superman star dead^after years kermit frog getting new voice^don rickles legendary comedian actor dies kidney failure age^julia louis dreyfus diagnosed breast cancer^'storm chasers star joel taylor dead^ellen degeneres cries receiving best birthday gift portia de rossi^ellen degeneres cries receiving 'best birthday gift portia de rossi^fiona baby hippo dad henry dies,3,11,8,14,0.21428571428571427,0.5714285714285714,0
16637204,WEWS,3718,105349,1692,196936,1,5,2,6,news on your side champions people cleveland instagram news5cleveland,four people including year old boy found dead southern ohio suspect large^fact checking democratic presidential candidate debate new hampshire^an akron woman defrauded u.s. department education 1.8 million^while n't condone antagonistic tone president press recent media avails supp^breaking vice president biden deliver statement rose garden :10 pm est^two four suspects dropped nebraska one suspect arrested police issued arre^amal george clooney welcome twins^channing tatum jenna dewan tatum announce separation^xxxtentacion murder third suspect arrested connection rapper death^photos 'the brady bunch house sale 1.885 million^photos 'the brady bunch house sale 1.885 million^bon jovi dire straits nina simone among rock amp roll hall fame inductees^taylor swift announces new album 'reputation^richard simmons hospitalized evere indigestion,3,11,8,14,0.21428571428571427,0.5714285714285714,0
18320938,DeanObeidallah,10453,96129,1530,128810,0,10,3,1,host dean obeidallah show radio channel -9pmet lawyer tell jokes columnist,today trump said statement someone else wrote we come together send one clear strong unmist^today trump said statement someone else wrote we come together send one clea^sarah palin speech literally laundry list cliches im sure dinner gets booked thats great cpac much^sarah palin speech gets applause older peeps cpac younger ones n't look thrilled esp mentioned birth control^democrats created coverage pre existing medical conditions aca democrats crea^of course putin would go trump favorite network chris wallace lands interview with vladimir putin fox news^trump recruiter chief donald trump featured new jihadist recruitment video^correct russia wanted trump potus hillary the russians knew would continue divide ame^do u know white people pulled much philando castile stopped times police day shot^wow philando castile stopped times police was racial profiling rhetorical question^reminder trump defends 'beautiful confederate statues part culture now today trump warned europe l^trump response terrorism after charlottesville blamed sides praised white supr^trump response worst coordinated terrorist attack us soil since /11 blame m^breaking matt lauer fired nbc news inappropriate sexual behavior,3,11,8,14,0.21428571428571427,0.5714285714285714,0
15756056,KREM2,1967,66528,849,178349,0,0,3,11,covers latest news weather sports around inland northwest based spokane wash owned check krembts look behind scenes,prince harry meghan markle apologize delayed royal wedding 'thank you cards^prince harry meghan markle apologize delayed royal wedding 'thank you cards^prince harry meghan markle apologize delayed royal wedding 'thank you cards^koko gorilla knew sign language dies^koko gorilla knew sign language dies^the best memorial day sales home appliances^scott baio wife renee reveals microvascular brain disease diagnosis^scott baio wife renee reveals microvascular brain disease diagnosis^scott baio wife renee reveals microvascular brain disease diagnosis^former fox news ceo roger ailes dead photo via getty images^'nypd blue creator steven bochco dead^'nypd blue creator steven bochco dead^'nypd blue creator steven bochco dead^april giraffe pregnant,3,11,8,14,0.21428571428571427,0.5714285714285714,0
331311644,ladbible,0,2240371,2487,51664,0,0,4,10,redefining entertainment news follow ladbible best viral videos funny stories latest news,brad pitt jennifer lawrence 'dating spending lots 'late nights together^brad pitt jennifer lawrence 'dating spending lots 'late nights together^brad pitt jennifer lawrence 'dating spending lots 'late nights together^brad pitt jennifer lawrence 'dating spending lots 'late nights together^a seat n't actually left empty princess diana royal wedding^there seat left empty princess diana royal wedding^prince harry asks brother william best man royal wedding^black mirror episode 'uss callister could get spinoff^paris jackson cleans graffiti michael jackson walk fame hollywood star^'big bang theory star kaley cuoco marries karl cook^meghan markle deletes instagram facebook twitter accounts revealed exactly^kit harington rose leslie officially married tying knot front game thrones co star^the director guardians galaxy dropped massive truth bomb groot freaking everyone ou^the director guardians galaxy dropped massive truth bomb groot freaking everyone ou,4,10,6,14,0.2857142857142857,0.42857142857142855,0
18999261,FOX10Phoenix,1203,296252,1967,401391,1,5,3,5,phoenix breaking news weather politics sports tweet us tips pics hashtag fox10phoenix,people found dead southern ohio friday least relatives apparently shot execution style^i added video playlist full speech french president macron address joint session congress^right now president makes statement revamped north american free trade deal ro^live president donald trump moon township pennsylvania support state rep. rick saccone tight race.^live president donald trump arriving joint base andrews board air force one he heading moon towns^live president trump speaking campaign rally las vegas support gop candidates.^tmz kylie jenner pregnant travis scott baby^selena gomez eeking treatment 'tackle emotional issues head^selenagomez eeking treatment 'tackle emotional issues head^harrypotter river cruise set sail summer cost serious cash^icymi actor vince vaughn arrested suspicion dui resisting arrest^actor vince vaughn arrested suspicion dui resisting arrest manhattan beach checkpoint^breaking demi lovato reportedly hospitalized suffering apparent heroin overdose.^live video aprilthegiraffe pregnant animal adventure park officials say due sometime spr,4,10,6,14,0.2857142857142857,0.42857142857142855,0
52047494,KABBFOX29,673,72199,703,147037,0,5,4,5,know know first kabb-tv fox affiliate san antonio texas without doubt unique local news broadcasts city,yami exclusive interview former ms13 gang member tonight fox news nine^watch live white house press briefing^watch live white house press briefing^watch live white house press briefing^four bodies recovered one still missing san marcos apartment fires^meghan duchess sussex kisses prince harry team wins polo match^meghan duchess sussex kisses prince harry team wins polo match^report ben affleck jennifer garner settle divorce^brad pitt hits back angelina jolie child support jab^meghan markle dad reportedly wo n't attend royal wedding staging photos^report meghan markle dad attend royal wedding due heart surgery^steve martin martin short 'colonoscopy parties tom hanks^reports former fox news ceo roger ailes dead^oscars the complete list nominations winners,4,10,6,14,0.2857142857142857,0.42857142857142855,0
2479845637,decider,5819,30650,550,73174,0,3,4,7,can decide watch we help decider cuts clutter find best movies shows stream subscribe,check streaming state union overview hits misses lessons learned industry^'morning joe 'fox amp friends took different sides donald trump minutes interview^check streaming state union overview hits misses lessons learned industry^josh o connor play prince charles thecrown season^millie bobby brown wants hopper joyce romance strangerthings season one^what says filthy donaldtrump finally responding stephen colbert controversial rant^rachel bilson eddie cibrian team make throwback crime procedural taketwo is worth^these best movies tv shows coming netflix december^get excited the first celebrity edition bigbrother coming cbs winter^howie mandel claims n't remember meghan markle run 'deal no deal^i even remember i i meghan markle n't make impression 'deal or no deal host ho^howie mandel claims n't remember meghan markle run 'deal no deal^howie mandel claims n't remember meghan markle run 'deal no deal^the goldenglobes live streamed first time year here watch,4,10,6,14,0.2857142857142857,0.42857142857142855,0
43346352,Y94Official,426,4383,86,41286,0,0,4,10,y94 fargo-moorhead hit music station home of the y94 morning playhouse ryan kelly amy kaye jayson slade,report katy perry throws pal raunchy bachelorette party nyc^selena gomez says nick jonas romance puppy love fears she getting old^is hailee steinfeld dating justin bieber^cardi b amp dj snake send messages selena gomez singer seeks treatment emotional issues^will grace trailer reunites your favorites with musical twist^suspect arrested xxxtentacion murder^justin timberlake adds new leg man woods tour announces european dates^ariana grande confirmed open billboard music awards^celebsizzler lady gaga announces details las vegas residency enigma a celebration unique^talk show host seth meyers host golden globes^finally taylor swift announces new album reputation nov^ariana grande jimmy fallon the roots perform no tears left cry nintendo labo instruments^billboard music awards complete winners list^the weinstein company file bankruptcy,4,10,6,14,0.2857142857142857,0.42857142857142855,0
16083576,CBSPhilly,1298,188688,2384,245689,1,7,4,2,the latest philadelphia area news weather sports traffic home cbs3,first lady melania trump undergoes kidney surgery at walter reed medical center^the life eectancy u.s. declined slightly last year according new data centers disease con^live democratic national convention committee mayor philadelphia hold joint press conference^full transcript president trump address a joint session congress^president trump addressed administrations zero tolerance policy tuesday national federation indepen^the life eectancy u.s. declined slightly last year according new data centers disease con^watch live attorney general jeffsessions delivers remarks us attorney office philadelphia^watch china fires back with tariffs on 60 billion worth of u.s. trade goods^kellyanne conway plug from the white house 'go buy ivanka stuff^tonight new details fergie josh duhamel split don miss etnow^channing tatum and jenna dewan tatum announce separation^channing tatum and jenna dewan tatum announce separation^it beautiful day neighborhood tom hanks set play mr. rogers upcoming biopic you are my^celine dion donates concert proceeds to las vegas shooting victims 'so many are still suffering,5,9,4,14,0.35714285714285715,0.2857142857142857,0
27706099,FOXBaltimore,1275,159627,1400,201535,1,2,4,7,with hours emmy award winning news coverage every weekday fox45 consistently baltimore honored news operation rts endorsements,nyc suspect taunts trump federal prosecutors charge nyc subway bomb suspect say wrote facebook trump y^breaking new statement baltimore city public schools video teacher attacked^white house vice president joe biden make statement rose garden watch live^david cassidy fighting memory loss wants 'enjoy life^report ryan phillippe 'devastated 'false allegations domestic violence^katie couric matt lauer today co host said i idea going tenure after^former miss utah trump accuser holding press conference salt lake city^koko gorilla knew sign language dies^koko gorilla knew sign language dies^third suspect arrested xxxtentacion murder^matt damon apologizes comments sexual misconduct^meghan markle dad reportedly wo n't attend royal wedding staging photos^off the market| priyanka chopra nick jonas announced respective instagram accounts engaged^richard simmons hospitalized severe indigestion,5,9,4,14,0.35714285714285715,0.2857142857142857,0
18090418,zimbio,241,8971,218,19903,0,0,5,9,feeding pop culture obsession,miley cyrus liam hemsworth relationship timeline get scoop say i^miley cyrus liam hemsworth relationship timeline check romance beginning maybe end^things know about courteney cox new man johnny mcdaid^plot twist shannen doherty defends charmed reboot asks fans give chance read^castle gets taketwo rachel bilson eddie cibrian do think new caskett^laura prepon ben foster married see adorable wedding photo^these best tv shows find favorites made list^pauley perrette finally reveals leaving ncis might eected read^'moonlight ashton sanders amp jharrel jerome win best kiss mtv movie amp tv awards^rachel mcadams is pregnant with her first child so it time to let go of noah allie for real^michael fassbender alicia vikander married^well quick nick jonas priyanka chopra engaged two months dating^tv shows netflix binge watch holidays^pauley perrette announces leaving ncis season abbysciuto whyworld,5,9,4,14,0.35714285714285715,0.2857142857142857,0
17980523,mitchellvii,9289,459921,3964,151531,5,8,1,0,host yourvoice america sun-thu pm et trusttrump maga trump2020 asupporter trusttheplan,thanksobama food stamp enrollment drops four million one month breitbart ... for^sharia law banned america period not states issue it threatens constitution sovereignty^according code federal regulations cfr appointing special prosecutor ag call not president^the entire democrat party media sycophants screaming world ignorance basic code federal regulations law^the code federal regulations makes law immunizing trump jr. actions precisely clear foreign national individual may ...^the fact social media openly dramatically censoring pro trump voices tells us one clear thing ar^great interview full transcript president donald trump interview face nation cbs news^breaking rep. matt gaetz filing federal election commission complaint against twitter video via^here we go we 're going wholesale full scale investigation i think despicable process d^president trump holds heart breaking listening session healthcare the last refuge^paul ryan invited emmanuel macron address joint session congress i think i speak french ameri^flying pigs sighted sunday nbc meet press host chuck todd said president donald trump winning^great interview full transcript president donald trump interview face nation cbs news^on timeline appears direct causal relationship democrats booing god convent,6,8,2,14,0.42857142857142855,0.14285714285714285,0
14192680,NOLAnews,1604,241043,3055,316349,1,3,5,5,latest news updates pulitzer prize-winning newsroom the times-picayune new orleans advocate,a fake photo emma gonzalez went viral far right parkland teens villains^federal election commission changes filing date candidate documents^2/15 john emery gt gt rb destrehan emery 2019 moraleiii he one nation top ranked running^million pounds ground beef recalled u.s. department agriculture^blake shelton people 'sexiest man alive^details florida school shooter attack emerge jennifer aniston splits justin theroux 10 things know f^critics choice awards full winners list announced^kate middleton gives birth rd child palace confirms^kate middleton gives birth rd child palace confirms^pregnant serena williams poses mostly nude vanity fair cover^donald trump star hollywood walk fame vandalized again^hgtv stars chip joanna gaines welcome baby no^julia louis dreyfus diagnosed breast cancer trump increases aid puerto rico 10 things know friday^george amal clooney donate 1 million fight hate groups,6,8,2,14,0.42857142857142855,0.14285714285714285,0
779947624572985344,9HoneyAU,139,2684,22,27724,0,0,6,8,delivering daily buzz aussie women news parenting celebrity beauty fashion food travel fitness homes,"chris pratt files divorce anna faris^khloe kardashian says new baby wo n't mend distant relationship caitlyn jenner^a housekeeper earned 60,000 clean anmer hall resigned honey^'desperate housewives star teri hatcher slams report claiming 'broke homeless^hollywood reacts matt lauer firing 'do n't let door hit way^'desperate housewives star teri hatcher slams report claiming 'broke homeless^rachel weisz pregnant eecting first child husband daniel craig^'mean girls star rachel mcadams pregnant first child^just in royal staff reportedly called emergency meeting buckingham palace^'breaking bad star aaron paul wife lauren welcome first child^'7th heaven actor jeremy london arrested domestic violence^you spend night house 'scream ... dare^tommy lee engaged former vine star brittany furlan ring stunning^chris pratt files divorce anna faris",6,8,2,14,0.42857142857142855,0.14285714285714285,0
34245009,indiatvnews,33,786730,1189,447468,5,4,3,2,india watched hindi news channel follow latest/breaking news alerts globe fb,after senate bill introduced us house representatives end non defence aid pakistan^news alert us house representatives passes spending bill ends government shutdown afp usshutdown^the us house representatives thursday passed annual defense spending bill fiscal among ot^miller came us age seven vying enter house representatives lower^news alert federal prosecutors charge nyc subway bomb suspect say wrote facebook trump failed pro^watch beti bachao beti padhao mere slogan mission statement bjp says at^i withdraw statements instead attacked office tender apology^pm president issue joint statement rose garden^newsalert four criminals dead one injured encounter delhi police special cell rajesh bharti gang^northkorea dismisses 'fire fury threat warns 'absolute force^the ex couple six children together still fighting children custody they together s^'excited priyankachopra hopes meghanmarkle pregnancy 'amazing^defending champion serena williams withdraws australian open^oscars live updates here complete winners list afantasticwoman bags best foreign language film award,8,6,-2,14,0.5714285714285714,-0.14285714285714285,1
280664117,PatrickSvitek,8701,32824,1004,66364,7,6,1,0,reporter psvitek.org,joe arpaio endorses texas agriculture commissioner sid miller election^sid miller statement meeting today senior trump staff this great meeting texas texas ag^texas agriculture commissioner sid miller says trump way would campaign^texas agriculture commissioner sid miller ex u.s. rep. henry bonilla r san antonio arrived mar lago meetings pool^texas agriculture commissioner sid miller wo n't face charges jesus shot trip reports^texas republican lengthiest praise today trump action tpp appears sid miller his statement^regulators fine texas ag chief sid miller sloppy accounting via^inbox sunday^releases clip post election interview w/ earlier today houston home a^tweaks stump speech san antonio talk iran nuclear deal in foreign policy either go t^chair gilberto hinojosa opening speech convention almost entirely family separation^biggest applause lines yet convention speech universal background checks assault weapons ban ten^after new remarks last night philadelphia back jobs freedom security stump speech hershey^full circle something like drake fake love fame cites fake media denying hijab story,8,6,-2,14,0.5714285714285714,-0.14285714285714285,1
23697509,JosephKapsch,5131,9387,344,50229,0,1,8,5,emmy nominated hollywood news biz survivor top digital news chief ex-hollywood reporter thewrap la times,sarah palin cpac speech might as well be the next dr. seuss book via^i agree news networks should report feels like today show team eager report s^katie couric opens up matt lauer today exit via^'live duo kelly ripa ryan seacrest inspire abc scripted comedy 'work wife via^'live duo kelly ripa ryan seacrest inspire abc scripted comedy 'work wife via^'live duo kelly ripa ryan seacrest inspire abc scripted comedy 'work wife via^robert pattinson has not canceled amp 39 cosmopolis amp 39 appearance says rep^'live duo kelly ripa ryan seacrest inspire abc scripted comedy 'work wife via^castle creators back abc with new light detective procedural take two rachel bilson eddie cibrian star^harvey weinstein faces new rape allegation class action lawsuit via^daytime emmy awards the complete winners list via^congrats katharine david foster are engaged via^ed sheeran wins top artist billboard music awards complete winners list via^lena dunham joins american horror story season via,8,6,-2,14,0.5714285714285714,-0.14285714285714285,1
143142203,worldnewsdotcom,5399,17235,906,113709,0,1,9,4,a global provider news worldnews wn network presents news mainstream regional sources this permits variety perspectives interpretations,in reversal rudygiuliani says donaldtrump interview robertmueller team russiaprobe^kellyanneconway likely broke rules with 'go buy ivanka stuff remarks government ethics chief^channing tatum jenna dewan split nearly years marriage channingtatum jennadewantatum actors^jenniferaniston amp angelinajolie style showdown critics choice awards ap/matt sayles^justin bieber 'is selena gomez despite marrying hailey baldwin justinbieber selenagomez^channing tatum jenna dewan split nearly years marriage channingtatum jennadewantatum actors^kanye west and are struggling with second pregnancy kanyewest^ben affleck looking family friendly role benaffleck hollywood movie^selena gomez feeling empowered selenagomez depression anxiety hollywood^selena gomez leaves rehab suffering 'emotional breakdown selenagomez lupus rehab entertainment^'the walking dead season promotes three actors series regular eect see lot gareth th ...^update comedian billcosby found guilty sexualassault retrial andreaconstand montgomerycountycourt^how roseanne revival came together according laurie metcalf comedy^do i need british accent asks princeharry interviews ... bbcradio,9,5,-4,14,0.6428571428571429,-0.2857142857142857,1
91334232,Independent_ie,199,512712,2496,361546,3,2,7,2,ireland read news website providing breaking news content million readers month get touch contact.ie,irish workers may get access thousands us visas 'e3 bill passed house representatives^breaking us federal prosecutors charged new york subway bomb suspect akayed ullah saying wrote fac^suspect nyc subway bombing wrote 'trump failed protect nation facebook prosecutors^interpol using facial recognition technology track convicted sex offender key suspect^video four injured one gored pamplona bull festival^north korea says seriously considering plan strike guam trump warns 'fire fury'^north korea says seriously considering plan strike guam trump warns 'fire fury'^'we always united fergie josh duhamel announce shock split eight years marriage^george clooney brad pitt ... everyone here becky dickinson committed 'i wo n't life^prince william kate invite george nursery friends playdates anmer hall^nick grimshaw spilling a listers angelina jolie 'cold will smith 'fake nice^'you may forgive forgetting possible khloe kardashian 'uncomfortable watching tristan thompson^enrique iglesias wife anna kournikova welcome ecret twins^the first lady celebrating th birthday week liz kearney n't impressed plans,10,4,-6,14,0.7142857142857143,-0.42857142857142855,1
205206309,Naijapals,838,128250,200,258960,0,0,10,4,naija news celebrity gossip nigeria nigeria biggest music nollywood nigerian movie website,kim kardashian shows baby bump hiding baby bump several hit miss outfits ...^stylish mother of three kim kardashian puts her sexy body on display in two piece bikini photos^american actress angelina jolie speaks on her divorce it hard being single i do n't enjoy^american actress angelina jolie speaks on her divorce it hard being single i do n't enjoy^american actress angelina jolie speaks on her divorce it hard being single i do n't enjoy^nicki minaj embarrassed by camel toe incident in latex outfit at vmas naijapals^nicki minaj embarrassed by camel toe incident in latex outfit at vmas naijapals^nicki minaj embarrassed by camel toe incident in latex outfit at vmas naijapals^bbnaija housemate gifty caught begging kim kardashian for a comment on any of her photos^bbnaija housemate gifty caught begging kim kardashian for a comment on any of her photos^one of the women involved in tristan thomspon cheating scandal claims to be pregnant for him this another maj^kevin hart and wife eniko parrish eecting their first child together gistmania^kevin hart and wife eniko parrish eecting their first child together gistmania^kevin hart and wife eniko parrish eecting their first child together gistmania,10,4,-6,14,0.7142857142857143,-0.42857142857142855,1
32353291,EconUS,580,91402,3175,28128,9,4,1,0,official tweets the economist us correspondents,in elections house representatives democrats win majority votes end fewer seats^half candidates democrats nominated house representatives year women^in elections house representatives democrats win majority votes end fewer seats^half candidates democrats nominated house representatives year women^democrats probably gain majority house representatives fall short senate^in elections house representatives democrats win majority votes end fewer seats^in elections house representatives democrats win majority votes end fewer seats^in elections house representatives democrats win majority votes end fewer seats^democrats probably gain majority house representatives fall short senate^the figure president always unstable one changed state union represented^the figure president always unstable one changed state union represented^the figure president always unstable one changed state union represented^is america longer shining city upon hill we sit interview listen^in press conference july th donald trump announced economy grew amazing a pinch salt is,10,4,-6,14,0.7142857142857143,-0.42857142857142855,1
74578857,popsugarau,2109,71265,299,99496,0,0,10,4,for pop culture obsessed,everyone going buy one thing seeing kate middleton leave hospital^twitter freaking cover good way^everything know fergie josh duhamel split^see pictures kate middleton first official appearance since giving birth april^the duchess cambridge royal us beauty lovers hair icon^major breaking news nicole kidman keith urban welcomed baby daughter via surrogate^there bad blood nikki reed^would you be surprised if jennifer aniston john mayer got back together jennifer aniston john mayer ...^angelina jolie reportedly new man life^angelina jolie tackle love war angelina next film already sounds like labor love actress ...^strangerthings officially renewed season^hugh hefner cause death revealed^jennifer lawrence darren aronofsky split^everything already know reasons why season,10,4,-6,14,0.7142857142857143,-0.42857142857142855,1
46424454,HuffPostCaLiv,701,16864,397,60021,0,0,10,4,features videos blogs women healthy living relationships food entertainment trends home bornandraised series we love things,kate middleton reasons leave hospital soon giving birth^kate middleton wore dress evoked memory diana leaving hospital^a timeline meghan markle prince harry relationship^a timeline meghan markle prince harry relationship^gwen stefani 'went white blake shelton revealed split^gwen stefani 'went white blake shelton revealed split^gwen stefani 'went white blake shelton revealed split^nikki reed nina dobrev squash bad blood rumours^paris fashion week attendees blame kim kardashian robbery^prince harry helped meghan markle pick tiara royalwedding^meghan markle half sister fires back prince harry family comments^joel taylor star discovery channel storm chasers dead^prince harry wanted royal family^meghan markle brings blue jays pride pippa middleton wedding,10,4,-6,14,0.7142857142857143,-0.42857142857142855,1
22515362,Southern_Living,14200,714105,3030,51506,1,0,10,3,instant recipes decorating ideas gardening tips travel destinations southern life,barbara bush says grandfather george h.w asked 'it feel worse wife died^the secret jennifer aniston waves sold walmart 2^all members british royal family ranked net worth^all members british royal family ranked net worth^all members british royal family ranked net worth^all members british royal family ranked net worth^we ca n't stop swooning nicole kidman adorable couple moments^nicole kidman may earned title biggest predators fans move^we love savannah guthrie hoda kotb say friendship^says brief conversation god changed perspective motherhood^tim mcgraw asked faith hill nothing bowl chicken dumplings^tim mcgraw collapses onstage performance ireland^does photo prove amelia earhart survived final flight^with holiday baking season upon us everything need know molasses,11,3,-8,14,0.7857142857142857,-0.5714285714285714,1
24180105,CloserOnline,2941,107728,505,113299,0,0,11,3,showbiz real life stories soap spoilers ask us fridge ...,kerry katona hunt husband number four george kay moves beauty pageant girlfriend^kerry katona hunt husband number four george kay moves beauty pageant girlfriend^kerry katona hunt husband number four george kay moves beauty pageant girlfriend^go girl kerry katona hunts husband number four^kerry katona hunt husband number four george kay moves beauty pageant girlfriend^kerry katona hunt husband number four george kay moves beauty pageant girlfriend^are ben affleck jennifer lopez getting back together^singleton selena gomez talks brad pitt 'lonely girls club parties taylor swift life bieber^is kim kardashian jealous little sister kylie jenner^in week closer confidential 're discussing victoria beckham fresh agony david beckham^in week closer confidential 're discussing victoria beckham fresh agony david beckham^aww enrique iglesias anna kournikova share first photos twins^aww enrique iglesias anna kournikova share first photos twins^aww enrique iglesias anna kournikova share first photos twins,11,3,-8,14,0.7857142857142857,-0.5714285714285714,1
23783028,B96Chicago,1886,74831,873,82749,0,0,11,3,chi station music pop culture celebs our djs gabe,kimkardashian defends baby sister kyliejenner^liam hemsworth amp wedding is most likely off for real plus new song dayswecantstop^listen new boyfriend is hubby material^justinbieber amp haileesteinfeld dating^gets real split decided give another chance^the feud continues katyperry taylorswift^christina aguiliera is engaged to her longtime boyfriend matt rutler check out the ring gt gt congrats^did get engaged beu wilder valderrama^the feud continues katyperry taylorswift^things pennywise inspired ugly christmas sweaters it going to^amp are back together again^hey katykats announces witness album release date amp world tour you have to register for tickets her^clarkson 'when i was really skinny i wanted kill myself^brandy hospitalized losing consciousness plane,11,3,-8,14,0.7857142857142857,-0.5714285714285714,1
125304763,CapitalXTRA,8676,132134,567,163457,0,0,12,2,playing hip hop r b across uk digital radio /107.1 fm london mobile,"so karrueche tran granted five year restraining order chris brown ...^,000,000 monday mood you ready try new dance challenge thanks lindsay lohan remel^kim kardashian posted message kanye west following reports embarrassed recent behaviour^ray j responded kanye west beef nick cannon kim kardashian^are are n't here complete history tyga kylie jenner relationship^so karrueche tran granted five year restraining order chris brown ...^multiple shots fired video shoot tekashi ix9ine kanye west amp nicki minaj reports claim^kanye west finally responded snoop dogg claimed kim kardashian used date drake^are are n't here complete history tyga kylie jenner relationship^rihanna hassan jameel spotted date despite recent split rumours..^ray j responded kanye west beef nick cannon kim kardashian^so nbc want judge american idol kanye judge i ca n't even begin imagine this^ariana grande named first ever honorary citizen manchester^kim kardashian made emotional return paris week first time since robbery",12,2,-10,14,0.8571428571428571,-0.7142857142857143,1
18812572,60Minutes,401,1035645,8033,22153,1,12,0,0,the successful news magazine tv history offering hard-hitting investigative reports interviews feature segments profiles people news,i learned policy matters politics watching dad. before father died former president g^i think guys would willing take years end lives order get sunday^i think guys would willing take years end lives order get sunday^the page audio transcript el faro voyage data recorder longest ever produced ntsb minutes^last year lesley stahl sat sen. john mccain discuss life career illness watch that^in previously unaired footage john mccain minutes interview senator compared time pow^just couple people stand say 'this guy served country in final interview min^last year lesley stahl sat sen. john mccain discuss life career illness watch that^tick tick tick up next minutes begins special rebroadcast senator john mccain final minutes interview^in previously unaired footage john mccain minutes interview senator compared time pow^just couple people stand say 'this guy served country in final interview min^last year lesley stahl sat sen. john mccain discuss life career illness watch that^tick tick tick up next minutes begins special rebroadcast senator john mccain final minutes interview,1,12,11,13,0.07692307692307693,0.8461538461538461,0
225265639,ddale8,1239,615415,7522,95804,1,12,0,0,reporter cnn fact-checking president politicians,here transcript republican sen. jeff flake senate speech supporting canada trump steel an^here transcript republican sen. jeff flake senate speech supporting canada trump steel an^trump never holds solo press conferences almost never interviews anyone outside fox news usually ca^freeland coming back washington wednesday meet senate foreign relations committee giv^he first used campaign speeches convention speech it later became name organization^a rare domestic saturday trump events going las vegas fundraiser dean heller speech at^in first address joint session congress trump praise solemn call democrats republi^one reason presidents travel get easy positive headlines local press here cincinnati enquirer f^the white house added pm televised briefing larry kudlow g7 meeting^the white house added :30 pm sarah sanders briefing^the white house added :45 pm televised briefing secretary state mike pompeo meeting trump right^trump falsely claims us lost 817 billion trade last year the trade deficit 566 billion countin^stephen harper fox canada biggest single purchaser us goods services world ... this the,1,12,11,13,0.07692307692307693,0.8461538461538461,0
15865878,NiemanLab,824,293720,13760,48773,1,12,0,0,we nieman journalism lab part harvard we trying figure future news,cnn rumored shutting snapchat show nbc news whose parent company significant invest^the political tv ad archive making easier journalists report campaign spots^the political tv ad archive making easier journalists report campaign spots^the political tv ad archive making easier journalists report campaign spots^how npr factchecked first presidential debate realtime top live transcript^how npr factchecked first presidential debate realtime top live transcript^npr factchecked first presidential debate realtime top live transcript 22 reporters one google doc^how npr factchecked first presidential debate realtime top live transcript^how npr factchecked first presidential debate realtime top live transcript^how npr factchecked first presidential debate realtime top live transcript one giant google doc^how npr factchecked first presidential debate realtime top live transcript^how npr factchecked first presidential debate realtime top live transcript^in one week propublica set collaborative reporting project find thousands kids six partner newsro,1,12,11,13,0.07692307692307693,0.8461538461538461,0
16640775,WTHRcom,7785,275078,1970,292737,0,7,1,5,thanks visiting wthr-tv nbc television affiliate indianapolis indiana,president trump took shots retired adm. william mcraven interview fox news weekend^it cost everything in hour long interview fox news roseanne barr apologized tweet led t^the report program trustees says medicare become insolvent social security^support roe v. wade reached new high including majority republicans according new nbc news/^the artist booted nashville christmas parade comments made joy behar interview^live now president trump speaks national republican congressional committee march dinner watch^philadelphia ap democratic national committee offers incere apology sanders supporters 'inexcusable remarks emails^tells 'no idea matt lauer misconduct worked together^kevin hart wife eniko parrish eecting baby boy first child together^james franco denies sexual misconduct allegations raised social media sunday golden globes^julia louis dreyfus back work veep revealed last september diagnosed br^priyanka chopra nick jonas announced respective instagram accounts saturday engaged^henry hippo fiona dad dies suffering chronic illness,1,12,11,13,0.07692307692307693,0.8461538461538461,0
21316253,ZekeJMiller,5635,219488,4316,170914,1,12,0,0,white house reporter email zekejmiller.com links rts endorsements,"new york ap federal prosecutors charge nyc subway bomb suspect say wrote facebook trump failed protect nation^criminal inquiry sought hillary clinton use email^total direct spending jobs bill includes unemployment reform 50,284b 59,842b 34,958 19,885^white house :30pm the president signs h.r department homeland security appropriations act^still site selected dnc already filed fec create democratic national convention committee^inbox dnc chair rep. debbie wasserman schultz announces leah daughtry ceo democratic national convention committee^read transcript final presidential debate^statement president regarding trade china^inbox dnc chair tom perez announced today democratic national committee hold democratic national^inbox hillary america partners genius annotate hillary clinton campaign launch speech^just in :30am the president delivers statement rose garden^breaking :00am the president delivers statement rose garden^rt commercial break michigan romney campaign ad restore our future ad red white blue fund ad",1,12,11,13,0.07692307692307693,0.8461538461538461,0
348647639,ILoveMCR,3320,86320,548,103124,0,0,1,12,the city brand trusted symbol civic pride adopted manchester people championing community culture diversity unity ilovemcr,the fitness brand popular celebrities including kendall jenner kim kardashian rosie huntington whitely an^ariana grande named first honorary citizen manchester^ariana grande named first honorary citizen manchester^ariana grande named first honorary citizen manchester^ariana grande named first honorary citizen manchester^ariana grande named first honorary citizen manchester^ariana grande named first honorary citizen manchester^ariana grande named first honorary citizen manchester^ariana grande named first honorary citizen manchester^ariana grande named first honorary citizen manchester^ariana grande named first honorary citizen manchester^ariana grande named first honorary citizen manchester^ariana grande named first honorary citizen manchester,1,12,11,13,0.07692307692307693,0.8461538461538461,0
15688704,journalnews,1963,10322,214,129914,0,4,1,8,we local best covering butler warren counties southwest ohio,chicago hospital shooting nurse critically wounded police officer among multiple victims shot^chicago mercy hospital shooting the victims identified officer samuel jimenez dr. tamara e. o neal a^vice president joe biden visits labor day picnic^vice president joe biden speaks coney island labor day picnic^katie couric breaks silence news matt lauer dismissal 'today^here popular halloween candy every state^here popular halloween candy every state^legendary comedian don rickles dies^just in former fox news ceo roger ailes dead^more former fox news ceo roger ailes dead^michael jackson musical coming broadway^actor ving rhames says police held gunpoint home neighbor reported burglary^ncis fan favorite pauley perrette leaving show seasons cbs,1,12,11,13,0.07692307692307693,0.8461538461538461,0
44728980,ANCALERTS,778,4796040,7718,663888,1,9,1,2,news updates breaking news philippines like facebook page,federal prosecutors charge nyc subway bomb suspect say wrote facebook trump failed protect nation via^watch socioeconomic planning sec ernesto pernia clarifies initial statement family live p^aquino responds sen lacson statement names 'narcolist released publicly aquino rep^crude futures extend gains us energy information administration said domestic supplies fell m barrels last week ong^sen. loren legarda delivers speech dfa th anniversary reminds agency foreign policy must be^ancearlyedition how president rodrigo duterte perform second year office de la salle university pol^on the phone aiza layague gives updates president duterte speech convention vice mayor^look the stage set first us presidential debate republican candidate donald trump democratic be^panelo definitely brought speaking bro eddie even read statem^'humble macron responds critics state union address^amal george clooney welcome boy girl twins^'nypd blue creator steven bochco dead^talk show host seth meyers host golden globes,2,11,9,13,0.15384615384615385,0.6923076923076923,0
29730065,parentsmagazine,9097,4778196,6107,50559,0,5,2,6,gone days striving perfect parent tag real unfiltered moments parentsirl,the popular baby names state^the popular baby names state^what offbeat baby names are most popular your state^the popular baby names state^the popular baby names state^kate middleton hospital bag reportedly packed adorable items^even kate middleton luxury hospital stay costs less typical birth america^pregnant first child check super cute announcement^america ferrera is pregnant with her first child^america ferrera is pregnant with her first child^wants lit baby shower daughter way i might even drink red wine^shameless star jeremy allen white addison timlin eecting first child^april giraffe pregnant viral star eecting another baby calf,2,11,9,13,0.15384615384615385,0.6923076923076923,0
701725963,nowthisnews,12189,2430486,9704,133669,0,6,2,5,stories move send us tips contact.com subscribe daily newsletter,"this haunting sculpture made ,000 knives confiscated police make statement violence^president trump criticized george h.w bush famed 'thousand points light speech used phrase his^president trump criticized george h.w bush famed 'thousand points light speech used phrase his^live hillary clinton addressing mass shooting orlando^reports michael cohen flipped pres trump north korea eanding nuclear program tha^oneinfour u.s. women abortion age women sharing stories trump scotus nominat^world trade center opening amp despite said snl 're trouble finding tenants^miley cyrus says regrets riding around naked wrecking ball^abby lee miller 'dance moms sentenced year prison fraud^mila kunis makes monthly donation planned parenthood mike pence name^anthony senerchia jr. man inspired als ice bucket challenge dead^frasier star john mahoney dead age^ving rhames says police held gunpoint home",2,11,9,13,0.15384615384615385,0.6923076923076923,0
19038934,CBCAlerts,421,1186546,8562,129425,1,5,1,6,breaking national international news alerts cbc news canada tv radio online social media news leader,watch live donald trump hold news conference democrats win control house representatives us midt^'i know everything went tape without hear says trump fox news interview adds t^watch live us president donald trump delivers remarks national republican congressional committee dinner^if everyone world eat food recommended us department agriculture planet would nee^in tweet trade morning donald trump said canada reports 'a really high surplus trade us in fac^us trade deficit grew highest level decade october despite trump administration tariffs analysts say^the twitter account posted closeup look kiss harry meghan shared after^nypd statement weinstein arrest 'today nypd st precinct harvey weinstein arrested processed an^tiger woods arrested dui charge florida spends hours county jail released^more justin bieber cancels remaining dates purpose world tour including sept. toronto^wrongful death lawsuit jim carrey dismissed^former rapper craig mack known hit song flava ya ear dead^'do i need british accent kensington palace releases teaser interview barack obama prince harry se,2,11,9,13,0.15384615384615385,0.6923076923076923,0
14515799,brianstelter,6546,658572,13996,184413,0,10,2,1,anchor chief media correspondent formerly top morning email bstelter.com,updated crossfire story w/ comments cnn cable news channel show like^trump says oprah q biased slanted judge transcript^fox biz prez brian jones issued statement defending maria bartiromo her wide ranging trump interview made^michael moore trolling o'reilly ailes interview tonight ...^in tonight media digest fresh reporting fear my interview melas in^trump spent part sunday club fox news host sean hannity favors judge barrett ...^rudy sunday^cnn anchors reflected anthony bourdain life prime time tribute here comments from^washpo story trump visit editorial board subtweets nyt the meeting record transcript coming^according transcript trump first bring o'reilly th^morning tv intrigue nbc promoted today blinked might missed here my^didja miss today reliable here highlights^nypd confirms today nypd st precinct harvey weinstein arrested processed charged rape,2,11,9,13,0.15384615384615385,0.6923076923076923,0
4760694445,ringer,716,488331,4931,97492,0,4,2,7,sports pop culture tech,who could predicted germany would n't make group stages it st^on pressbox examine rudy giuliani enlightening interview sean hannity and^in patriots without tom brady bill belichick came football miracle week^in patriots without tom brady bill belichick came football miracle week^on jam session discuss angelina jolie vanity fair cover story^on jam session discuss angelina jolie vanity fair cover story^'girls stayed true end series finale^these best tv shows including successionhbo atlantafx eight others everyone lea^no matter hard streaming shows tried subvert tv episode still lives these best fr^these best tv shows including successionhbo atlantafx eight others everyone lea^no matter hard streaming shows tried subvert tv episode still lives these best fr^these best tv shows including successionhbo atlantafx eight others everyone lea^because justin timberlake good enough pitches best super bowl halftime show ever w,2,11,9,13,0.15384615384615385,0.6923076923076923,0
15358759,reviewjournal,177,251833,2220,177710,0,10,2,1,worth talking send news tips atthescene.com rjnow,the first illnesses occurred march recent began may according centers disease co^the centers disease control prevention says outbreaks california massachusetts new yo^the calls going republican national committee describes targeted voters nevada^livestream speaks rally campaign headquarters las vegas watch live now^livestream speak rally campaign headquarters las vegas watch now^the trump campaign confirmed planned rally las vegas south point cancelled^he tried grab las vegas police officer gun donald trump campaign rally june^he tried grab police officer gun attempt kill donald trump june campaign rally las vegas^former president former vice president heading las vegas campaign events s^livestream watch bernie sanders speak democratic campaign rally las vegas academy arts^vanessa marquez gained attention last year said george clooney helped blacklist hollywood d^vanessa marquez gained attention last year said george clooney helped blacklist hollywood d^palace officials announced monday prince harry engaged,2,11,9,13,0.15384615384615385,0.6923076923076923,0
1175221,digiphile,1573,238944,5276,172520,2,11,0,0,director digital democracy project ef editor advocate,congress first branch u.s. government too many members seem forgotten ov^in statement said wished chosen different u.s. attorney general today^in statement strongly objects says revoking access line purported offense unac^transcript potus elect trump interview tonight ht on^watching duke vs. kansas overtime amp reading transcript one marchmadness feels bit diff^data point state opengov c^that accurate while tweets indeed like sta^the president org elaborated false statement^multiple judges signed fisa surveil page the investigation began talked t^the responded inadequately russia attacks us election integrity this^a quote ages whose symbiotic addictive relationship cable news amp people s^will release full written transcript that clearly record^livestreaming certainly speaks transcript/on record issue opengov foia socialgov gov20,2,11,9,13,0.15384615384615385,0.6923076923076923,0
14085099,KDKA,278,178091,1476,146048,1,7,1,4,official twitter kdka-tv news cbs pittsburgh if send us tweet consent letting kdka sister stations showcase air digital,a pittsburgh native lowered american flag half staff aboard uss george h.w bush day forme^the life eectancy u.s. declined slightly last year according new data centers disease con^in interview minutes adult film actress stormy daniels claimed threatened keep quiet h^missing local teen found safe in new jersey a local teenager n't seen week found sa..^president trump attorney rudy giuliani says president wants details classified information shared with^take look president trump concluded speech tuesday washington dc he speaking t^the life eectancy u.s. declined slightly last year according new data centers disease con^hosting thanksgiving year the u.s. department agriculture tips prepare safe thanksgiv^'they foiled me mariah carey blames bungled performance on producers^breaking former dance moms star abby lee miller sentenced year day prison^prosecutor dancemoms abby lee miller went dance moms dance cons sentenced year prison.^for sale brady bunch house sale nearly 1.9 million^dui arrest actor vince vaughn arrested early sunday morning suspicion driving influence accor,2,11,9,13,0.15384615384615385,0.6923076923076923,0
14296157,nbc4i,5815,165440,1514,165450,0,2,2,9,your number one source columbus central ohio breaking news weather sports nbc4 wcmh stormteam4 buckeyenation,vp biden to speak at cincinnati labor picnic vice president joe biden speak major union labor day gat ...^searchable database fbi uniform crime reports fbi uniform crime reports^president trump warns north korea fire fury nbc4^channing tatum wife jenna dewan tatum announce split^'jeopardy host alex trebek recovering brain surgery blood clots^'jeopardy host alex trebek recovering brain surgery blood clots^kensington palace says prince charles walk meghan markle aisle royal wedding.^justin timberlake announces new album man woods scheduled released feb. .^announces new album man woods scheduled released feb.^breaking fiona dad henry hippo dies cincinnati zoo^fiona dad henry hippo dies cincinnati zoo nbc4^fiona dad henry hippo dies cincinnati zoo nbc4^april giraffe pregnant,2,11,9,13,0.15384615384615385,0.6923076923076923,0
16329426,13WHAM,1236,157584,991,168790,0,2,2,9,no breaking news weather authority rochester n.y. area twitter ig,watch live white house press briefing^senator chuck schumer holds press conference following midterm elections^trump warns north korea 'fire fury wham^report ben affleck jennifer garner settle divorce^mario batali includes cinnamon roll recipe apology sexual misconduct^james franco denies sexual misconduct allegations^third suspect arrested xxxtentacion murder^meghan markle dad reportedly wo n't attend royal wedding staging photos wham^steve martin martin short 'colonoscopy parties tom hanks^breaking former fox news ceo roger ailes dead age special report^richard simmons hospitalized severe indigestion wham^april giraffe pregnant^april giraffe pregnant wham,2,11,9,13,0.15384615384615385,0.6923076923076923,0
18989002,CBS6Albany,1375,100265,883,146673,0,7,2,4,bringing news weather sports albany region,if heat oil could see increase spending according u.s. energy information administra^the centers disease control prevention cdc named fentanyl america deadliest drug according a^vermont sen. bernie sanders laying groundwork launch bigger presidential campaign first^if heat oil could see increase spending according u.s. energy information administra^live president trump speaking national republican congressional committee dinner watch^the centers disease control prevention cdc named fentanyl america deadliest drug according a^if heat oil could see increase spending according u.s. energy information administra^today tells new boyfriend kids make first appearance show p^kensington palace releases official photos wedding prince harry meghan markle duke duc^donald trump star vandalized hollywood walk fame^meghan markle dad reportedly wo n't attend royal wedding staging photos^update kensington palace releases statement behalf meghan markle she confirms father atten^breaking former fox news ceo roger ailes dead,2,11,9,13,0.15384615384615385,0.6923076923076923,0
2293099507,SXMUrbanView,1367,34454,245,61231,1,6,1,5,siriusxm urban view ch where talk empowers becomes action solutions african-american perspective,melania trump undergoes kidney surgery walter reed medical center powerhour^sean hannity interview roseanne barr fox news hannity powerhours^laura coates discusses trump pardons the lead jake tapper via^chicago mercy hospital secured shooting injures officer multiple victims reported^cnn don lemon doubles controversial white men comments godfreycomplex^income poverty health insurance coverage united states show^the vanishing white house press briefing powerhours^some good news finally hoda kotb named replace matt lauer co anchor nbc today thepowerhour^show prince harry is engaged meghan markle^'clueless actress stacey dash running congress california powerhour^the show 'clueless actress stacey dash running congress california^michael jackson musical coming broadway powerhour^house cards season shocking twists by numbers show w/,2,11,9,13,0.15384615384615385,0.6923076923076923,0
20558644,NapaRegister,283,33537,633,35655,0,11,2,0,breaking news politics features photos staff retweets napa valley daily online media source napanewsnow,"suicide rates increased percent across united states nearly two decades ending according to^the us centers disease control prevention says people gotten sick multi state outbreak of^the us centers disease control prevention is warning that parasites and bacteria are lurking in hotel pool^an estimated ,000 americans died flu complications last winter according us centers diseas^romaine lettuce is safe to buy again according to u.s. centers disease control prevention^this year salmonella headliner centers disease control prevention reporting eight f^suicide rates u.s. increased nearly percent less years centers disease control^with summer around corner centers disease control prevention eerts warning beware bugs^an estimated ,000 americans died flu complications last winter according us centers diseas^chicago police multiple victims reported shooting hospital^the study us department agriculture shows consumers failed wash hands rub soap f^nfl predictions who come top draft^today birthdays sept. beyonce knowles",2,11,9,13,0.15384615384615385,0.6923076923076923,0
8216772,denverpost,809,439745,6005,200521,1,8,2,2,colorado source breaking news information unlimited digital access subscribe newsletters,a fake photo emma gonz lez went viral far right parkland teens villains^ken buck called michael bennet concede u.s. senate race colorado covote cosen^the denver post editorial board endorsed michael bennet u.s. senate colorado^michael bennet darryl glenn meet first debate u.s. senate seat western slope event saturday^breaking denver public schools superintendent michael bennet chosen fill u.s. senate seat^purple state memo michael bennet goes attack u.s. senate race^how michael bennet u.s. senate race colorado ken buck^live transcript obama romney square final presidential debate^philando castile stopped times police was racial profiling^obama commutes prison sentence chelsea manning soldier convicted leaking classified information wikileaks^prince springsteen who else made onto list top super bowl halftime shows^photos game thrones co stars kit harington rose leslie married scotland^announces new album reputation wake social media blackout via,3,10,7,13,0.2307692307692308,0.5384615384615384,0
16356226,WTOL11Toledo,2155,103412,822,169846,1,5,2,5,breaking news weather traffic sports stories matter nw ohio/se michigan beyond maintained actual humans robots,the bangladeshi immigrant arrested botched suicide bombing new york subway mocked president donald trum^police respond video woman harassing rant sparks outrage social media spectrum woman former emplo^the centers disease control prevention recommends anyone months age older get flu vaccine by^the last democratic presidential debate iowa caucuses new hampshire primaries tonight^the centers disease control prevention recommends anyone months age older get flu vaccine by^so cool the toledo fire department something special tap year jeep fest august this rare c^channing tatum wife jenna dewan tatum announce split^mariah carey new year eve performance 'they foiled gt gt^walmart remove 'cosmopolitan checkout lines what think decision^miss nebraska sarah rose summers crowned miss usa monday night^meghan markle dad wo n't attend royal wedding^beyonce eminem the weeknd headline coachella^april giraffe pregnant,3,10,7,13,0.2307692307692308,0.5384615384615384,0
20629645,CNYCentral,943,82066,682,110808,0,3,3,7,cnycentral source news weather entertainment sports syracuse central new york nbc3/wstm cbs5/wtvh cw6/wstq,ny mayor stopping mosque compromises terror fight^president donald trump hit reset button address joint session congress tuesday night^white house vice president joe biden make statement rose garden^report ben affleck jennifer garner settle divorce^mariah carey new year eve performance 'they foiled^former miss utah trump accuser holding press conference salt lake city^mario batali includes cinnamon roll recipe apology sexual misconduct^james franco denies sexual misconduct allegations^matt damon apologizes comments sexual misconduct^report meghan markle dad attend royal wedding due heart surgery^former fox news ceo roger ailes dead^oscars the complete list nominations winners^april giraffe pregnant,3,10,7,13,0.2307692307692308,0.5384615384615384,0
269581619,7NewsAdelaide,1329,78774,528,139323,1,7,2,3,news adelaide leading news service put together team award-winning journalists camera crews,former u.s. president george bush snr died texas age the wwii veteran helped gui^a rejuventated made strong statement reigning premiers last night a goal second term set up^khawaja makes statement regarding arrest brother sydney fake documents containing alleged^khawaja makes statement regarding arrest brother sydney fake documents containing alleged^weighed debate soaring cost petrol 're averaging around 1.66^a police officer two victims killed mass shooting chicago hospital earlier today poli^four people hurt head collision south myponga one airlifted hospital othe^returned field australian soil darwin four^prince philip skipped royal family traditional easter sunday service leaving queen attend with^the duchess cambridge cemented place fashion icon she named year top royal style i^prince harry meghan markle n't royals planning wedding year princess eugenie announced^another twist royal wedding turmoil meghan markle father almost certainly walk daughter dow^if market new car royal flair prince harry car sale the audi rs us,3,10,7,13,0.2307692307692308,0.5384615384615384,0
18908628,WDTN,470,68412,629,114421,3,10,0,0,working for you,"listen curious robocall seeks damaging information on moore^listen curious robocall seeks damaging information on moore read^authorities ohio say two people found dead home died gunshots including woman reporter fo^water heating one biggest eenses house according u.s. energy information administration^president donald trump preferred congressional candidate chief legislative achievement b^a special congressional election ohio last test voter sentiment nationally november high^water heating one biggest eenses house according u.s. energy information administration^more 900,000 given sinclair college u.s. department education implement four year chi^the u.s. department education published new rules colleges universities deal sexual a^the centers disease control prevention said recently smoking u.s. reached time low^water heating one biggest eenses house according u.s. energy information administration^vice president mike pence delivered wide ranging speech cincinnati tuesday touching tax policy also cap^one dead four injured three car crash",3,10,7,13,0.2307692307692308,0.5384615384615384,0
15723290,TIMEPolitics,762,49938,1541,34164,0,9,3,1,twitter feed politics channel,read transcript vice presidential debate^read transcript second presidential debate^read transcript first clinton trump presidential debate^read transcript final presidential debate^transcript read full text second democratic debate demdebate^read full transcript democratic debate charleston^read full transcript th democratic debate charleston demdebate^transcript sixth democratic debate milwaukee^read full text hillary clinton campaign launch speech^kim kardashian returned white house discuss prison reform^an obama confidant opens eight years white house via vick^oprah intrigued idea running president best friend gayle king says via^melania trump trapped hotel room g20 protesters via,3,10,7,13,0.2307692307692308,0.5384615384615384,0
16951434,WGNOtv,659,38626,811,79736,1,4,2,6,this official twitter account wgno news abc26 new orleans tag photos videos wgno permission share air online,melania trump undergoes kidney surgery walter reed medical center^michael cohen resigns republican national committee post^nbc fox news pull trump campaign racist ad sunday night football backlash^chicago mercy hospital secured shooting injures officer multiple victims reported^chicago mercy hospital secured shooting injures officer multiple victims reported^prince harry meghan markle wed may^amal george clooney welcome twins^finally april giraffe gives birth^after years kermit frog getting new voice^after years kermit frog getting new voice^ellen degeneres cries receiving best birthday gift portia de rossi^ellen degeneres cries receiving best birthday gift portia de rossi wgno^fiona baby hippo dad henry dies,3,10,7,13,0.2307692307692308,0.5384615384615384,0
17068146,WCPO,3446,196864,1662,312337,0,8,4,1,cincinnati breaking news weather traffic onyourside add us ig onyourside,fentanyl deadliest drug america according centers disease control prevention.^fentanyl deadliest drug america according centers disease control prevention.^now streaming vice president joe biden speaks cincinnati labor day picnic^president to speak at afl cio labor day picnic^motorcade pulled afl cio labor day picnic we eect former president bill clinton speak shortly^live former president bill clinton campaigns wife hillary clinton afl cio labor day picnic cincinnati^bernice king speaking cincinnati th anniversary father famous speech encouraged w^china friday accused united states starting biggest trade war economic history us tariffs too^broadway star jennifer holliday backs inauguration performance^sweet dreams beautiful cincinnati eect another hot day ahead like brad pitt '90s hot.^sweet dreams beautiful cincinnati eect another hot day ahead like brad pitt '90s hot.^caitlyn jenner latest celebrity float run office^breaking former fox news ceo roger ailes dead age news network confirms,4,9,5,13,0.3076923076923077,0.38461538461538464,0
16743886,10NewsWTSP,12742,158790,1688,258426,0,3,4,6,news cbs tegna covers news tampa bay st. petersburg clearwater sarasota news tip -577-1010 desk.com reply using,more half u.s. pregnancy deaths deemed preventable centers disease control pr^protesters rally pinellas co. sheriff office 'stand your ground decision^more half u.s. pregnancy deaths deemed preventable centers disease control pr^reports brad pitt accused child abuse investigation^podium says suspicious packages analyzed major investigation u^emmy awards the winners list^channing tatum jenna dewan announce separation^walmart remove 'cosmopolitan magazine checkout lines amid me too movement^scott baio wife renee reveals microvascular brain disease diagnosis^'rob amp big star christopher 'big black boykin dead^former fox news ceo roger ailes dead^cardi b confirms secretly married offset september 'engaged^prince william prince harry best man royal wedding,4,9,5,13,0.3076923076923077,0.38461538461538464,0
290758912,Collider,985,114721,1380,51633,0,1,4,8,read ... ... ... ... ... ... ... ... ... watch ... ... ... ... ... ... ... high impact entertainment news,our official statement regarding loss beloved jon schnepp foreversweaty^ashley judd 'berlin station season amp working david lynch 'twin peaks^a series new aquaman character posters tease underwater creatures queen nicole kidman^david fincher using actor play charles manson season mindhunter quentin tarantino^julie bowen talks 'life party improving melissa mccarthy saying goodbye 'modern family^'stranger things officially renewed season check current renewals cancellat^kevin spacey suspended role frank underwood netflix 'house cards^here full schedule freeform nights halloween starting next wednesday^halloween nearly here full schedule freeform nights halloween spooky movie need^get ready *lots* 'hocus pocus' here freeform full schedule nights halloween^get ready *lots* 'hocus pocus' here freeform full schedule nights halloween^rest easy thewalkingdead fans lauren cohan returning amc drama series season least^watch tv talk crew discuss '13 reasons why getting renewed season,4,9,5,13,0.3076923076923077,0.38461538461538464,0
35390366,Z104fans,8359,16119,155,46333,0,0,4,9,number hit music station z104 entercom station listen live app,rumors swirling dating robert pattinson see the photo everyone talking^worst celebrity dancers dancing stars^icymi complete list grammy winners^is tucker carlson fox news having affair julie bowen modern family^ariana grande breaks her silence following deadly manchester arena elosion^cindy crawford swears this 8 drugstore mascara.. i saw kind i like omg i use this haha^a new suspect arrested xxxtentacion murder^justin bieber selena gomez taking some space but don call it breakup^have mercy uncle jesse eecting first child fianc e caitlin mchugh gt^jennifer lawrence single details split director boyfriend /^sofia richie scott disick enjoy date night she introduces nd puppy^richard simmons hospitalized severe indigestion details^announced going return new halloween movie next year,4,9,5,13,0.3076923076923077,0.38461538461538464,0
77271215,PowerAthens,1010,1799,99,65196,0,0,4,9,wpup power athens hit music station ig,'conan kristen stewart throws major shade justin bieber^international women day stars celebrate^katie couric breaks silence news matt lauer dismissal 'today^dakota johnson interesting moment last night^james franco denies allegations sexual misconduct^photos miss north dakota cara mund crowned miss america^meghan markle maid honor royal wedding^portia de rossi says steven seagal unzipped pants audition^justin theroux breaks social media silence jennifer aniston split^labor day deals sales macy walmart best buy^snap inc. stock falls kylie jenner tweet snapchat redesign^celine dion donates concert proceeds victims las vegas shooting^ncis fan favorite pauley perrette leaving show seasons,4,9,5,13,0.3076923076923077,0.38461538461538464,0
69172612,arabnews,43,196360,2102,186437,4,2,1,6,established arab news middle east leading english language daily,op ed us democrats looked ready storm house representatives november mid terms the kavanaugh fur^saudiarabia king salman meets us house representatives speaker paulryan^saudiarabia crown prince mohammed bin salman welcomed speaker us house representatives paulryan^breaking saudiarabia king salman meets us house representatives speaker paulryan^the philippines finance ministry said sunday eloring plan sponsor catastrophe bond issue simi^trade war us lists 200 bn chinese goods hit tariffs^lindsaylohan make us tv comeback mtv reality series^watch video koko gorilla learned sign language dies^watch video koko gorilla knew sign language dies^reality star kyliejenner made surprise visit high school prom students captured wild night video^seth meyers host golden globes^taylorswift ends intrigue announces new album november reputation^princeharry best man princewilliam arrive st. george chapel royal wedding,5,8,3,13,0.38461538461538464,0.2307692307692308,0
17497090,OnTheRedCarpet,1021,57612,878,38033,0,0,5,8,nan,sofia vergara kate upton top askmen 'most desirable list guess snubbed hint brad pitt^oscar nominees include george clooney jonah hill brad pitt albert brooks shailene woodley snubbed^kim kardashian kanye west attend restaurant opening reality star wears 'kw earrings kimkardashian kanyewest^prince harry duke sussex attend launch menstar coalition to promote hiv testing^brad pitt quit acting three years he years old bradpitt^billboard music awards tomorrow see full list nominations includes justintimberlake lorde^billboard music awards weeks see full list nominations includes imaginedragons pink^billboard music awards nominations full list who you excited see bbma^billboard music awards weeks see full list nominations includes justintimberlake lukebryan^billboard music awards days see full list nominations beyonce miley cyrus^billboard music awards month see full list nominations includes rihanna onedirection^billboard music awards full list nominations justin timberlake icymi^billboard music awards tonight see full list nominations includes katyperry mileycyrus,5,8,3,13,0.38461538461538464,0.2307692307692308,0
5971922,BoingBoing,2246,232008,12908,249554,3,7,3,0,a directory wonderful things,inside fake news sausage factory this is all about income^fox news accidentally puts poll graphic shows least trusted network^fox news accidentally puts poll graphic shows least trusted network^the internet archive looking software extract political ads tv archives^once student name birthday ssn us department education give everything else^once student name birthday ssn us department education give everything else^once student name birthday ssn us department education give everything else^neil gaiman read cheesecake factory menu raise 500k un high commission refugees^most popular baby names state^chicago mass shooting mercy hospital police officer suspect victims^prince harry real dad tom cruise sex guru week tabloids^sen. al franken accused forcibly groping radio host leeann tweeden^sen. al franken accused forcibly groping radio host leeann tweeden,6,7,1,13,0.4615384615384616,0.07692307692307693,0
833612154,APEntertainment,1179,167560,1359,38797,0,3,6,4,this official account ap entertainment department check top stories showbiz,his new book gives berniesanders opportunity promote ideas without going formality launch^news investigative reporter brian ross suspended mistakenly reporting story president^former white house press secretary seanspicer go tour promote memoir `the briefing^emergency surgery hospitalized appendectomy forced postpone date^update georgeclooney wife amal welcome twins ella alexander^update georgeclooney wife amal welcome twins ella alexander^update it boy girl georgeclooney wife amal welcome twins alexander ella^kensington palace releases official portraits wedding prince harry meghanmarkle^kensington palace releases official portraits wedding prince harry meghanmarkle^bill paxton family files wrongful death lawsuit los angeles hospital surgeon performed actor he^case dismissed wrongful death lawsuit filed jim carrey estranged husband mother ex girlfrien^they 're hitched actress kaleycuoco the big bang theory marries equestrian karl cook^ben affleck matt damon production company adopt inclusion rider,6,7,1,13,0.4615384615384616,0.07692307692307693,0
574405888,RSI,13915,23558,499,45810,6,7,0,0,freemarket think tank advancing real solutions complex policy problems follow eerts book them/media aphelan.org,"in era ,000 page bills colossal code federal regulations legislation complex ever tr^nearly two years soaring rhetoric slashing code federal regulations size h^nearly two years soaring rhetoric slashing code federal regulations size h^nearly two years soaring rhetoric slashing code federal regulations size h^nearly two years soaring rhetoric slashing code federal regulations size h^in era ,000 page bills colossal code federal regulations legislation complex ever tr^july eerts discuss social security trustees report^in era ,000 page bills colossal code federal regulations legislation complex ever tr^nearly two years soaring rhetoric slashing code federal regulations size h^nearly two years soaring rhetoric slashing code federal regulations size h^nearly two years soaring rhetoric slashing code federal regulations size h^nearly two years soaring rhetoric slashing code federal regulations size h^in era ,000 page bills colossal code federal regulations legislation complex ever tr",6,7,1,13,0.4615384615384616,0.07692307692307693,0
3893557647,Refinery29UK,612,19436,228,33729,0,4,6,3,delivering daily inspiration live creative life,bristol taxi firm slammed sexist ad campaign^bristol taxi firm slammed sexist ad campaign fat shames women^bristol taxi firm slammed sexist ad campaign^bristol taxi firm slammed sexist ad campaign fat shames women^do n't confuse grief lack courage leaders celebrities react london attack^you see much selena gomez changed years^you see much selena gomez changed years^the account garnered attention corners industry posts causing upset including u^reveals hair destroyed bleach^reveals hair destroyed bleach^harry styles never felt need define sexuality^everything know '13 reasons why season^everything think know meghan markle amp prince harry honeymoon,6,7,1,13,0.4615384615384616,0.07692307692307693,0
26794016,TheSceneSD,1927,16510,375,18820,0,0,6,7,nbc7 san diego platform highlighting good america finest city food drink fashion shopping events entertainment good times,a look comedian leslie jones best takes team figure skating event^images our list best super bowl halftime shows which one favorite^congrats amal george clooney welcome twins^sharon osbourne talks split ozzy osbourne years marriage^angelina jolie brad pitt headed court early next month estranged movie stars battle ov^in case missed relive sweetest touching moments royalwedding prince harry^meet ines rau year old french model n. african descent amp playboy first ever openly transgender playmate.^all presenters sag awards women perhaps reflection changes store hollywoo^see complete list winners billboard music awards^kylie jenner youngest woman forbes list america richest self made women earning spot the^ariana grande joins jimmy fallon the roots perform no tears left cry nintendo labo instruments ea^see complete list winners billboard music awards^the backstreet boys join jimmy fallon the roots perform hit i want it that way classroom instru,6,7,1,13,0.4615384615384616,0.07692307692307693,0
5907282,shobz,1193,8901,299,348534,1,0,5,7,data scientist serena superfan music lover part time writer,the cnn porn scare fake news spreads via^jennifer aniston justin theroux split 'lovingly after two years marriage^jennifer aniston justin theroux split 'lovingly after two years marriage^jennifer aniston justin theroux split 'lovingly after two years marriage^rt saturday night live ratings steady with kristen stewart amp a lot of politics^i think brad pitt win sag oscar maybe leo might coz snubbed lot^mena massoud cast aladdin disney live action reboot e news^'star trek discovery renewed season cbs all access^house cards producers consider killing off kevin spacey frank underwood exclusive via^louis ck accused five women sexual misconduct new report^george clooney once gave his best friends 1 million each rande gerber says^'feud casting who should play princess diana prince charles via^madonna announces she moved portugal is working new music,6,7,1,13,0.4615384615384616,0.07692307692307693,0
40076725,MTVNEWS,5766,5155081,11629,115017,0,0,7,6,fun social wow,all apologies times justin bieber said sorry via^wait did justin bieber and hailey baldwin already get married^chlo grace moretz responds body shaming 'red shoes ads^kim kardashian reveals kanye new yandhi release date it is worth the wait^selena gomez calls relationship justin bieber crazy intense selenators beliebers^selena gomez calls relationship justin bieber crazy intense selenators beliebers^selena gomez reveals she had a kidney transplant^tom petty rock icon and hitmaker dead at^jada pinkett smith calls all eyez on me depiction relationship tupac deeply hurtful^mac miller champions self care and hints at how he doing after breakup with ariana grande^so fetch rachel mcadams is reportedly pregnant with her first child^get ready tiffany haddish is hosting the mtv movie amp tv awards^nick jonas and priyanka chopra are reportedly engaged,7,6,-1,13,0.5384615384615384,-0.07692307692307693,1
9830752,mySA,6713,204929,1451,180613,5,2,2,4,tweeting latest breaking news entertainment site san antonio eress-news text news instant alerts,texas ag chief sid miller interviewing usda post friday^taayers might paid texas ag commish sid miller trip get 'jesus shot^controversial texas ag commish sid miller reportedly eyed trump cabinet post^texas ag chief sid miller interviewing w/ usda post friday^hog apocalypse plan backed texas sid miller hold^utsa issues statement controversial video cops escorting student class^big quotes former president george w. bush today show interview^the worst hit song every year since macklemore train twice^ivanka trump 'why i disagree with my dad magazine cover spawns twitter memes^reliable source bristol palin joins cast mtv 'teen mom og years pregnancy tripp^actor jeremy london arrested domestic violence dispute wife juliet reeves via^richard simmons hospitalized california evere indigestion^internet sensation april giraffe pregnant,7,6,-1,13,0.5384615384615384,-0.07692307692307693,1
9542972,PIX11News,2768,69404,1391,176127,0,1,7,5,pix11 news every story hits home new york hometown station since,watch live police sharing information four people killed astoria one victims year^amal george clooney welcome twins^elle faces backlash false kim kardashian kanye west breakup tweet^elle faces backlash false kim kardashian kanye west breakup tweet^shots fired near tekashi ix9ine kanye west nicki minaj california music video set report^shots fired near tekashi ix9ine kanye west nicki minaj california music video set report^elle faces backlash false kim kardashian kanye west breakup tweet^elle faces backlash false kim kardashian kanye west breakup tweet^ryan seacrest revealed kelly ripa new co host live^tina turner son craig turner dead apparent suicide^after years kermit frog getting new voice^after years kermit frog getting new voice^after years kermit frog getting new voice,7,6,-1,13,0.5384615384615384,-0.07692307692307693,1
826108328312987652,billboardhiphop,152,54456,502,14927,0,0,7,6,hip-hop/r b music channel,kanye west smiles battles kardashians 'family feud^the weeknd almost released upbeat album split selena gomez^travis scott pleads guilty disorderly conduct allegedly inciting riot^kanye west unleashed live rant mind control publishing rights amp best living recording artist^a timeline kanye west amp relationship performance together chicago^a timeline kanye west amp relationship performance together chicago^a timeline kanye west amp relationship performance together chicago.^third suspect arrested connection xxxtentacion murder^flavor flav sues chuck d public enemy team unpaid royalties amp releasing music without consent^tamar braxton files divorce husband manager vincent herbert^tamar braxton files divorce husband manager vincent herbert^nelly reportedly criminal investigation sexual assault^returning the voice season,7,6,-1,13,0.5384615384615384,-0.07692307692307693,1
1632903139,PeopleFood,1364,52432,306,33062,0,0,7,6,get latest celebrity food news plus exclusive recipes cooking tips kitchen inspiration editors people fb instagram peoplefood,kourtney kardashian sophia richie caitlyn jenner attend star studded malibu chili cook off^kourtney kardashian shares current meal plan that helps her 'stay track^kourtney kardashian shares current meal plan that helps her 'stay track^kourtney kardashian shares current meal plan that helps her 'stay track^kourtney kardashian shares current meal plan that helps her 'stay track^kourtney kardashian shares current meal plan that helps her 'stay track^kourtney kardashian shares current meal plan that helps her 'stay track^kfc runs out gravy one week after suffering chicken shortage^kfc runs out gravy one week after suffering chicken shortage^icymi that starbucks narwhal frappuccino thing and tastes like pink starburst^that starbucks narwhal frappuccino thing and tastes like pink starburst^jonathan cheban is legally changing his name 'foodg d^jonathan cheban is legally changing his name 'foodg d,7,6,-1,13,0.5384615384615384,-0.07692307692307693,1
848997614095814656,dailyblastlive,2788,11255,66,21545,0,5,7,1,real honest entertaining live national tv show digital news a live conversation day trending stories,roseanne barr sat first tv interview after^set first ever televised interview fox news will watch o^former u.s. secretary state coach team cleveland hear debate^we 're hearing sides debate separating immigrant families border live now^hello everyone 're live twitter afternoon periscope we interview^comedian leslie jones posted gym selfie us talking listen^the feud continues responded upset discussing ex ca^the feud continues responded upset discussing ex ca^we latest divorce battle angelinajolie bradpitt daily blast live catch her^baby extravaganza comedic actress amy schumer eecting royalty meghan markle may showing how excited a^marc summers commented friend mattlauer former co anchor called the^the feud continues responded upset discussing ex ca^just in reports pregnant boyfriend travis scott,7,6,-1,13,0.5384615384615384,-0.07692307692307693,1
16342817,theprovince,3463,174435,2403,212379,0,1,8,4,online companion vancouver daily tabloid the province the web team manages twitter account,a simple blood test shows genetic risk suicide early enough head catastrophe^david cassidy fighting memory loss wants 'enjoy life arts^the complete list winners golden globes arts^which royals secret social media accounts^ben affleck jennifer garner settle divorce case report^beyonce reunite destiny child coachella report^caitlyn jenner skips son brody jenner wedding^rachel weisz daniel craig welcome baby girl^jennifer lawrence swears sex terrified getting sti^after long search ryan seacrest officially kelly ripa new permanent live co host^don rickles legendary comedian actor dies arts^relive meghan markle prince harry big day the best royal wedding photos^oscars the complete list nominees winners happen,8,5,-3,13,0.6153846153846154,-0.2307692307692308,1
14857525,csmonitor,2122,74680,4488,306428,0,5,8,0,a news organization focusing ideas values behind global headlines get journalism,obama 8217 strategy afghanistan pakistan president obama unveiled new afghanistan pakistan str..^the monitor opinion president trump strategy similar former president barack obama also off^the monitor opinion president trump strategy similar former president barack obama also off^the monitor opinion president trump strategy similar former president barack obama also off^book review in catastrophe max hastings elores tumultuous early months world war i^angelina jolie brad pitt appear ready adopt syrian refugee^angelina jolie brad pitt appear ready adopt syrian refugee^angelina jolie brad pitt appear ready adopt syrian refugee^angelina jolie brad pitt appear ready adopt syrian refugee^angelina jolie brad pitt appear ready adopt syrian refugee^angelina jolie brad pitt appear ready adopt syrian refugee^angelina jolie brad pitt appear ready adopt syrian refugee^angelina jolie brad pitt appear ready adopt syrian refugee,8,5,-3,13,0.6153846153846154,-0.2307692307692308,1
187179778,dailyedge,259,50820,395,92599,0,0,8,5,instagram dailyedge,here internet reacted brad pitt angelina jolie getting married^khlo kardashian ex said 'he wants nothing family ... the dredge^miley cyrus reportedly called wedding liam hemsworth ... it the dredge^eressions sum kanye claims beyonc inspired kim kardashian^eressions sum kanye claims beyonc inspired kim kardashian^someone brought taylor swift katy perry american idol auditions^billy connolly raging michael parkinson saying billy 'brain dulled^someone brought taylor swift katy perry american idol auditions^ed sheeran gotten engaged longtime girlfriend cherry seaborn once wedding singer wedding.^ed sheeran gotten engaged longtime girlfriend cherry seaborn once wedding singer wedding.^serial wedding singer ed sheeran gotten engaged girlfriend cherry seaborn^guardians galaxy stars chris pratt zoe saldana break silence director james gunn firing^michael fassbender alicia vikander getting married secret ceremony ibiza ... the dredge,8,5,-3,13,0.6153846153846154,-0.2307692307692308,1
110926079,HWD,312,18664,304,24322,0,0,8,5,updates news hwd,what exactly katie holmes relationship tabloids^sarah jessica parker still imagine sex city without kim cattrall^tom hiddleston lock james bond bet anymore^sarah jessica parker still imagine sex city without kim cattrall^today know starting new chapter third hour show hoda kotb told viewer^stephen colbert let billy bush hook^hoda kotb officially replaced matt lauer^today know starting new chapter third hour show hoda kotb told viewer^donald trump almost played president sharknado^everything know reasons why season^exclusive first look jessica lange ryan murphy reunion long day journey night^exclusive first look jessica lange ryan murphy reunion long day journey night^after 500 million deal fell apart weinstein company decided file bankruptcy,8,5,-3,13,0.6153846153846154,-0.2307692307692308,1
17035063,bristei,1736,13461,693,27382,0,5,8,0,sr tv editor i write lot advertising media late-night hosts throw talk music comics hello brian.steinberg.com,abc news rivals nbc news cbs news rushing live streaming era core viewer does^statement sean hannity when potus invited stage give remarks last night i surprised^fox news cnn shake up sunday schedules midterms coverage via^sunday announces interview potus summit^josh elliott popular gma/nbc sports/ cbs news anchor host four day live event yellowstone live on^michael strahan sara haines will host abc new gma hour via^michael strahan sara haines will host abc new gma hour via^abc making big bet michael strahan sara haines stretch good morning america parts th^'good morning america afternoon michael strahan sara haines preview abc bold leap am pm^morning madness eected anchor monday am hour of^michael strahan sara haines will host abc new gma hour via^abc making big bet michael strahan sara haines stretch good morning america parts th^'good morning america afternoon michael strahan sara haines preview abc bold leap am pm,8,5,-3,13,0.6153846153846154,-0.2307692307692308,1
176566301,937RhythmFm,2450,977236,692,355670,0,0,9,4,rhythm where hit music lives ... best urban tunes facebookhttp // listen lihttp //,kevin hart amp wife eniko parrish welcome baby boy comedian kevin hart wife eniko parrish welcomed ...^george clooney and wife amal welcome twins ella and alexander silverbird rhythm fm^george clooney and wife amal welcome twins ella and alexander^np despacito yankee cc nanya morningdrivelagos^np despacito yankee ft cc osakioduwa thingsiwillteachmykids^np despacito yankee afternoondrive cc arthur gladys^np despacito yankee cc arthur gladys afternoondrive^i do n't enjoy being single angelina jolie^i do n't enjoy being single angelina jolie hollywood star angelina jolie says difficult time ...^kim kardashian shares first photo baby girl chicago west adorable kimkardashian^read again ... mobb deep rapper prodigy cause of death revealed as accidental choking^mobb deep rapper prodigy cause of death revealed as accidental choking^read again ... mobb deep rapper prodigy cause of death revealed as accidental choking,9,4,-5,13,0.6923076923076923,-0.38461538461538464,1
24322323,ElleCanada,2514,85242,1158,53983,0,0,9,4,canada leading magazine fashion beauty arts entertainment lifestyle follow us instagram,cindy crawford family closet kids great taste design^we talk interior design kids great taste^cindy crawford family closet kids great taste design^we talk interior design kids great taste^cindy crawford family closet kids great taste design^we talk interior design kids great taste^cindy crawford family closet kids great taste design^we talk interior design kids great taste^brad pitt oscar fashion breakdown men black white penguin style and 're done too easy ab ellecaoscars^are priyanka chopra nick jonas engaged^are priyanka chopra nick jonas engaged^david foster katharine mcphee engaged^david foster katharine mcphee engaged,9,4,-5,13,0.6923076923076923,-0.38461538461538464,1
19447361,700wlw,251,53719,604,85981,0,2,9,2,cincinnati news radio wlw listen anywhere iheartradio,life eectancy united states dropped third year row falling one tenth year y^life eectancy united states dropped third year row falling one tenth year y^celebrities react trump withdraws steph curry white house invitation^celebrity reaction jimmy kimmel monologue on las vegas shooting and guns^jimmy kimmel talks donald trump harvey weinstein on 'gma^katie couric said matt lauer pinched her on the ass on 'today back in^ryan lochte charge dropped in rio robbery case^celebrities remember orlando pulse nightclub shooting victims one year later^celebrities react nfl players kneel lock arms during national anthem^grammy awards see the full winners list^celebrities thank barack obama on last day as president^here how help victims las vegas mass shooting^hugh hefner cause death revealed,9,4,-5,13,0.6923076923076923,-0.38461538461538464,1
36037083,mix923fm,2195,4134,85,75656,0,0,9,4,detroit r b throwbacks,what happens tiffanyhaddish reunites gma buddy georgestephanopoulos check on^celebrities react trump withdraws steph curry white house invitation^what happens tiffanyhaddish reunites gma buddy georgestephanopoulos check on^chris brown slammed by judge for skipping karrueche tran court hearing^katherine jackson resigns as blanket guardian^beyonce birth twins still hospital 'minor issue^simonebiles she biles^celebrities react nfl players kneel lock arms during national anthem^mariah carey not dating both nick cannon and bryan tanaka despite report^jerry lewis dies age^tamar braxton files divorce from vincent herbert^alex rodriguez year old daughter sings for jennifer lopez photos^tori kelly is engaged to german basketball player andre murillo,9,4,-5,13,0.6923076923076923,-0.38461538461538464,1
28109359,WendyWilliams,1961,1519761,7062,26362,0,0,10,3,the new season begins september,jennifer lawrence split director darren aronofsky year dating^meghan markle dad thinks daughter miserable royal family^hot topics meghan markle dad spoke weekend said meghan much pressure looks mis^style reporting miley cyrus amp liam hemsworth called wedding^wendy latest details brad pitt angelina jolie divorce today hot topics^prince harry meghan markle picked date find fairy tale wedding^hot topics khloe kardashian tristan thompson supposedly planning 2 million wedding next summer tri^wendy latest details brad pitt angelina jolie divorce today hot topics^a lot people think angelina jolie using media weapon nasty custody battle brad pitt.^kanye west back rants time fighting three celebrities wife kim kardashian.^hot topics khloe kardashian dealing reports boyfriend tristan thompson allegedly cheated whil^hot topics bill cosby found guilty three counts sexual assault retrial keep watching at^hot topics janet jackson debuted new baby boy ben affleck jennifer garner officially file divorce.,10,3,-7,13,0.7692307692307693,-0.5384615384615384,1
16269666,Bossip,16948,334155,3039,202271,0,0,10,3,the premier destination af-am pop culture entertainment edgy viciously hilarious politically aware and completely unique,doormat days done is khloe kardashian finally dumping dirty dog babydaddy trystin thompson^a pregnant and irritated kim kardashian responds to rumor about lamar odom and khloe video^do n't be fooled mariah carey and nick cannon played nice for cameras but beef boils at kids choice awards^via karrueche tran screw chris brown ... i can post pics whoever i want video karrueche tran got ...^people are trolling ivanka trump why i disagree with my dad cover story in us weekly via^gone eric benet halle berry dumps new boo alex da kid during bora bora baecation^caked up catfight jennifer lopez can stand kim kardashian getting so much attention for her famous fake fatty^yikes gun shots ring off at tekashi ix9ine nicki minaj and kanye west video shoot last night^rumor control kanye west shuts down speculation that he will host american idol reboot^so precious angela jolie and brad pitt lil ethiopian princess zahara wants to grace magazine covers like her^rapradar podcast will smith talks no dealbreaker devotion to jada pinkett and recounts hilarious jay z call afte^madonna files emergency order stop tupac shakur letter auction via^how think kevin spacey character frank underwood written house of cards,10,3,-7,13,0.7692307692307693,-0.5384615384615384,1
75329944,three8six,6,400,21,23756,10,0,1,2,your source things entertainment daytona beach news-journal,a flight volusia/flagler county breweries^shriners parade road closures daytona beach^feel pull prairie uniquely american safari montana^travel old world meets new historic quebec city^things do wednesday^kate dicamillo finds joy summer reading^travel old world meets new historics quebec city^podcasts listen to good beer hunting best craft beer podcasts listen^ticket write city wall flashy changing guard ceremony worth seeing quebec city^tom petty memorabilia goes auction^new post the crown has found its new prince charles queen mother^breaking comedy legend jerry lewis dies age via^new post bristol palin reportedly joins cast teen mom og,11,2,-9,13,0.8461538461538461,-0.6923076923076923,1
34641628,NashCntryDaily,1006,374055,1771,48041,0,0,12,1,covering music lifestyles country music biggest stars a company includes,sultry new single turnin me on was inspired listen^sultry new single turnin me on was inspired listen^sultry new single turnin me on was inspired listen^sultry new single turnin me on was inspired listen^sultry new single turnin me on was inspired listen^sultry new single turnin me on was inspired listen^sultry new single turnin me on was inspired listen^sultry new single turnin me on was inspired listen^watch play it forward covering strong enough^watch play it forward covering strong enough strong strong performance^watch play it forward covering strong enough^watch play it forward covering strong enough^legendary rocker tom petty is dead,12,1,-11,13,0.9230769230769232,-0.8461538461538461,1
22912596,RoyalReporter,4091,103403,912,31115,0,0,12,1,i royal correspondent daily eress london views eressed necessarily employers naturally,big speech ghana prince charles morning slavery it stops short apology though the crown o^do n't know sure my understanding stayed anmer hall long period christmas i may wrong^princess charlotte ahead second birthday tomorrow the photo taken kate anmer hall april^happens it partly due acquiring anmer hall surely normal go berks^there something quite poignant kate drawing picture one royal residences think bed anmer hall street kid^kate tomorrow family staying anmer hall birthday weekend they 're church^the photos george taken anmer hall matt porteous^the cambridges harry meghan staying anmer hall^oh sure church attendance everyone interested staying anmer hall go^yes and charles king need william anmer hall unlike^the marchioness year old husband david marquess also banquet they line near anmer hall houghton hall^harry meghan farmhouse great tew oxfordshire designated official royal residence howeve^meghan markle mother accompany car royal wedding bride father walk the,12,1,-11,13,0.9230769230769232,-0.8461538461538461,1
47991897,avantmusic,1653,86475,261,16382,1,0,11,1,check out avant new single,law passed all child support united states will end beginning reportedly details inside^kanye revealed texts to caitlyn jenner and they prove he still on her side^what going on kim kardashian is freaking out over kanye latest tweet^justin bieber selena gomez confirm romance public declaration love^miley cyrus 'calls wedding liam hemsworth ready children spon^baby crazy kylie jenner may already be trying get pregnant again spon^kourtney kardashian jealous sister kylie jenner relationship travis scott spon^beyonce gives birth twins family drama led very difficult delivery^kanye revealed texts to caitlyn jenner and they prove he still on her side^kris jenner furious travis scott thinks kylie 'deserves^kylie jenner heartbroken disappointed travis scott neglects pregnancy^britney spears gears secret valentine day wedding^anyone notice that cameron diaz disappeared from hollywood here why,12,1,-11,13,0.9230769230769232,-0.8461538461538461,1
989950356,StefArmbruster,3444,6143,225,18203,0,1,12,0,correspondent pacific queensland multicultural aboriginal torres strait gladly public service fed council rep. rts or,we want see aust voices back pacific and pacific voices aust we need hear amp listen to^pacific fisheries ministers unanimously appoint tonga manumatavai tupou roosen first female director general o^pacific fisheries ministers unanimously appoint tonga manumatavai tupou roosen first female director general o^pacific fisheries ministers unanimously appoint tonga manumatavai tupou roosen first female director general o^pacific fisheries ministers unanimously appoint tonga manumatavai tupou roosen first female director general o^pacific fisheries ministers unanimously appoint tonga manumatavai tupou roosen first female director general o^pacific fisheries ministers unanimously appoint tonga manumatavai tupou roosen first female director general o^pacific fisheries ministers unanimously appoint tonga manumatavai tupou roosen first female director general o^pacific fisheries ministers unanimously appoint tonga manumatavai tupou roosen first female director general o^abc v bishop we n't support closing shortwave radio transmissions pacific^pacific fisheries ministers unanimously appoint tonga manumatavai tupou roosen first female director general o^pacific fisheries ministers unanimously appoint tonga manumatavai tupou roosen first female director general o^pacific fisheries ministers unanimously appoint tonga manumatavai tupou roosen first female director general o,12,1,-11,13,0.9230769230769232,-0.8461538461538461,1
18916432,SpeakerRyan,249,3637661,12808,14931,1,11,0,0,office th speaker house paul ryan,rt eda eda hosted panel discussion speaker us house representatives h.e amb yousef al otaiba^watch give weekly republican address national security^look forward deliver weekly republican address efforts keep americans safe^have asked deliver weekly republican address she talk fight isis^in tomorrow weekly republican address mark womenshistorymonth^excited oklahoma state rep. lisa johnson billy deliver weekly republican address tomorrow^here sneak peek tomorrow weekly republican address delivered^i delivering weekly republican address bold pro growth agenda look tomorrow am^saturday weekly republican address little different usual womenshistorymonth^watch weekly republican address womenshistorymonth^now online the house budget committee new report the war poverty years later^after years underfunding budget uncertainty bipartisan budget act passed overwhelmingly sen,1,11,10,12,0.08333333333333333,0.8333333333333334,0
17483878,totalfilm,537,426175,6461,44860,0,0,1,11,the smarter movie magazine get,brad pitt plans quit acting three years time^everything know far strangerthings season^stranger things season release date cast trailer script everything else know far^strangerthings season release date cast trailer script everything else know far^strangerthings season release date cast trailer script everything else know far^strangerthings season release date cast trailer script everything else know far^strangerthings season release date cast trailer script everything else know far^strangerthings season release date cast trailer script everything else know far^strangerthings season release date cast trailer script everything else know far^strangerthings season release date cast trailer script everything else know far^strangerthings season release date cast trailer script everything else know far^strangerthings season release date cast trailer script everything else know far,1,11,10,12,0.08333333333333333,0.8333333333333334,0
24506246,haaretzcom,1612,361632,10360,302498,0,11,1,0,all news opinion analysis israel middle east jewish world,even die hard american jews forced admit week something rotten favorite jewish state^read full transcript clinton trump second presidential debate^the republican national committee came fire prominent republicans former gop members monday after^'as son polish holocaust survivor images sounds family separation policy heart wrenchi^israel police raid ad firm information finances pro netanyahu campaign^israel police raid ad firm information finances pro netanyahu campaign^icymi read full transcript clinton trump third final presidential debate debates2016^icymi read full transcript clinton trump third final presidential debate hillaryvstrump^watch 'who is america sacha baron cohen gets former trump campaign manager defend neo nazis^'who america sacha baron cohen gets former trump campaign manager defend neo nazis^icymi 'who is america sacha baron cohen gets former trump campaign manager defend neo nazis^kim kardashian signs deal face israeli brand carolina lemke,1,11,10,12,0.08333333333333333,0.8333333333333334,0
14730894,FreedomWorks,10420,288839,4259,103288,1,11,0,0,freedomworks one america largest grassroots organizations advocating less government text `` freedom '' join fight use ampfw,"tsa border patrol stole life savings without even charging crime horrifying this ruined his^it one person mitch mcconnell ability call vote wants to^if home state allow vote gets votes senate.^behind in state people behind ,000^trustees report confirms looming medicare social security insolvency ampfw^trustees report confirms looming medicare social security insolvency ampfw^trustees report confirms looming medicare social security insolvency ampfw^trustees report confirms looming medicare social security insolvency ampfw^trustees report confirms looming medicare social security insolvency ampfw^trustees report confirms looming medicare social security insolvency ampfw^trustees report confirms looming medicare social security insolvency ampfw^trustees report confirms looming medicare social security insolvency ampfw",1,11,10,12,0.08333333333333333,0.8333333333333334,0
21782956,wsoctv,2179,271252,1515,250410,0,7,1,4,wsoc-tv no local news station charlotte legalese if send us tweet consent letting us showcase media including tv,"the centers disease control prevention issued food safety alert days thanksgiving has^the centers disease control prevention advising people careful washing cooking raw turkey esp^breaking dnc host committee announced charlotte mayor foxx speaker democratic national convention dnc2012^channel confirmed democratic national convention host committee able raise approx 24.1m convention dnc2012^the centers disease control prevention advising people careful washing cooking raw turkey esp^recall alert utah based swift beef co. recalling ,260 pounds raw ground beef products possible e. col^more million pounds frozen ready eat taquitos recalled amid concerns may con^'intrigued idea running president friend gayle king says^roger ailes founder former ceo fox news dead^roger ailes founder former ceo fox news dead^labor day deals sales macy walmart best buy^snap inc. stock falls kylie jenner tweet snapchat redesign",1,11,10,12,0.08333333333333333,0.8333333333333334,0
8731312,DenverChannel,11625,268021,2847,274153,1,8,0,3,updating breakingnews cowx denver colorado headlines denver7 got news tip tweet us call us -832-0162,the suspect yesterday elosion new york city posted facebook earlier day saying trump faile^just ken buck calls michael bennet concede race u.s. senate watch news 5 p.m. covote^do know types behaviors statements might indicate someone thinking suicide here^the democratic national committee eyeing eight american cities democratic national convention.^fact checking last night democratic presidential candidate debate new hampshire demdebate^after airing trump campaign second anti immigrant ad sunday night football nbc said would no^breaking vice president joe biden says running president statement rose garden^live facebook today white house press briefing press secretary sarah sanders^police giving us update monday shooting downtown denver left one person dead four others in^want live house featured the brady bunch you listed sale 1.885 million take^'game thrones stars kit harington rose leslie married denver7^april giraffe pregnant denver7,1,11,10,12,0.08333333333333333,0.8333333333333334,0
17070252,Q13FOX,1869,122786,1952,218993,1,4,0,7,seattle western washington news weather traffic sports q13 fox kcpq official home seahawks sounders fc storm tweet us using q13fox,melania trump undergoes kidney surgery walter reed medical center^nbc fox news pull trump campaign racially charged ad 'sunday night football backlash^nbc fox news pull trump campaign racially charged ad sunday night football backlash^these victims chicago mercy hospital shooting^china accuses united states starting biggest trade war economic history us tariffs took effect o^an american join royal family prince harry engaged meghan markle^aly raisman sues us olympic committee usa gymnastics^after years kermit frog getting new voice^nicholas duffy fudge star wicked tuna dead^storm chasers star joel taylor dead q13fox^fiona baby hippo dad henry dies^fiona baby hippo dad henry dies,1,11,10,12,0.08333333333333333,0.8333333333333334,0
15397175,whnt,3973,122424,926,130057,1,4,0,7,we north alabama news leader weather authority tag us news tips use valleywx weather photos,melania trump undergoes kidney surgery walter reed medical center^these victims chicago mercy hospital shooting^these victims chicago mercy hospital shooting^these victims chicago mercy hospital shooting^briefing the president president donald trump seen phone aboard air force one talked governor^white house glows pink honor national breast cancer awareness month^white house glows pink honor national breast cancer awareness month^erin moran star happy days dead^erin moran star happy days dead^fiona baby hippo dad henry dies cincinnati zoo^fiona baby hippo dad henry dies cincinnati zoo^fiona baby hippo dad henry dies cincinnati zoo,1,11,10,12,0.08333333333333333,0.8333333333333334,0
14859642,KTVB,4737,89250,939,96899,0,0,1,11,boise idaho local news weather sports ktvb idaho news source social mobile web tv where news comes first,channing tatum jenna dewan announce separation^walmart remove 'cosmopolitan magazine checkout lines amid me too movement^walmart remove 'cosmopolitan magazine checkout lines amid me too movement^scott baio wife renee reveals microvascular brain disease diagnosis^scott baio wife renee reveals microvascular brain disease diagnosis^scott baio wife renee reveals microvascular brain disease diagnosis^report meghan markle dad longer attend royal wedding^former fox news ceo roger ailes dead^'nypd blue creator steven bochco dead^reports priyanka chopra nick jonas engaged two months dating^wwe star vader dead age^wwe star vader dead age,1,11,10,12,0.08333333333333333,0.8333333333333334,0
17129271,CommSec,721,32624,449,105989,1,11,0,0,keep date latest news information investment markets australia leading online broker support reached,the us set release january producer price index producer inflation industrial production tonight.^video economic insights the reserve bank australia left cash rate unchanged rd mont^energy information administration eia eects west texas intermediate wti oil price average us 37.59/bl cut us 38.54/bl^the us energy information administration released latest forecasts ausbiz markets^the us energy information administration released latest forecasts ausbiz markets oil^chart oil prices slumped us energy information administration reported higher domestic crude inventor^yen reaction talk new us tariff list released still awaiting confirmation twitter news via^video mid session the asx200 declining second day investors concerned heightened trade tens^the us china trade tariffs us 34bill us goods effect big swings aussie since pm aest aud/usd^the u.s. china trade tariffs eected kick july tariffs us 34bill us goods take effect from^us dow futures early trade us tariff list goods announced e mini dow sep pts^data focus tonight us durable goods orders may us trade balance may us weekly crude inventories us,1,11,10,12,0.08333333333333333,0.8333333333333334,0
36757125,Variety_Music,6,6079,368,21577,0,0,1,11,music coverage variety,shots fired tekashi ix9ine video shoot with kanye west^harry styles announces world tour dates^scott hutchison frightened rabbit frontman found dead by police^barbra streisand had her beloved dog samantha cloned meet miss scarlett miss violet^former mtv vj jesse camp reported missing^justin timberlake announces man woods tour dates^justin timberlake announces new album man woods single coming friday watch^katy perry host mtv video music awards^lady gaga announces dates two different las vegas residency shows^lcd soundsystem gavin russom comes out transgender^michael jackson musical coming broadway^kelly clarkson host billboard music awards nominees announced,1,11,10,12,0.08333333333333333,0.8333333333333334,0
32547678,oflores,870,1664,76,28719,0,8,1,3,digital journalist golden mike award emmy award winner newshound,the first confirmed us case andes virus reported delaware hospital january according report fr^the us centers disease control prevention warned us consumers tuesday eat romaine lettuce it^the us centers disease control prevention escalated response polio like illness struc^president donald trump visit central ohio saturday injects high stakes congressional special ele^more one fifth 3.9 million president donald trump election campaign spent year^fox news distancing racist remark made one paid commentators sunday^the first confirmed us case andes virus reported delaware hospital january according report fr^the us centers disease control prevention escalated response polio like illness struc^comedian leslie jones may appear lots political sketches lampoon president part job sat^donald trump star hollywood walk fame vandalized man destroyed pick ax^this video demi lovato recent performance california mid state fair july the popular singer i^singer demi lovato hospitalized suffering apparent drug overdose recently performed at,1,11,10,12,0.08333333333333333,0.8333333333333334,0
18806753,RealSimple,1623,1382991,8150,68946,0,1,2,9,creative practical inspiring solutions make life easier instagram simple,the surprisingly popular baby names every state^why does kate middleton leave hospital so soon after giving birth^meghan markle just dropped her own major royal baby hint^here most popular halloween candy your state^here popular halloween candy state^here most popular halloween candy your state^anne hathaway reveals she gaining weight role and preemptively shuts down body shamers^meghan markle dad wo n't attend royal wedding after it was revealed he staged photos report^meghan markle dad wo n't attend royal wedding after it was revealed he staged photos report^julia louis dreyfus says diagnosed breast cancer^surprise ariana grande pete davidson are engaged after dating few weeks^surprise ariana grande pete davidson are engaged after dating few weeks,2,10,8,12,0.16666666666666666,0.6666666666666666,0
17379685,NBCLA,849,488527,4488,282283,1,9,1,1,welcome place news weather everything socal nbcla,"jenna bush hager host one hour special saturday honoring grandfather president george h.w bush who^centers disease control prevention officials said received reports pediatric flu deaths sin^the fda centers disease control prevention cautioned people eat romaine lettuce t^a video replay injury time gave spain goal needed win group b world cup next champio^percent voters approve president job performance nbc news/wall street journal poll found^watch live french president macron delivers rare address joint session congress wraps washingto^each year estimated million people get sick foodborne illness ,000 hospitalized ,000 di^the fda centers disease control prevention cautioned people eat romaine lettuce t^chuck todd host meet press nbc4 conan nolan talk nation fractured political landscape^the raw ground beef products may contaminated e. coli u.s. department agriculture food safety and^meghan duchess sussex prince harry duke sussex first trip married couple photos^prince harry long one britain eligible wealthy single men engaged suits actres",2,10,8,12,0.16666666666666666,0.6666666666666666,0
8795772,freep,3522,471261,4614,239347,0,3,2,7,breaking news analysis chatter detroit michigan w/ web team on guard,obama launches election campaign e mail web site^meet free press all detroit high school football team^live stream president trump makes statement paris climate agreement rose garden^reports brad pitt accused child abuse investigation^kevin hart confesses cheating pregnant wife^tonya harding admits prior knowledge nancy kerrigan attack abc special^walmart remove 'cosmopolitan magazine checkout lines amid me too movement^summer phoenix files divorce husband casey affleck^eminem announces release date new album 'revival^eminem announces release date new album 'revival^prince william prince harry best man royal wedding^reports kylie jenner pregnant,2,10,8,12,0.16666666666666666,0.6666666666666666,0
15922214,rollcall,1587,360639,8088,105813,1,10,1,0,breaking news reporter tweets analysis source news capitol hill since instagram,towards end speech house minority leader nancy pelosi said our basic request honor house re^the united steelworkers league conservation voters spending 3.1 million ohsen azsen nvsen and^the united steelworkers league conservation voters spending 3.1 million ohsen azsen nvsen a^this week at races republican women campaign ads siblings mitt ro^the st president rd vice president onetime congressman cia director united nations ambassador rep^towards end speech house minority leader nancy pelosi said our basic request honor house re^the government accountability office found campaigns president trump hud secretary carson hillary cl^senate minority leader chuck schumer sent letter asking centers disease control prevention look at^at :10 p.m. vice president deliver statement rose garden the president also attend^this afternoon announced wo n't run president watch rose garden statement^during second day testimony time house energy commerce committee mark zuckerberg faced^president donald trump dismissed democratic sen. bob casey rally thursday sleeping bob calling over,2,10,8,12,0.16666666666666666,0.6666666666666666,0
11265832,FOX2now,1703,241580,1980,185645,1,1,1,9,the official twitter page ktvi fox news st. louis breaking news stl stories video photo galleries follow reporters,melania trump undergoes kidney surgery walter reed medical center^dr. hellinger final presidential debate john mccain barack obama squared third f..^channing tatum jenna dewan tatum announce separation^replay video watch moment april gives birth baby giraffe^tmz happy days star erin moran dead^tmz happy days star erin moran dead^ellen degeneres cries receiving best birthday gift portia de rossi^ellen degeneres cries receiving best birthday gift portia de rossi^billboard music awards check complete list winners^billboard music awards check complete list winners^meghan markle prince harry reveal details wedding cake^april giraffe pregnant,2,10,8,12,0.16666666666666666,0.6666666666666666,0
17394793,News3LV,2214,152053,1465,190660,0,2,2,8,breaking news top headlines your nbc affiliate las vegas nevada facebook news las vegas ig news3lv,that wrap first presidential debate hofstra university debatenight news3lv^watch live white house press briefing^report ben affleck jennifer garner settle divorce^angelina jolie split brad pitt 'i n't enjoy single^james franco denies sexual misconduct allegations^third suspect arrested xxxtentacion murder^report meghan markle dad attend royal wedding due heart surgery^steve martin martin short 'colonoscopy parties tom hanks^former fox news ceo roger ailes dead^lady gaga announces las vegas residency park mgm^fergie josh duhamel announce split years marriage^reports kylie jenner pregnant,2,10,8,12,0.16666666666666666,0.6666666666666666,0
12413892,13NewsNow,2042,142004,1168,187091,0,2,2,8,news now part abc affiliate southeastern virginia northeastern north carolina telling stories now,read transcript former president obama speech blasting president trump^read transcript former president obama speech blasting president trump^reports brad pitt accused child abuse investigation^channing tatum jenna dewan announce separation^ex 'dance moms star abby lee miller sentenced year prison^walmart remove 'cosmopolitan magazine checkout lines amid me too movement^scott baio wife renee reveals microvascular brain disease diagnosis^more former fox news ceo roger ailes dead^'nypd blue creator steven bochco dead^lady gaga announces las vegas residency dates^cardi b confirms secretly married offset september 'engaged^prince william prince harry best man royal wedding,2,10,8,12,0.16666666666666666,0.6666666666666666,0
14408989,masslivenews,1925,83465,789,126667,0,2,2,8,your destination everything news sports entertainment across massachusetts,massachusetts lawmakers earn high marks league conservation voters national environmental scorecard^an insurgent underdog vermont sen. laying groundwork launch bigger presidential^maks chmerkovskiy skips 'dancing with stars due conflicts partner vanessa lachey reports say^watch former 'today co hosts meredith vieira reveal matt lauer 'huge bag sex toys katie couric pinch^'jeopardy host alex trebek recovering brain surgery^'jeopardy host alex trebek recovering brain surgery^who die next thewalkingdead a look characters chances survival^who think die next^justin timberlake announces 'the man of the woods tour stopping boston april^rock roll hall fame bon jovi moody blues the cars among inductees^taylor swift announces new album 'reputation released november^coachella lineup the weeknd beyonce eminem headline two weekend festival,2,10,8,12,0.16666666666666666,0.6666666666666666,0
22547149,KMPHFOX26,1388,83166,509,56234,0,3,2,7,breaking news weather sports information fresno area central valley fox26 news studio have great day,despite news reports centers disease control prevention n't warn people dressing c^despite news reports centers disease control prevention n't warn people dressing c^the centers disease control prevention reports food allergies among children rose whopping percent bet^trump warns north korea 'fire fury attack guam threatened^meghan markle nephew developed royal strain marijuana called 'markle sparkle honor wedding.^mario batali includes cinnamon roll recipe apology sexual misconduct^mattdamon apologizes comments sexual misconduct^entertainment news josh duhamel announce split years marriage^everything 'rent broadway show set fox next live musical^richard simmons hospitalized severe indigestion^reports kylie jenner pregnant^april giraffe pregnant,2,10,8,12,0.16666666666666666,0.6666666666666666,0
19660001,KJRH2HD,1122,76860,776,88936,0,7,2,3,your source breaking news weather information tulsa green country links retweets endorsements reach us newsroom.com,"nearly ,000 people united states died guns last year marking highest number gun deaths decad^the test results friday confirmed first human case h3n2 variant influenza reported indiana since and^i think lot foes trump told cbs news interview segment aired sunday face nation.^your health matters possible cancer symptoms via^question stitt attack ads says firm bankrolled edmondson campaign gave cushy job ag steered m^collins told cnn state union opposing landmark abortion case roe v. wade spoke judicial ph^nearly ,000 people united states died guns last year marking highest number gun deaths decad^dad turns driveway real life diagon alley harry potter^it included performances jennifer hudson stevie wonder ariana grande faith hill many well spe^nicholas 'duffy fudge star 'wicked tuna dead^it gon na may justin timberlake announces 'man woods tour dates including stop .^mila kunis makes monthly donations planned parenthood mike pence name",2,10,8,12,0.16666666666666666,0.6666666666666666,0
25354366,ArkansasOnline,101,73024,918,177939,0,7,2,3,arkansas newspaper sign free email newsletters arkdg,arkansas baby names the popular names state last year search moniker find ranking^arkansas baby names search name see ranks see last year popular monikers state^arkansas baby names search name see ranks see last year popular monikers state^arkansas baby names the popular names state last year search moniker find ranking^years ago american troops played major role ending wwi series smaller related conflicts brok^four arkansas cities trying land two branches u.s. department agriculture agency wants to^four arkansas cities trying land two branches u.s. department agriculture agency wants to^rapper travis scott arrested ark concert pleads guilty disorderly conduct how much 'll have^new rapper travis scott arrested arkansas concert pleads guilty disorderly conduct how much he^new tiger woods arrested dui charge florida mugshot know far^walmart remove cosmopolitan magazine checkout lines what national center sexual eloitation said^new walmart remove cosmopolitan magazine checkout lines what national center sexual eloitation said,2,10,8,12,0.16666666666666666,0.6666666666666666,0
23930762,eagleradio,95,64680,403,187405,0,1,2,9,always surrey hampshire fm dab online app smart speaker the peter gordon breakfast show also try,national news outrage lush ad campaign cosmetics firm claims police 'paid lie^showbiz amal george clooney welcome twins ella alexander^national news david beckham hirked responsibility speeding charge say road safety groups^national news prince harry asks william best man^national news ed sheeran engaged girlfriend cherry seaborn^showbiz ed sheeran engaged long term girlfriend cherry seaborn^national news love island star sophie gradon dead^showbiz love island star sophie gradon dead^showbiz kevin spacey house of cards character frank underwood killed^national news meghan father walk aisle royal wedding^national news sir roger moore james bond star dead^showbiz sir roger moore james bond star dead,2,10,8,12,0.16666666666666666,0.6666666666666666,0
932214169335627776,arabnewspk,46,13124,59,14204,0,10,2,0,the official twitter account pakistan,pakistantehreekeinsaf pti chairman imrankhan victory speech thursday said strive ma^pakistantehreekeinsaf pti chairman imrankhan victory speech thursday said strive ma^noor assistant professor international islamic university islamabad became first woman south^the us department state honoured outstanding young leaders around world including daniahassan fr^the us department state honoured outstanding young leaders around world including daniahassan fr^with aim cement ties turkey pakistan presidents countries met discuss area^with aim cement ties turkey pakistan presidents countries met tuesday discu^oped trade china third largest destination us goods investments country create lar^the us economy may roaring ahead american consumers face prospect paying everyday goods^oped trade china third largest destination us goods investments country create large^like many couple princeharry wife meghanmarkle moving suburbs ahead anti^like many couple princeharry wife meghanmarkle moving suburbs ahead anti,2,10,8,12,0.16666666666666666,0.6666666666666666,0
30002837,kytxcbs19,534,10611,300,106237,0,0,2,10,we got covered to submit news tip call us 903 -1919 send email news.tv visit us facebook,emmy awards the winners list watchcbs19^channing tatum jenna dewan announce separation^walmart remove 'cosmopolitan magazine checkout lines amid me too movement^scott baio wife renee reveals microvascular brain disease diagnosis^'house cards teaser reveals fate kevin spacey frank underwood^meghan markle dad reportedly wo n't attend royal wedding^'nypd blue creator steven bochco dead^reports priyanka chopra nick jonas engaged two months dating^cardi b confirms secretly married offset september 'engaged^wwe star vader dead age^prince william prince harry best man royal wedding^april giraffe pregnant,2,10,8,12,0.16666666666666666,0.6666666666666666,0
34985745,coshtribune,71,2861,113,40664,0,0,2,10,this twitter account coshocton tribune coshocton ohio we covering news coshocton county since,trump assertion left wing protesters violent white supremacists charlottesville sets firestorm^trump assertion left wing protesters violent white supremacists charlottesville sets firestorm^tonya harding admits prior knowledge nancy kerrigan attack abc special^tonya harding admits prior knowledge nancy kerrigan attack abc special^the best memorial day sales home appliances^the best memorial day sales home appliances^summer phoenix files divorce husband casey affleck^summer phoenix files divorce husband casey affleck^serena williams withdraws australian open^serena williams withdraws australian open^oscars the complete winners list^oscars the complete winners list,2,10,8,12,0.16666666666666666,0.6666666666666666,0
788524,guardiannews,1262,2917056,32287,209641,0,2,3,7,the need independent journalism never greater become guardian supporter,betting media firms offer fund addiction awareness ad campaign^one us soldier killed four wounded somalia attack^brad pitt angelina jolie search perfect pr hollywood divorce^actor terry crews i sexually assaulted hollywood executive^brad pitt quit acting 'in three years^pregnant serena williams poses nude vanity fair cover shoot^tony awards complete list nominations^royal wedding meghan markle father walk aisle^louis ck accused five women sexual misconduct new report^tom daley dustin lance black eecting first child^defending champion serena williams withdraws australian open^daniel craig confirms play james bond,3,9,6,12,0.25,0.5,0
116502194,globalnews,1131,354239,2710,209615,1,7,2,2,breaking canadian news fresh perspective local international headlines ig tiktok,texas official sid miller uses c word hillary clinton twitter^former conservative mp tony clement admitted acts infidelity statement full story^starting monday our sotucanada series elores alternative relationships reshaping love canada^we rallying noble nations build new liberal order prevents war achieves greater prosperity^philando castile stopped times police was racial profiling^watch live hillary clinton addresses supporters campaign rally las vegas^on wednesday bruce linton canopy growth ceo sold first legal recreational cannabis canada stroke of^watch live white house press briefing eected focus retaliatory tariffs^here complete list nominees golden globes who rooting^jenner n't reveal final surgery last page^prince harry meghan markle official wedding portraits revealed read more^the latest taylor swift stalker story comes within weeks another man caught attempting break swift,3,9,6,12,0.25,0.5,0
14528874,aldotcom,850,305016,1934,177463,0,8,3,1,all things alabama managed team alabama media group monica keener,doug jones endorsed league conservation voters alsen race will vote jones moore^doug jones endorsed league conservation voters pac alsen race will vote jones moore^doug jones endorsed league conservation voters pac alsen race will vote jones moore^the centers disease control prevention investigating suspected cases acute flaccid myelitis po^the death atlanta centers disease control prevention researcher whose body found chattahooc^takeaways third democratic presidential debate new hampshire^msnbc democratic presidential debate live stream feed new hampshire how to^the centers disease control prevention investigating suspected cases acute flaccid myelitis po^seacrest gets another 'war eagle 'live kelly ryan guest^seacrest gets another 'war eagle 'live kelly ryan guest^meghan markle prince harry hired alabama nanny connie help arrival first child sh^emmy award winning actress julia louis dreyfus diagnosed breast cancer,3,9,6,12,0.25,0.5,0
23077947,whiotv,1748,137956,913,170372,0,5,3,4,the dominant media center dayton miami valley with tweets sent humans bots,chicago mercy hospital shooting what know victims^chicago mercy hospital shooting the victims identified officer samuel jimenez dr. tamara e. o neal a^chicago hospital shooting nurse critically wounded police officer among multiple victims shot^white house vice president joe biden make statement rose garden more info come^live vice president joe biden makes statement rose garden^katie couric breaks silence news matt lauer dismissal 'today^local woman wins big morning live kelly ryan^local woman wins big morning live kelly ryan^'superman star margot kidder dead^meghan markle dad heart surgery wo n't attend royal wedding report says^more former fox news ceo roger ailes dead^actor ving rhames says police held gunpoint home neighbor reported burglary,3,9,6,12,0.25,0.5,0
21215544,thestaredmonton,1243,55380,620,57638,0,5,3,4,local stories covered journalists live plus best investigations opinion national international news,edmonton members democrats abroad joined protesters united states weekend writing letters to^he hero the orlando police department honoured pulse valor award invited trump s^the teamsters international brotherhood electrical workers told cprail posi^if ucp platform product advertisement would come one drug warnings s^in world fakenews spreads like wildfire facebook trump tweet shake alliances trudea^is meghan markle already miserable royal we tongue cheek scoop tabloids^summon trumpeters town criers meghan duchess sussex child you heard first that^summon trumpeters town criers meghan duchess sussex child you heard first that^in comedian said standup act bill cosby lot rape allegations ... when^did know meghan markle brief case carrying model deal no deal howie mandel ca n't remembe^prince charles walk meghan markle aisle royal wedding stepping father br^prince charles walk meghan markle aisle royal wedding stepping father br,3,9,6,12,0.25,0.5,0
17094323,FOX26Houston,4564,311072,1803,340938,0,0,4,8,get latest headlines houston news sports weather photo submission disclosure,tmz khloe kardashian i want nothing to do with lamar odom but ... pm m f fox^dishin 'bout fears for jessica weight obsession gone too far we 've got skinny jessica simpson ...^entertainmentnow kylie jenner misses tyga birthday party amid breakup rumors the post kylie ...^want fairy tale wedding like meghan markle the castle venue right houston coming fox morni^second suspect arrested xxxtentacion murder^entertainmentnow harry potter river cruise set sail summer^harry potter river cruise set sail summer^harry potter river cruise set sail summer^second suspect arrested xxxtentacion murder^actor vince vaughn arrested suspicion dui^breakingnews kensington palace says prince charles walk meghan markle aisle royal wedding fox26news^justin timberlake announces play houston may part the man woods tour tix sale,4,8,4,12,0.3333333333333333,0.3333333333333333,0
21021326,FOX5Vegas,559,236978,1384,137008,3,6,1,2,watch -9 a.m. -6:30 p.m. -11:30 p.m. weekends a.m. p.m send news tips desk,breaking federal prosecutors charge nyc subway bomb suspect say wrote facebook trump failed protect nation^live now pres trump addressing nation regarding new plans afghanistan watch live facebook^melania trump undergoes kidney surgery walter reed medical center gt^white house says supreme court review patient protection affordable care act march ...^on this day a year ago las vegas played host st presidential democratic debate final presidential debate of^watch president trump scheduled deliver keynote speech nevada gop convention gt gt^live president trump delivers speech vfw convention watch gt^last year chicago man displayed crosses honor victims las vegas shooting strip he retur^campaign rally scheduled las vegas today gt^mariah carey new year eve performance 'they foiled gt^iconic 'brady bunch house sale priced 1.885 million gt^aly raisman sues us olympic committee usa gymnastics push change future generations athletes wi,4,8,4,12,0.3333333333333333,0.3333333333333333,0
19031057,kron4news,3216,207444,2548,206325,1,3,3,5,kron4 the bay area local news station,federal prosecutors say nyc subway bomb suspect wrote facebook trump failed protect nation^live blog behind scenes first presidential debate hofstra university^live president trump speaking th anniversary celebration national federation independent b^president trump calls gavin newsom 'clown las vegas campaign rally^david cassidy fighting memory loss wants enjoy life^channing tatum wife jenna dewan tatum announce split^mariah carey new year eve performance they foiled^james franco denies sexual misconduct allegations^breaking comedian actor jerry lewis dies age according publicist^mugshot actor vince vaughn arrested suspicion dui^just in tina turner son craig turner dead suicide rip^reports say kylie jenner pregnant first child,4,8,4,12,0.3333333333333333,0.3333333333333333,0
30868693,OKCFOX,618,38589,840,145421,0,2,4,6,watch fox pm p.m. p.m. good day ok weekdays a.m. a.m,watch live white house press briefing^watch live senator chuck schumer holds press conference following midterm elections^angelina jolie split brad pitt 'i n't enjoy single^mariah carey new year eve performance 'they foiled^report angelina jolie named bizarre lax terror threat sent police^former miss utah trump accuser holding press conference salt lake city^mario batali includes cinnamon roll recipe apology sexual misconduct^james franco denies sexual misconduct allegations^third suspect arrested xxxtentacion murder^reports former fox news ceo roger ailes dead^oscars the complete list nominations winners^reports kylie jenner pregnant,4,8,4,12,0.3333333333333333,0.3333333333333333,0
16579249,ABCNewsRadio,823,14961,628,52211,1,6,3,2,america largest commercial radio news network powered worldwide resources news,"nyc bombing suspect wrote facebook alleged attack 'trump failed protect nation complaint^democratic debate clinton sanders spar over wall street speech transcripts^as white house responds fallout pres trump meeting putin helsinki spea^on president trump legal team sets new conditions interview robert mueller^democratic debate clinton sanders spar over wall street speech transcripts^alert news special report vice president biden makes statement rose garden^interview president george w. bush world news podcast^kellyanne conway accused violating ethics rules urging shoppers 'go buy ivanka stuff'^trump administration politicians celebrities react sean spicer resignation^kim kardashian admits her selfie obsession 'ridiculous^david spade donates 100,000 mental health organization following kate death^queen elizabeth ii visits victims manchester arena attack hospital",4,8,4,12,0.3333333333333333,0.3333333333333333,0
23974167,Y108Rocks,1775,10400,190,56794,0,0,4,8,rock radio hamont -800-267-rock mornings -2 -6 sat,prince harry meghan markle a detailed timeline relationship^brad pitt jennifer lawrence leonardo dicaprio fighting money owed weinstein company^justin bieber says religion et free bondage shame^prince harry meghan markle a detailed timeline relationship^rachel mcadams welcomes first child boyfriend jamie linden report^prince harry meghan markle official wedding portraits revealed^john oliver blame meghan markle calling royal wedding^justin timberlake announces new album man woods^julia louis dreyfus diagnosed breast cancer^the weeknd beyonce eminem headline coachella^daniel craig confirms play james bond^royal wedding prince william prince harry best man,4,8,4,12,0.3333333333333333,0.3333333333333333,0
15679641,dallasnews,734,674059,6628,199910,3,4,2,3,the official dallas morning news twitter account daily news updates headlines,breaking texas rangers investigate sid miller oklahoma trip^campaign scratch fever serving treasurer texas agriculture commissioner candidate sid miller^rt farmer texas firm makes custom cowboy hat trump admired sid miller^how dinosaur hunter million year old sea monster got^how smu dinosaur hunter million year old sea monster got smithsonian^paige patterson steps key convention speech amid ongoing controversy^interview former president george w. bush former first lady laura bush george bush^selena gomez reveals kidney transplant donor name might ring bell guidelive^selena gomez eeking treatment emotional issues hospital stays^rapper nelly arrested wal mart outside seattle suspicion rape^'when i really skinny i wanted kill kelly clarkson clarifies elains^the brady bunch house sale 1.885 million,5,7,2,12,0.4166666666666667,0.16666666666666666,0
986907835,BuzzFeedEnt,362,85146,1168,38385,0,0,5,7,entertainment news worth sharing,people think katy perry just shaded taylor swift on american idol and it awkward af^kristen wiig might play the villain in wonder woman and i am dead deceased on the floor^jennifer lawrence still terrified nude photo hack via^people think katy perry just shaded taylor swift on american idol and it awkward af^taylor swift endorsement of democrats has relieved fans and infuriated others via^beyonc was offered a role in the beauty and the beast remake but turned it down^drew barrymore just confessed that '90s drew barrymore spray painted her ex boyfriend car^modernfamily renewed sixth season and abc tonight via^ryan reynolds opened up about how blake lively helped him reconcile with his dad before he died^kim kardashian and kris jenner predicted kylie would be a young mom^in honor friday th first look new series screamqueens starring^black panther is officially the most tweeted about movie of all time,5,7,2,12,0.4166666666666667,0.16666666666666666,0
15145138,ABC13News,497,46700,593,144636,1,3,4,4,edward r. murrow award winner your stop breaking news weather sports coming heart virginia story ideas email us newsdesk.com,today honor life george h.w bush he buried private service alongside wife years^watch live president donald j. trump speaking national republican congressional committee dinner.^watch live sarah sanders holds white house press briefing first time kicked virgi^traffic alert crews scene crash involving four vehicles intersection graves mill road an^report ryan phillippe 'devastated 'false allegations domestic violence^angelina jolie split brad pitt 'i n't enjoy single^mariah carey new year eve performance 'they foiled^report angelina jolie named bizarre lax terror threat sent police^former fox news ceo roger ailes dead^breaking reports former fox news ceo roger ailes dead^fergie josh duhamel announce split years marriage^reports kylie jenner pregnant,5,7,2,12,0.4166666666666667,0.16666666666666666,0
64798315,Mix965Houston,349,9780,189,52005,0,0,5,7,houston best variety hours commercial free music noon start workday home the morning mix call us 713 881-5965,secondnews fergie and josh duhamel split lady gaga hospitalized gt gt gt^'lauren lowdown cee lo leaving 'the voice jessica simpson weight loss^watch new 'aquaman trailer starring jason momoa nicole kidman^secondnews ed sheeran gon na new movie list worst dancers 'dancing with the stars and^secondnews american idol wo n't show bad auditions time around kanye west facetimes sick fan^freeform nights of halloween schedule^freeform nights of halloween schedule^freeform nights of halloween schedule^lady gaga announces las vegas residency^lady gaga announces las vegas residency^secondnews thursday april giraffe pregnant banned weddings songs^secondnews thursday the kardashians hiring april giraffe pregnant banned weddin,5,7,2,12,0.4166666666666667,0.16666666666666666,0
14629315,XXL,741,2344641,8106,217928,0,0,7,5,hip-hop higher level,kanye west shares friendly exchange caitlyn jenner wife kim kardashian feuds jenner claims made^much made strained relationship caitlyn jenner kardashian family kanye west^a rapper retired named son saint west^according someone set ix9ine kanye west nicki minaj video shoot eight shots fired du^yg laugh hearing set ix9ine video shoot kanye west nicki minaj shot ix^kanye west returns twitter uploads nearly minute video mind control^collaborative history goes back nearly years 'nasir here timeline m^fifty days xxxtentacion murder trayvon newsome fourth suspect arrested surrendering a^the first suspect arrested xxxtentacion murder wants private investigator look evidence against^fifty days xxxtentacion tragic death trayvon newsome fourth final suspect slain rapper m^authorities arrested fourth final suspect xxxtentacion murder year old trayvon newsome^the suspect arrested charged first degree murder death xxxtentacion pleaded guilty th,7,5,-2,12,0.5833333333333334,-0.16666666666666666,1
4234594469,TVCconnect,312,124945,205,169886,0,1,7,4,tvc one leading entertainment channels lagos,rivers state governor chairman peoples democratic party national convention committee ...^amal george clooney welcome boy girl twins^justin bieber selena gomez confused selena gomez continues mental health treatment.^justin bieber selena gomez confused selena gomez continues mental health treatment.^claudia jordan confirms jamie foxx katie holmes dating^kim kardashian says kanye west warned date^kanye west judging american idol would one interesting spectacles tv happening ...^kanye west star ryan seacrest revamped american idol^surprise ariana grande snl star pete davidson engaged^cardi b confirms secretly married offset last year^cardi b confirms secretly married offset last year^brandy hospitalized losing consciousness plane,7,5,-2,12,0.5833333333333334,-0.16666666666666666,1
188443744,TIMENewsFeed,139,59244,1965,23891,0,1,7,4,what vital viral web real time hosted newsfeed,seth meyers inserted himself into white house press briefing with comical results^meghan markle is brought happy tears when children sing anti zika serenade^celebrities react donald trump immigration order^celebrities react donald trump immigration order^here how katy perry responded taylor swift superfan american idol^prince harry wants meghan markle have baby girl people couldn be more excited^no one more excited about meghan markle prince harry than this animal^here how katy perry responded taylor swift superfan american idol^the reason why meghan markle won have maid honor her royal wedding^prince charles will walk meghan markle down aisle royal wedding^mirai nagasu makes history first american woman land triple axel olympics^taylor swift music video director hits back criticism beyonc copied bad blood,7,5,-2,12,0.5833333333333334,-0.16666666666666666,1
804605049859145728,TRTWorldNow,8,48751,432,42777,7,3,0,2,breaking news live updates developing stories around world follow in-depth coverage features videos,us house representatives speaker paul ryan announces seeking election saying wants spen^republicans us house representatives looking impeach rod rosenstein country high profile de^us house representatives defeat republican compromise bill aimed providing long term protections drea^it took little longer thought you democrat conor lamb claims victory for^update the us house representatives approves bill fund federal government march ending for^a bill us house representatives would halt arms sales saudi arabia unless secretary state mike pomp^if mueller team finds criminal activity regards russian interference us presidential election wh^the eu call accountability scapegoating killing jamal khashoggi saudi consulate i^ousted pakistani prime minister nawaz sharif way back britain face jail time says knows^we working set call president president turkey reaffirm strong bond w^just in us olympic gymnast simone biles claims sexually abused jailed us team doctor larry nassar^months dozens women accused harvey weinstein sexual misconduct including rape the weinstein company th,7,5,-2,12,0.5833333333333334,-0.16666666666666666,1
63155859,KISS985BUFFALO,2922,42995,368,70111,0,0,7,5,your number one hit music station listen live,jamie foxx katie holmes finally out public as couple via^rumors swirling dating robert pattinson see the photo everyone talking^taylor swift looks gorgeous leggy black dress date night with calvin harris via^rumor kim kardashian kanye west getting secretly married week^billsmafia before game let us know your favorite song today hot4at4 kmb18^kanye west talks join revamped american idol via^icymi complete list grammy winners^jason aldean brittany kerr are eecting baby boy via^have mercy uncle jesse eecting first child fianc e caitlin mchugh gt^jennifer lawrence single details split director boyfriend /^richard simmons hospitalized severe indigestion details^announced going return new halloween movie next year,7,5,-2,12,0.5833333333333334,-0.16666666666666666,1
21436676,FootwearNews,1597,26242,505,64013,0,0,7,5,the shoe authority,celebrities wear body confident looks^spotted favorite wedges yesterday^rocks pointy neon yeezy heels post breakup^rocks pointy neon yeezy heels breakup^rocks pointy neon yeezy heels breakup^responds red shoes movie ad controversy^stepped ariana grande concert daughter th birthday^kanye west kim kardashian best looks met gala through years^prince william prince harry wore somber suits visit victims grenfell tower fire^the craziest red carpet looks ever worn billboard music awards artists including^pose naked british vogue spring fashion issue^pose naked british vogue spring fashion issue,7,5,-2,12,0.5833333333333334,-0.16666666666666666,1
2999935691,CapitalNENews,4765,5886,98,21412,0,0,7,5,we news team capital north east tweet us stories email northeast.news.com,told bigtop40 feeling bit fragile split wor cheryl hear full interview^liam payne spoken split cheryl last month he told us feels like 've broken twice^there word yet miley cyrus liam hemsworth rumours 've split reported 've called t^it reported kylie jenner pregnant us media say eecting first baby travis scott.^justin bieber hailey baldwin already got married according uncle alec baldwin told reporters t^fans think dating thanks post met ball photo^david beckham prosecuted speeding charge lawyer successfully fought allegation on^meghan markle going spend christmas prince harry senior members royal family sandring^nelly arrested police us suspicion rape he accused assaulting woman tour bus.^love island star sophie gradon died age she appeared series show northumbria^game of thrones stars kit harington rose leslie reportedly getting married today capitalreports^black panther tweeted movie time million tweets sent it.,7,5,-2,12,0.5833333333333334,-0.16666666666666666,1
19546942,Refinery29,2150,1327441,9865,94987,0,3,8,1,the catalyst women feel see claim power we cover news fashion beauty entertainment wellness,according centers disease control prevention latina adolescents aged 24 years u.^according centers disease control prevention latina adolescents aged 24 years u.^the popular baby names state^kellyanne conway disciplined urging go buy ivanka stuff^blac chyna angela kardashian dalliance concludes^kristen stewart dyed hair loveliest shade blonde^the real reason justin bieber selena gomez still fighting^happy halloween cardib break feud nickiminaj meghanmarkle spilling her^does confirm jamie foxx katie holmes dating^kylie jenner bleach destroyed latest hair look^what kate middleton severe morning sickness everyone freaking^just one day meghan markle pregnancy announcement four days attending princess eugenie star st,8,4,-4,12,0.6666666666666666,-0.3333333333333333,1
22646514,NewstalkFM,1566,230068,1333,212920,1,2,7,2,we aim engage challenge inform entertain tune newstalk -108fm,trump calls end partisan politics us house representatives shifts toward democrats^election debates important part democratic process need centred principle i^election debates important part democratic process need centred principle i^academyawards full list oscar night winners^academyawards full list oscar night winners^academyawards full list oscar night winners^sharon ozzy osbourne reportedly split years marriage^sharon ozzy osbourne reportedly split years marriage^tv host amanda byram leave dancing with stars ireland dwtsirl^leave dancing with the stars irelandhttp //^james franco denies allegations sexual misconduct^james franco denies allegations sexual misconduct,8,4,-4,12,0.6666666666666666,-0.3333333333333333,1
126741060,msnlatino,603,14421,133,125101,0,0,8,4,nan,con qui n se lleva mejor jenner en el clan kardashian^kim kardashian regresa la casa blanca por reforma criminal^fotos que demuestran que tal vez sofia richie scott disick son el uno para el otro^julia roberts se emociona tras ver el musical de pretty woman en broadway^fotos que demuestran que tal vez sofia richie scott disick son el uno para el otro^'the lighthouse es la nueva pel cula del director de 'la bruja con un robert pattinson punto de golpearle en e^fotos que demuestran que tal vez sofia richie scott disick son el uno para el otro^fotos que demuestran que tal vez sofia richie scott disick son el uno para el otro^how to get away with murder karla souza gives birth first child 'welcome baby girl gianna^meghan markle dad reportedly wo n't attend royal wedding^jennifer aniston is injured her first appearance since justin theroux split^ving rhames says police held him gunpoint his own home after neighbor reported robbery,8,4,-4,12,0.6666666666666666,-0.3333333333333333,1
109863068,Vicki_Mirror,1431,3091,45,20697,0,0,8,4,senior celebrity reporter online geordie lass london views e vicki.newman.co.uk,katie holmes jamie foxx plit call wedding five years^beyonce 'to reunite destiny child coachella fans losing^kim kardashian 'hoping strike royal friendship meghan markle kuwtk^caitlyn jenner scolded skipping son brody wedding charity ball kuwtk^travis scott pleads guilty disorderly conduct days daughter birth^angelina jolie brad pitt 'going head head custody battle six kids^billy connolly wife pamela blast michael parkinson comments health^kim kardashian leaves fans divided poses naked advertise eyeshadow kuwtk^chicagofire star dushon monique brown cause death revealed^hugh hefner cause death revealed playboy founder dies aged^stranger things star shannon purser comes bisexual^this could sort dress meghan markle wore pippa middleton wedding,8,4,-4,12,0.6666666666666666,-0.3333333333333333,1
22063870,TheYBF,2184,127733,1417,67203,0,0,9,3,your source of celebrity fabulousness foolywang founder editor natasha eubanks |tips.com ig theybf daily snap/fb theybf,sofiarichie turned vacaying year old boyfriend scottdisick mexico.^about week wendywilliams said one would ever sit guest co host chair announced^chrissy teigen opens up for the first time about her struggle with postpartum depression in glamour magazine^sofiarichie turned vacaying year old boyfriend scottdisick mexico.^there rumors halleberry dating johnwick3 co star keanureeves are find site^blacchyna going jugular suing all kardashian jenners elosive new lawsuit deets th^sofiarichie turned vacaying year old boyfriend scottdisick mexico.^sofiarichie turned vacaying year old boyfriend scottdisick mexico.^there rumors halleberry dating johnwick3 co star keanureeves are find site^split tisha campbell files for divorce from husband of years duane martin^nd suspect arrested in connection to xxxtentacion murder young thug former manager manny halley wins huge se^blue ivy is the boss watch the year old hilariously shut down beyonce amp jay z at the grammys,9,3,-6,12,0.75,-0.5,1
15761637,breakingnewsie,762,48726,608,307516,0,0,9,3,ireland premier breaking news website providing minute news sports reports,kellyanne conway told people 'go buy ivanka stuff questions raised^david cassidy fighting memory loss wants 'enjoy life^celebrities react donald trump inauguration president^baftas here full list award winners^george clooney wife amal welcome birth twins ella alexander^i enjoy single hard angelina jolie^teen gets turned prom kylie jenner goes instead^kris jenner defends life of kylie amid criticism^david beckham fight speeding claim technicality^everything need know inbal dror meghan markle rumoured wedding dress designer^watch christopher plummer replaces kevin spacey 'all money world trailer^christopher plummer replaces kevin spacey all the money in the world trailer,9,3,-6,12,0.75,-0.5,1
15077962,joblocom,812,47192,1520,76532,0,0,9,3,founded kickin movie news reviews onto masses ever since movie fansite run fanboys over billion views yt,captain america the winter soldier 2014 movie clip nick fury assassination attempt marvel hd via^the untouchables clip stairway shootout 1987 kevin costner^fifty shades freed trailer darker amp of grey compilation 2018 dakota johnson jamie dornan movie via^red shoes and the dwarfs official trailer 2017 chloe grace moretz an ... via^red shoes and the dwarfs official trailer 2017 chloe grace moretz animation movie hd via^margot robbie matthias schoenaerts star ruin wwii drama^fifty shades freed trailer darker amp of grey compilation 2018 dakota johnson jamie dornan movie via^the lost city of z movie clip soldiers the queen 2017 charlie hunnam robert pattinson drama via^the lost city of z movie clip who are you 2017 charlie hunnam robert pattinson drama hd via^the full list mtv movie amp tv awards nominees released^keri russell early talks join cast star wars episode ix^jamie lee curtis preps michael return new halloween trailer tease,9,3,-6,12,0.75,-0.5,1
474232856,AP_Planner,8598,37695,1309,18432,0,3,9,0,highlights upcoming events essential editorial planning tool a paid service the associated press for news updates follow,sunday bob schieffer interviews mitt romney face the nation cbs^a week today holds campaign rally las vegas 14 oct^tomorrow th anniversary president bill clinton signing brady bill law requiring five day waiting^tomorrow uk prince harry meghan duchess sussex open 'nelson mandela centenary exhibition london^tomorrow birthdays beyonce knowles 37 max greenfield 38 wes bentley 40 mike piazza 50 damon wayans 58^tomorrow uk prince harry meghan duchess sussex open 'nelson mandela centenary exhibition london^tomorrow iheartradio music festival day two biggest live concert event radio history hosted ryan seacr^a month away magazine person year revealed 6 dec^days away dolly parton honored musicares person year gala 8 feb^days away person year announced 6 dec^tomorrow iheartradio music festival day two biggest live concert event radio history hosted ryan seacr^tomorrow birthdays kel mitchell 40 tim burton 60 elvis costello 64 gene simmons 69 regis philbin 87,9,3,-6,12,0.75,-0.5,1
1555266841,TheStatesmanLtd,252,10108,400,77144,1,2,8,1,the statesman one india oldest english newspapers founded kolkata,an indian american cancer research scientist hiraltipirneni lost narrowly special election hou^actors rosamundpike chris o dowd joined cast upcoming sitcom state union^donaldtrump flagged an election one states america would scarcely much mom^files divorce anna faris^justinbieber selenagomez yet confirm officially back together^here kanyewest advised date kimkardashian^angelinajolie enjoys children custody battle agreement bradpitt^angelinajolie enjoys children custody battle agreement bradpitt^angelinajolie enjoys children custody battle agreement bradpitt^talks join 'americanidol^seeking treatment emotional breakdown hospital following tough weeks^files divorce anna faris,9,3,-6,12,0.75,-0.5,1
369631951,ElvisDuranShow,876,274504,930,51064,0,0,10,2,instagram follow crew,justinbieber saddened by selenagomez hospitalization^is report is having 'divorce docs drawn up is 'miserable with^is anyone else thinking circumstances around royal baby seem fishy how kate middleton walk out^what beautiful cover vogue cover story see interview highlights^being famous downsides kristenstewart on dating robertpattinson 'the public were the enemy^squash rumors nope is not dating^uh oh.. think are mariah carey amp joe jonas feuding^kuwtk episode reveals how khloekardashian dealt with tristanthompson scandal^avrillavigne good sport 'mildly amused by death conspiracy^kyliejenner back spotlight kuwtk^here how help victims las vegas mass shooting^check full list billboard music awards nominations see full list of bbmas nominees,10,2,-8,12,0.8333333333333334,-0.6666666666666666,1
64705123,albericie,943,117439,820,14060,0,1,11,0,abc chief economics correspondent,the abs pressuring fed gov 4 million funding lift provide reserve bank w^tune pm local radio a wrap today historic events+ liberal senator head t^michael kroger abcpm mp french au pair frankly time time need ministers who^my guest :30pm local radio former liberal leader alexander downer pm auspol libspill^it malcolm turnbull said lead government strong policy clim^i done story today amp developments super chairman rick allert witness box the^my guest tonight abcpm president nsw liberal women council mary lou jarvis tune local^coming pm warren entsch says needs decisive he needs assert author^exclusive on pm tonight radio amp tv i 'll interviewing warren entsch confirmed leaks he^on abcpm i asked michael kroger concedes merit subjective term i keep hearing got t^looking forward hosting pm next fortnight takes break tune pm aest on^my guest tonight abcpm president nsw liberal women council mary lou jarvis she adviser,11,1,-10,12,0.9166666666666666,-0.8333333333333334,1
31115170,KiddNation,55,96265,425,45344,0,0,11,1,official account the kidd kraddick morning show hosts,jennifer aniston justin theroux announced separated anyone else heartbroken news^kim kardashian american idol judge^today showbiz top is katie holmes pregnant jamie foxx baby^on day years ago world graced one would rule put formation ar^throwback listen old interview talks friendship^apparently squashed beef none^apparently already got married courthouse 're crying ... justin^some reporters saying already headed divorce he apparently ve^hugh hefner passed away blake gwen try baby amp rob kardashian suing blac chyna alleged assault^says jenner may compete th season dancing stars how think 'll^apparently squashed beef none^nick jonas priyanka chopra engaged showbiztop5,11,1,-10,12,0.9166666666666666,-0.8333333333333334,1
822039337,Rare,1574,57203,632,88765,0,1,11,0,news opinion probably ruin day that rare,"rand paul will donald trump betray voters hiring john bolton^comedian leslie jones tweeted selfie pyeongchang^comedian leslie jones tweeted selfie pyeongchang^even gwen stefani shocked blake shelton miranda lambert split^rumor lovebirds gwen stefani blake shelton planning put wedding baby plans hold u^rumor lovebirds gwen stefani blake shelton planning put wedding baby plans hold u^keith urban nicole kidman beam pride exciting moment^rumor lovebirds gwen stefani blake shelton planning put wedding baby plans hold u^kendall jenner breaks tears discussing dad transition woman^rumor lovebirds gwen stefani blake shelton planning put wedding baby plans hold u^rumor lovebirds gwen stefani blake shelton planning put wedding baby plans hold u^this man spent 150,000 look like kim kardashian that severe allergic reaction",11,1,-10,12,0.9166666666666666,-0.8333333333333334,1
2200632505,KIIS1065,986,38328,282,73788,0,0,11,1,sydney hit music station morning non-stop hits day drive home sosydney kiis1065,caitlyn jenner shot can intern pete trick staff reporting fake news kjshow^looks like miley cyrus liam hemsworth wedding summerfling jcentertainment^addresses rumours joins season^a man faithful options kyle liked quote chris n't live it ge^umm already married the evidence seems suggest details gt gt^caitlyn jenner shot can intern pete trick staff reporting fake news kjshow^the top celebrity feuds v it could well biggest summe^the top celebrity feuds v it could well biggest summe^g'day prince harry meghan markle the royals officially touched sydney could n't exc^they back back together months.. we love kiis1065^the top celebrity feuds v it could well biggest summe^the queen royal staff reportedly called across u.k emergency meeting buckingham palace kiisnews,11,1,-10,12,0.9166666666666666,-0.8333333333333334,1
15013823,sohh,1262,17193,486,96388,0,0,11,1,for all rap hip-hop urban news there is follow us ig/fb/snapchat periscope,angela rye tries to h amp m adidas mila j bathroom selfie iphone x show kim kardashian s^rihanna low key hurt over drake amp nicki minaj see him w/ nicki hurts^chance the rapper responds to donald trump co signing him amp issues open apology my fault yo^kylie jenner figure puma deal destroyed by kanye west she is on yeezy team^kanye west shares low key dm shot of dave chappelle idris elba amp spike lee^meek mill out here firing shots at nicki minaj her ex n***a embarrassed^chris brown responds to everyone freaking out over him choking karrueche lookalike^taylor swift responds to kim kardashian that moment when kanye west secretly records your^machine gun kelly uses brad pitt movie scene to fuel eminem battle tensions that why no one will remember your^kim kardashian amp donald trump meet again in white house kanye west wife fights for year old freedom^blac chyna still waging war against kim kardashian but gives khlo amp kylie jenner passes^watch seconds of awesomeness from steven spielberg new ready player one sci fi thriller,11,1,-10,12,0.9166666666666666,-0.8333333333333334,1
158450841,Now1005FM,704,6008,240,45369,0,0,11,1,welcome fall today best hits live now -766-1005 now1005fm,r official pictures prove gt^people freaking kimkardashian kanye reportedly got northwest hairextensions th^revealed recent interview thinks reached end dating life following^there good chance planning release single life post are excit^catfight fires back^is seeking revenge we think gt^do you think make cute couple they 're reportedly dating now see pic^called sister 'a distraught evil human kim upset ... g^there good chance planning release single life post are excit^rumor missed shows diamondsworldtour might pregnant what think^after struggling w/ depression fast years entered mental health facility treatmen^let halloween memes roll lol this one so accurate right tonight freeform kicks nights,11,1,-10,12,0.9166666666666666,-0.8333333333333334,1
16898332,Philip_Elliott,6266,30672,1494,34686,1,10,0,0,washington correspondent ninth election cycle alumnus politics lifelong learner rt endorse,democratic leader nancy pelosi ends record breaking speech house floor honor house representati^hillary clinton acceptance speech john mccain hero patriot deserves respect demsinphilly^this minutes transcript video^a reminder rudy giuliani defended bernie kerik based results ethics interview^democratic leader nancy pelosi ends record breaking speech house floor honor house representati^at vfw national convention president trump leads audience jeers fake news these veterans foug^dnc starts radio campaign turn african american hispanic female voters first dnc ads cycle star obama^flight booked heading new hampshire next week romney/bachmann/huntsman/giuliani/ palin who ahead fitn^ahead joint us eu presser white house sends gem briefing doc america farmers un^a reminder the white house organized briefing house intel chairman the result actual selectiv^the president complaining us trade deficit canada per trade rep the u.s. goods servi,1,10,9,11,0.09090909090909093,0.8181818181818182,0
3353220134,WardDPatrick,1405,7617,181,23702,0,10,1,0,fox news producer former embed i like tom brady better i like opinions/bad jokes,president trump you get rid ice going country going afr^tomorrow sits exclusive interviews senators r mo and^a source familiar confirms fox news president trump asked serve second term chai^reports fbi spoken christine blasey ford friend leland keyser her attorney howard^must watch gov rick scott exclusive fox news sunday tomorrow am et floridarecount flsen^on today fox news sunday^this awesome also song used called heart champion use time open for^new president trump tells probably not ask nominees beforehand might vote o^vice president deliver statement rose garden :10pm^this sunday chris sits exclusive interview r az chairman armed services^the kim kardashian white house news cycle lasted roughly minutes today,1,10,9,11,0.09090909090909093,0.8181818181818182,0
26327958,jasonlynch,690,6687,300,35837,0,0,1,10,tv/media editor former person contributor so much great tv little time,epix picked third season berlin station hours star ashley judd appears time person year cover^after year long search ryan seacrest takes kelly ripa new live co host^icymi after year long search ryan seacrest takes kelly ripa new live co host^icymi this week cover uneectedly tumultuous year annual upfront roasts retu^from yesterday this week cover uneectedly tumultuous year annual upfront roa^icymi from killingeve pose cobrakai best new tv shows^from killingeve barry would thought cobrakai best new tv shows^here picks best tv shows^icymi from pose thegoodfight atlanta picks best tv shows^american idol officially returning next season but abc fox behind revival^theflash janethevirgin bookend the cw fall premiere dates,1,10,9,11,0.09090909090909093,0.8181818181818182,0
32962809,mrmikev,1481,1680,39,11154,0,0,1,10,digital editor alum gratitude attitude,josh duhamel fergie relationship thebest place following split^meghan markle love letter mom perfectly showcases unbreakable bond royalwedding^how became unlikely icon feminism^we proposal all details clare crawley engagement ring thebachelorwintergames^how kristin cavallari rebranded laguna beach the hills teamkristin^here likely wo n't see lorde performing tonight grammys^why demi lovato longer cares haters say swimsuit instagrams^how shannon beador handling ex husband david new girlfriend rhoc^how sam hunt continues win wife heart celebrate year anniversary acmawards^watch tearfully accept billboard woman year award francia raisa womeninmusic^how stagecoach headlines florida georgia line became rock stars country music,1,10,9,11,0.09090909090909093,0.8181818181818182,0
17348525,StarTribune,699,364615,3788,165383,0,4,2,5,minnesota top choice news journalists help,meet new dinosaur bone hunter science museum minnesota alex hastings really digs crocodiles jur^breaking joe biden set make statement rose garden within minutes apparently say whether running president^u.s. rep. jason lewis made disparaging comments women radio show says cnn report includes audio.^these four minnesoans sought answers outside mainsream religions shared stories us part our^channing tatum wife jenna dewan tatum announce split social media post^longtime friend gayle king says oprah 'intrigued idea running president^koko gorilla knew sign language dies^ed sheeran says engaged girlfriend cherry seaborn inspiration song perfect.^'big bang theory star kaley cuoco marries equestrian karl cook son intuit co founder scott cook.^'chicago fire actress dushon monique brown dead age^lady gaga announces year las vegas residency,2,9,7,11,0.18181818181818185,0.6363636363636364,0
15577108,NZStuff,790,184196,1661,277673,0,0,2,9,stuff new zealand largest popular news site email newstips.co.nz,raunchy katy perry rocks kiwi fans^katie holmes seen mystery man^tonya harding admits prior knowledge nancy kerrigan attack tv special^happy days star erin moran dead^happy days star erin moran dead^happy days star erin moran dead^happy days star erin moran dead^'do i need british accent barack obama sits interview prince harry^weinstein company eected file bankruptcy sale talks collapse^ben affleck jennifer garner officially file divorce^ben affleck jennifer garner officially file divorce,2,9,7,11,0.18181818181818185,0.6363636363636364,0
15736836,pbpost,16786,173847,1766,202635,0,0,2,9,the palm beach post reporters resources palm beaches delivering breaking news need stay informed real news starts here,royal wedding meghan markle siblings evil stepfamily fairy tale^oprah 'intrigued idea running president friend gayle king says^matt damon apologizes comments sexual misconduct^mtv movie amp tv awards complete winners list^'superman star margot kidder dead^meghan markle dad heart surgery wo n't attend royal wedding report says^just in simon cowell rushed hospital scary accident london home^breaking former fox news ceo roger ailes dead^michael jackson musical coming broadway^ving rhames says police held gunpoint home neighbor reported burglary^kylie jenner pregnant according reports,2,9,7,11,0.18181818181818185,0.6363636363636364,0
26028938,CBNNews,8487,122803,1523,112428,2,9,0,0,christian broadcasting network bringing international christian inspired -hour news,the voting finished midterm election finally democrats control us house represe^faith nation be sure tune :30pm est facebook live today coverage immigration also^at least cases confirmed states year least additional illnesses states^prayer request the centers disease control prevention warning possible outbreak new polio lik^prayer request the centers disease control prevention warning possible outbreak new polio li^at least cases confirmed states year least additional illnesses states^an exclusive interview president trump attorney rudy giuliani^at least cases confirmed states year least additional illnesses states^prayer request the centers disease control prevention warning possible outbreak new polio lik^prayer request the centers disease control prevention warning possible outbreak new polio li^at least cases confirmed states year least additional illnesses states,2,9,7,11,0.18181818181818185,0.6363636363636364,0
32496789,WLOS_13,713,75948,873,198221,0,1,2,8,news wnc news leader serving asheville hendersonville rutherfordton waynesville weaverville brevard points also,during interview nbc today show thursday michelle obama revealed years seated nex^fergie josh duhamel announce split years marriage liveonwlos^mariah carey new year eve performance 'they foiled liveonwlos^mario batali includes cinnamon roll recipe apology sexual misconduct^koko gorilla knew sign language dies^matt damon apologizes comments sexual misconduct liveonwlos^new meghan markle dad reportedly wo n't attend royal wedding staging photos^fergie josh duhamel announce split years marriage liveonwlos^meryl streep joins cast 'big little lies season^richard simmons hospitalized severe indigestion^april giraffe pregnant,2,9,7,11,0.18181818181818185,0.6363636363636364,0
54329062,kiii3news,262,56163,421,79264,0,2,2,7,south texas news leader,roseanne barr interview sean hannity fox news airs tomorrow do think soon roseanne h^the 'fox news sunday host told trump presidents eressed frustration news media none h^channing tatum jenna dewan announce separation^channing tatum jenna dewan announce separation^american idol renewed second season abc^scott baio wife renee reveals microvascular brain disease diagnosis^scott baio wife renee reveals microvascular brain disease diagnosis^former fox news ceo roger ailes dead^'nypd blue creator steven bochco dead^'nypd blue creator steven bochco dead^april giraffe pregnant,2,9,7,11,0.18181818181818185,0.6363636363636364,0
5770442,1010WINS,672,42285,1322,181016,1,5,1,4,all news all the time associated press winner digital presence wins,update federal prosecutors charge suspect underground port authority bus terminal bombing say wrote face^men women states run republican national committee best avoid topic pos^photos democratic presidential candidates debate in new hampshire^just in comments cnn jim acosta getting back press pass we writing rules regul^giuliani new hampshire receive primary award^multiple fatal shooting update four people confirmed dead queens shooting the nypd says one victim was^entertainment news taylor swift pays tribute aretha franklin 'michael jackson th^here popular halloween candy state^after years kermit frog getting new voice^tab hunter dead the heartthrob star 'damn yankees movie later gay icon dies age partn^it looks like america favorite giraffe pregnant aprilthegiraffe,2,9,7,11,0.18181818181818185,0.6363636363636364,0
14617026,WRDW_WAGT,1221,36135,479,114625,0,4,2,5,news12investigates on your side augusta/aiken the team like/rt endorsement,the u.s. centers disease control prevention says people sickened salmonella linked t^the u.s. centers disease control prevention says people sickened salmonella linked t^hosting thanksgiving year the u.s. department agriculture tips prepare safe thanksgiv^crash claims life one injures four others car hits building ehrhardt^kensington palace released three photos royal wedding prince harry meghan markle the whole fam^billy bush confirms trump voice infamous access hollywood tape^jinger duggar vuolo is pregnant with her first child^it beautiful day neighborhood tom hanks set play mr. rogers upcoming biopic you are my^america ferrera is pregnant with her first child^watch justin timberlake surprise ellen degeneres with an epic birthday gift^it family affair britain royal officials say prince harry asked elder brother prince william best,2,9,7,11,0.18181818181818185,0.6363636363636364,0
17613674,localnews8,241,17780,382,42059,2,9,0,0,eastern idaho western wyoming news leader have news tip share us,"the us house representatives passed bill wednesday fund security schools^eight people found dead ohio seven killed execution style police still investigating^new data us centers disease control prevention says homicides suicides involving guns bee^according us centers disease control prevention shooting homicides rise common^cigarette use among american adults lowest since centers disease control prevention^the democratic national convention underway without committee chairwoman debbie wasserman schultz^new data us centers disease control prevention says homicides suicides involving guns bee^according us centers disease control prevention shooting homicides rise common^cigarette use among american adults lowest since centers disease control prevention^rest in peace a police officer doctor recently graduated pharmacist three victims shooting^the u.s. department agriculture emergency watershed protection program authorized 500,000 he",2,9,7,11,0.18181818181818185,0.6363636363636364,0
99127272,KALBtv5,490,12590,286,121198,0,7,2,2,we provide local news along nbc cbs network programming central louisiana portions southwestern mississippi,flu shots and pregnancy if 're pregnant thinking whether get flu shot seas^trump asks rnc chair to stay president donald trump said asked republican national committee chairwoman ron^icymi wednesday orchard foundation announced 4.5 million grant received u.s. department ed^flu shots and pregnancy if 're pregnant thinking whether get flu shot seas^the us department agriculture declared agriculture disaster recent drought louisiana^sausage recall tens thousands pounds jimmy dean meat products possibly containing pieces metal be^congressman ralph abraham announced friday us department agriculture awarded grants amount o^the nielsen company said million people united states watched wedding prince harry american^time put dancing shoes monica nobles cortney burford gdc take final look dancing the^xxxtentacion murder suspect arrested days rising rap star xxxtentacion killed luxury bmw electric^april giraffe pregnant,2,9,7,11,0.18181818181818185,0.6363636363636364,0
17072129,KTVL,1653,8492,389,70902,1,5,1,4,your connection southern oregon northern california phone -773-7378 email ktvl.com ig ktvlnews10 header courtesy harry brindley,"tear jerking footage former congressman republican senate leader bob dole pays tribute george h.w.^according centers disease control prevention heat illness practice competition lea^an estimated ,000 young children vaccination diseases shots r^according centers disease control prevention heat illness practice competition lea^an estimated ,000 young children vaccination diseases shots r^chicago police said last week fewer homicides nearly fewer shooting victims the^john mayer hospitalized emergency appendectomy^mario batali includes cinnamon roll recipe apology sexual misconduct^former fox news ceo roger ailes dead^actor jeremy london famous roles th heaven mallrats party five arrested do^oscars the complete list nominations winners",2,9,7,11,0.18181818181818185,0.6363636363636364,0
151603912,Bruno_J_Navarro,7192,4849,400,111466,1,9,1,0,director content editorial risk spotter dot connector design buff rt endorsement ex etc,"the us house representatives advanced law bill would always require fbi cops ob^the american society civil engineers recently gave michigan infrastructure d+ grade estimating sta^icymi memory lapse trump seeks distance from 'advisor with past ties mafia abc news feliater^a report released today centers disease control prevention showed suicide rates women^trump flustered onslaught negative coverage generated new personal lawyer rudy giuliani^a former chairman republican national committee opines^facebook says russian firm bought ,000 ads campaign^due historic obstruction senate democrats president nominees goal passing appropria^organiser sarah miller said group plans fight facebook long takes bring change tellin^trump selected new head scientific research us department agriculture week scott hutchins an^chris caffarone assistant united states attorney eastern district new york said crew adv",2,9,7,11,0.18181818181818185,0.6363636363636364,0
21258337,TheView,1554,777159,3598,58344,0,7,3,1,join us hottopics comments/handle may published online/tv,abuse victims win espy courage award more survivors abuse hands disgraced usa gymnastics doc^abuse victims win espy courage award more survivors abuse hands disgraced usa gymnastics doc^did church politicize baby jesus a massachusetts church made political statement immigration nati^takeaways from trump wallace interview the co hosts weigh president interview fox news chris wal^the co hosts weigh president interview fox news chris wallace gave a+ his^giuliani media tour success or debacle pres trump attorney rudy giuliani recent interviews white^pres trump hugged american flag conclusion remarks national federation independent busi^let comedians do their job discusses critics digging comedians past controversy just like^let comedians do their job discusses critics digging comedians past controversy just like^oprah winfrey actively considering running president close friend gayle king says.^ahead hottopics reports say khloe kardashian pregnant days kylie jenner reported news do you,3,8,5,11,0.2727272727272727,0.4545454545454545,0
23879043,TheTodayShow,2219,422128,1701,158072,0,2,3,6,australia longest running breakfast tv program weekdays 0am weekends 0am tag us using today,the father fashion designers kate spade sadly passed away days daughters funeral the family^it good balance white australians iraqis syrians vietnamese got mix i^the role prince charles cast next season the crown today^nicole kidman allegedly involved feud today^the brad pitt angelina jolie odds custody six kids today^meghan relationship prince harry shone spotlight family said meghan markle brother it do^if 've got spare us 1.8 million one the house featured the brady bunch sale^after years kermit frog getting new voice today^fergie josh duhamel split years marriage today^made cover forbes richest self made women issue today^new details released wedding year meghan markle prince harry revealing is,3,8,5,11,0.2727272727272727,0.4545454545454545,0
12738892,wcnc,6948,219673,1720,193022,1,2,2,6,the twitter home nbc tv affiliate charlotte north carolina tweet email story ideas newstips.com,tepper i person inner faith i kind wake sometimes say thank god it what^we 're minutes away republican national committee voting host city rnc charl^in europe right u.n. high commission refugees says u.s. refugees admitted are^'go buy ivanka stuff kellyanne conway called house oversight official 'free commercial^emmy awards the winners list^scott baio wife renee reveals microvascular brain disease diagnosis^scott baio wife renee reveals microvascular brain disease diagnosis^breaking former fox news ceo roger ailes dead^lady gaga announces las vegas residency 'the rumors true^lena dunham joins 'american horror story season cast^reports jennifer garner ben affleck officially file divorce,3,8,5,11,0.2727272727272727,0.4545454545454545,0
14269771,WWLTV,1206,200447,1735,226560,1,2,2,6,breaking stories information wwl-tv channel eyewitness news cbs affiliate new orleans,verify is snapchat shutting^raw protests grow outside convention center sessions speech^raw protests grow outside convention center sessions speech^emmy awards the winners list^emmy awards the winners list^walmart remove 'cosmopolitan checkout lines says 'business decision^scott baio wife renee reveals microvascular brain disease diagnosis^reports priyanka chopra nick jonas engaged two months dating^cardi b confirms secretly married offset september 'engaged^cardi b confirms secretly married offset september 'engaged^prince william prince harry best man royal wedding,3,8,5,11,0.2727272727272727,0.4545454545454545,0
294176860,BIUK,86,111270,1622,119305,1,1,2,7,the latest news views europe,leonardo dicaprio says signed elon musk trip mars^estonia might have the most efficient tax filing system in the world^white house kellyanne conway 'has counseled told americans 'go buy ivanka stuff'^taylor swift reportedly keep new album streaming services like spotify apple music week^ellen page accuses brett ratner 'blatantly homophobic abusive behavior set 'x men the last stand^photos show kate middleton style evolved years by^here complete list winners brit awards^fox news founder former ceo roger ailes dead^former fox news ceo roger ailes dead^do i need british accent watch prince harry barack obama joke around interview bbc'^do i need british accent watch prince harry barack obama joke around interview bbc',3,8,5,11,0.2727272727272727,0.4545454545454545,0
24778454,5NEWS,397,67862,511,76574,2,1,1,7,covering news where you live,melania trump undergoes kidney surgery at walter reed medical center^at least seven people including children found dead in ohio homes^these are the victims in chicago mercy hospital shooting via^man who posed as justin bieber online to entice girls sentenced via^walmart to remove cosmopolitan magazine from checkout lines^walmart to remove cosmopolitan magazine from checkout lines^erin moran happy days star dead at age^erin moran happy days star dead at age^steven bochco tv creator of hill street blues nypd blue dead at^steven bochco tv creator of hill street blues nypd blue dead at^steven bochco tv creator of hill street blues nypd blue dead at,3,8,5,11,0.2727272727272727,0.4545454545454545,0
7940822,kxly4news,6209,58202,815,119832,0,3,3,5,news weather entertainment spokane coeur alene inland northwest we make laugh thanks following newsnow,health officials investigating record possible acute flaccid myelitis afm cases across country and^health officials investigating record possible acute flaccid myelitis afm cases across country and^live white house holds media briefing^tonight new details fergie josh duhamel split don miss etnow klxy^kim kardashian embarrassed husband kanye white house visit kxly^tonight miley cyrus liam hemsworth secretly get married don miss etnow kxly^'stranger things officially renewed netflix season kxly^aly raisman sues us olympic committee usa gymnastics kxly^here list sure talked super bowl moments what favorite did make cut^tonight justin theroux dealing since split jennifer aniston do n't miss etnow next :30pm.^meryl streep joins 'big little lies season kxly,3,8,5,11,0.2727272727272727,0.4545454545454545,0
17077313,KFIAM640,695,52852,1110,81473,0,7,3,1,stay connected like us follow instagram,"the centers disease control prevention cdc issued statement aiming keep healthy the^according centers disease control prevention ,000 people die u.s. alone year se^in interview abc this week sunday rudy giuliani asserted president donald trump probably th^the centers disease control prevention cdc issued statement aiming keep healthy the^according centers disease control prevention ,000 people die u.s. alone year se^at campaign rally last night las vegas said everyone promising funding come the^the city chicago mourning death police officer one four people killed gun battle at^celebrities remember orlando pulse nightclub shooting victims one year later^grammy awards see the full winners list read^celebrities thank barack obama on last day as president read^prince harry best man prince william royal wedding",3,8,5,11,0.2727272727272727,0.4545454545454545,0
16459325,ryanbeckwith,11188,29569,1354,129763,0,8,3,0,reporter part-time journalism teacher isaiah :12 rts rtbs,read transcript first presidential debate between hillary clinton donald trump^read transcript vice presidential debate^read transcript second presidential debate^as debate presidential field take look missing old democratic report^read transcript final presidential debate^read transcript democratic debate^hillary clinton launch campaign june rd anniversary bill sister souljah speech^obama campaign uses john glenn radio ads ohio^kim kardashian returned white house discuss prison reform^an obama confidant opens up eight years white house^oprah is intrigued idea running president best friend gayle king says,3,8,5,11,0.2727272727272727,0.4545454545454545,0
619970045,1033ampradio,6635,21647,268,47290,0,0,3,8,new hit music waayyy fewer commercials home,another royalbaby way check twitter hilariously reacts meghan markle amp prince harry preg^did get engaged or married see photo posted rd birthday^the word the lord back together kuwtk^poll who should win all stars finale^poll who should win all stars finale^when i really skinny i wanted kill clarkson^lol never fails entertain watch cardi show got pregnant^lol never fails entertain watch cardi show got pregnant^announces las vegas residency who going littlemonsters gagavegas^congrats receive michael jackson video vanguard award vmas^breaking announces new album reputation dropping november,3,8,5,11,0.2727272727272727,0.4545454545454545,0
43342743,FOX47News,3033,13563,243,68253,0,3,3,5,fox wsym says yes michigan bringing mid-michigan positive news convenient time we use social media connect viewers wesayyestomichigan,the michigan league conservation voters michigan lcv today announced formal endorsement gretchen whitme^us department education awards national blue ribbon michigan schools^the us department agriculture says turkey thawing refrigerator point n^dad turns driveway real life diagon alley harry potter^amal george clooney welcome twins^caitlyn jenner latest celebrity float run office^xxxtentacion murder third suspect arrested connection rapper death^photos 'the brady bunch house sale 1.885 million^our thoughts go friends family nicholas duffy fudge star of dead at^richard simmons hospitalized evere indigestion^'april giraffe pregnant park announces viral giraffe mom due spring,3,8,5,11,0.2727272727272727,0.4545454545454545,0
24872156,KLUV987,156,3625,126,59423,0,0,3,8,nobody plays,cheryl burke derek hough may return to dancing with the stars^cheryl burke derek hough may return to dancing with the stars^watch new 'aquaman trailer starring jason momoa nicole kidman^pregnant serena williams poses nude vanity fair cover^pregnant serena williams poses nude vanity fair cover^julia louis dreyfus to be awarded the mark twain prize for american humor^brandy hospitalized losing consciousness plane^richard simmons hospitalized for severe indigestion^richard simmons hospitalized for severe indigestion^cmt music awards nominations announced see complete list^cmt music awards nominations announced see complete list,3,8,5,11,0.2727272727272727,0.4545454545454545,0
23560291,DeonGuillory,1953,2821,93,94841,0,1,3,7,main anchor award winning journalist grad stan nola boy opinions page,indictment russians also tried help bernie sanders jill stein presidential campaigns robert mueller invest^we ask londoners prince harry meghan markle their responses may surprise^kevin hart confesses cheating pregnant wife that kevin hart dumbest moment that fi^response sides blame comments violence charlottesville va^tonya harding admits prior knowledge nancy kerrigan attack abc special harding says overheard ex hu^scott baio wife renee reveals microvascular brain disease diagnosis 'unfortunately true wrote ha^breaking roger ailes former chairman ceo fox news dead age news19^roger ailes dead former fox news ceo roger ailes died he^veep actress julia louis dreyfus diagnosed breast cancer news19^rebecca gayheart eric dane call quits years marriage rebecca gayheart files divorce eric^lady gaga announces las vegas residency 'the rumors true the rumors true tweeted tuesday the p,3,8,5,11,0.2727272727272727,0.4545454545454545,0
2615327132,UPIPhotos,28,2336,102,6571,1,7,2,1,delivering news entertainment sports photos since seven pulitzers chasing number eight,house democratic leader speaks reporters democratic caucus meeting us capitol n^republican house majority whip steve scalise gives thumbs president donald trump state un^president donald trump delivers state union address joint session congress house chamber^president donald trump delivers state union address joint session congress house chamber^president donald trump delivers state union address joint session congress house chamber^president donald trump delivers state union address joint session congress house chamber^rep. judy chu d ca gives thumbs president donald speaks ending chain immigration state^tbt oct. upi reporter helen thomas represents reporters boycott news bri^johntravolta takes photo photocall film gotti st annual cannesfilmfestival may^stacykeach arrives photocall film gotti st annual cannesfilmfestival on^actor paul rudd speaks press conference honored harvard university hasty pudding theatrical,3,8,5,11,0.2727272727272727,0.4545454545454545,0
49753604,ritholtz,1970,147248,4727,102621,1,7,3,0,director twitter cognitive dissonance chair/cio rwm masters-in-business radio host,fact check floyd mayweather jr. donates 'whopping sum money houston after hurricane^professional dummy congressman elect mark green promising new constituents tennessee going ba^professional dummy congressman elect mark green promising new constituents tennessee going ba^changes u.s. family finances evidence survey consumer finances^changes u.s. family finances evidence survey consumer finances^changes u.s. family finances evidence survey consumer finances^health insurance coverage united states^first look income poverty health insurance coverage united states^devos role surprising amp encouraging trump rescinds rules bathrooms transgender students^morning joe hosts trump bring national enquirer into their feud^hollywood gender pay gap revealed find highest paid stars via,4,7,3,11,0.3636363636363637,0.2727272727272727,0
9627102,FOX61News,817,139757,1032,157688,1,5,3,2,follow us latest breaking news weather sports entertainment fox61 news eect more,melania trump undergoes kidney surgery walter reed medical center^nbc fox news pull trump campaign racist ad sunday night football backlash^nbc fox news pull trump campaign racist ad sunday night football backlash^nbc fox news pull trump campaign racist ad sunday night football backlash^nbc fox news pull trump campaign racist ad sunday night football backlash^these victims chicago mercy hospital shooting^david cassidy fighting memory loss wants 'enjoy life fox61.com^channing tatum wife jenna dewan tatum announce split^caitlyn jenner latest celebrity float run office^after years kermit frog getting new voice^serena williams withdraws australian open,4,7,3,11,0.3636363636363637,0.2727272727272727,0
13719342,CBS6,4614,132634,1177,166576,0,4,4,3,local news beyond we love hear story newstips.com,these victims chicago mercy hospital shooting^these victims chicago mercy hospital shooting^chicago mercy hospital secured shooting injures officer multiple victims reported^now on cbs6 murphy sneaks white house press briefing persona non grata decades^arnold schwarzenegger quits the new celebrity apprentice^heather heyer mom reveals powerful takeaway charlottesville tragedy ellen^now theellenshow julie bowen performance leon bridges^now theellenshow the cast modernfamily including ed o neill sof a vergara julie bowen ty burrell jess^'storm chasers star joel taylor dead^'game thrones stars kit harington rose leslie married via^fiona baby hippo dad henry dies,4,7,3,11,0.3636363636363637,0.2727272727272727,0
2396261311,complexcanada,931,5798,68,22829,0,0,4,7,making culture pop,20 million herpes lawsuit against usher has been dismissed^joey fatone denies rumors *nsync reunion super bowl^scott disick tells world he getting back together with kourtney kardashian trolling nah^california teenager gets turned down prom shows up with kylie jenner instead^taylor swift helped buy house pregnant homeless fan^fourth suspect xxxtentacion murder case arrested^kendrick lamar sza team up 'black panther the album single all the stars^kylie jenner gives birth child her first with travis scott^gwyneth paltrow denies she becky with good hair after amber rose suggests it^beyonc eminem weeknd headline coachella^'game thrones final season premieres first half hbo boss reveals,4,7,3,11,0.3636363636363637,0.2727272727272727,0
25979455,dailynation,257,1762686,2131,498566,0,5,5,1,welcome daily nation twitter instant breaking news alerts happenings around find us facebook,state union revealed doses^inside the daily nation tomorrow state union revealed doses^state union revealed doses^today 's paper state union raila uhuru revealed doses^uhuru new order rocks jubilee boat^chadwick boseman 'black panther needed african accent^chadwick boseman 'black panther needed african accent^chadwick boseman 'black panther needed african accent^trump warns north korea 'fire fury daily nation^trump warns north korea 'fire fury daily nation^royal wedding drama father walk meghan aisle,5,6,1,11,0.4545454545454545,0.09090909090909093,0
14138785,TelegraphNews,238,767567,12776,210796,0,0,5,6,the latest national international news team,kellyanne conway 'counselled telling donald trump supporters 'go buy ivanka stuff possible ethics^oprah winfrey says waiting ign god run us president^jennifer aniston 'pregnant miracle baby aged husband justin theroux^eva longoria pranked victoria beckham forcing swap heels ugg boots^sarah jessica parker matthew broderick twins via surrogate^prince harry meets melania trump ahead invictus games first lady completes first solo overseas duty^melania trump nudges donald remind raise hand national anthem^emma watson donates 1 million anti sexual harassment campaign^comedian louis ck accused sexual misconduct five women^don rickles toy story star legendary comedian dies aged^simon cowell rushed hospital accident london home,5,6,1,11,0.4545454545454545,0.09090909090909093,0
5692542,statesman,19290,299991,5166,148923,3,4,2,2,austin news entertainment brought austin american-statesman web desk,"ut/texas tribune poll shows bush sid miller vulnerable runoff^texas official sid miller bills taayers 1,120 jesus shot trip^texas agriculture chief sid miller asks trump officials foreign workers^follow live the last democratic presidential debate tuesday new hampshire primary^live updates the last democratic presidential debate tuesday new hampshire primary^what texans naming babies here top popular baby names state^former president george w. bush defends no child left behind interview time magazine^get home improvement questions answered the rd annual austin fall home amp garden show meet the^one place one weekend all projects solved the rd annual austin fall home amp garden show meet the^james franco denies sexual misconduct allegations^just in former fox news ceo roger ailes dead",5,6,1,11,0.4545454545454545,0.09090909090909093,0
3074769187,CatchNews,33,56631,338,94875,0,2,5,4,a digital platform focussed ideas events shaping world,trump signs executive order 'protection the nation from foreign terrorist entry into the united states^shocking class kid found hanging school hostel darjeeling parents alleges murder^kimkardashian defends kyliejenner amid controversy forbescover 'she is self made^happy anniversary baby nicole kidman keith urban catch news^watch britneyspears terrified fan storms stage lasvegas show britneyliveinconcert^meghanmarkle princeharry want babies right away^bradpitt spent fatherday london kids amid custody battle angelinajolie^metoo movement walmart remove 'cosmopolitan checkout lines^ariana grande named first honorary citizen manchester^ed westwick accused third woman sexual assault^lorde loves 'friend taylor swift squad,5,6,1,11,0.4545454545454545,0.09090909090909093,0
39773949,MirrorTV,537,36961,337,138075,0,0,5,6,official daily mirror tv account follow depth news updates showbiz news film news,new only fools horses video watch david beckham poke fun glasses gag sport relief^netflix announces play prince charles third season the crown^jennifer aniston puts brave face ellen degeneres makes joke marriage^kris jenner fires back critics life kylie branded 'fake 'boring viewers^terrified kim kardashian breaks worrying phone call kanye west^queer eye tom jackson reveals back love life ex wife abby^when star wars episode ix everything else know far^what twinpeaks everything need know hit cult show returns^leonardo dicaprio star quentin tarantino charles manson movie^reasonswhy season everything know far netflix show return whether questions answere^netflix officially announces reasons why renewed season,5,6,1,11,0.4545454545454545,0.09090909090909093,0
42720503,98PXYRochester,2106,36510,240,40345,0,0,5,6,wpxy-fm the hit music station tweet teampxy listen anytime anywhere,jennifer garner settling new life single mom definitely ready date yet^if justin bieber selena gomez one month marriage hailey baldwin get annul^if justin bieber selena gomez one month marriage hailey baldwin get annul^rumors swirling dating robert pattinson see the photo everyone talking^icymi complete list grammy winners^have mercy uncle jesse eecting first child fianc e caitlin mchugh gt^jennifer lawrence single details split director boyfriend /^reputation album leaked hours early fans fired^richard simmons hospitalized severe indigestion details^fitness guru richard simmons hospitalized severe indigestion go details^announced going return new halloween movie next year,5,6,1,11,0.4545454545454545,0.09090909090909093,0
486057278,onwithmario,748,25889,270,27150,0,0,5,6,the official twitter nationally syndicated radio show co-host listen on,stopped week talk hosting akcdogshow new show carter fatherhood amp more^missed last week relive right jerryoconnell andimack disney^halle berry not pregnant at despite reports ca n't girl eat big burrito^nope justin bieber is not dating hailee steinfeld rumorcontrol^kanye west rebooting americanidol^icymi cmt music awards winners see the complete list cmtawards^meghan markle approves of priyanka chopra nick jonas engagement^jamie lynn spears pregnant second child the singer actress shared news sweet ig post^p nk to receive michael jackson video vanguard award at mtv vmas pink whataboutus^she back taylorswift announces new album reputation here everything know far^demi lovato announces tour with dj khaled see the dates demixkhaled demilovato,5,6,1,11,0.4545454545454545,0.09090909090909093,0
87365529,Z1043,2732,14328,344,45758,0,0,5,6,baltimore hit music station every morning an station made baltimore baltimore,beyonce not demanding silent delivery room despite report^rap star a ap rocky feels little jealous kendall jenner romance blake griffin^justin bieber one pursued selena gomez vice versa ...^beyonce birth twins still hospital 'minor issue^mariah carey not dating both nick cannon and bryan tanaka despite report^taylor swift helped fan buy house finding temporarily homeless months pregnant^alex rodriguez year old daughter sings for jennifer lopez photos^it official alicia keys returning the voice season^full schedule freeform nights halloween^jamie lynn spears pregnant second child the singer actress shared news sweet ig post^here full list nominations year billboard music awards,5,6,1,11,0.4545454545454545,0.09090909090909093,0
24263424,KABCRadio,732,6698,205,26087,1,4,4,2,nan,breaking george h.w bush passes age statement george w. bush passing father^hillary clinton bernie sanders donald trump react orlando mass shooting^icymi here key moments president donald trump first address joint session congress^multiple victims after shooting near chicago hospital police click video^emails show swamp stretches agriculture department new internal emails us department agricu^want roll like a vip vegas listen week win 25 gift card norms amp could score upfront ticket^want roll like a vip vegas listen week win 25 gift card norms amp could score upfront ticket^want roll like a vip vegas listen week win 25 gift card norms amp could score upfront ticket^move thebachelor the royal wedding prince harry meghan markle duke duchess sussex^today news blitz oc fair john jillian talk california split ballot b^here popular halloween candy every state ... what favorite halloween treat,5,6,1,11,0.4545454545454545,0.09090909090909093,0
2999970652,CapitalYORKNews,3082,4403,84,22606,0,1,5,5,we news team capital yorkshire tweet us stories email yorkshire.news.com call newsroom,three people including two teenagers remain police custody fatal crash darnall sheffield a one ye^there word yet miley cyrus liam hemsworth rumours 've split reported 've called t^it reported kylie jenner pregnant us media say eecting first baby travis scott.^justin bieber hailey baldwin already got married according uncle alec baldwin told reporters t^fans think dating thanks post met ball photo^david beckham prosecuted speeding charge celebrity lawyer nick freeman nicknamed mr loop^meghan markle going spend christmas prince harry senior members royal family sandring^nelly arrested police us suspicion rape he accused assaulting woman tour bus.^love island star sophie gradon died age the former miss great britain appeared series^game of thrones stars kit harington rose leslie reportedly getting married today capitalreports^black panther tweeted movie time million tweets sent it.,5,6,1,11,0.4545454545454545,0.09090909090909093,0
36327407,htTweets,129,6926996,6968,626183,1,4,5,1,one india largest media companies latest news around world retweets endorsements,aruna miller fray nd indian american woman enter us house representatives^kelly sadler longer employed within executive office president read brief statement deputy^mass suicide mass murder burari family deaths still mystery weeks later^four persons including one child shot dead apartment building queens^amid trade impasse china offers buy 70 billion us goods report^kate hudson dumped alex rodriguez madonnahttp //^angelina jolie takes kids hike amid brad pitt custody battle see pics^angelina jolie takes kids hike amid brad pitt custody battle see pics^angelina jolie takes kids hike amid brad pitt custody battle see pics^david beckham face trial speeding offence^do i need british accent barack obama asks prince harry interviews radio show,6,5,-1,11,0.5454545454545454,-0.09090909090909093,1
119097424,102_JAMZ,6004,88523,263,162591,0,0,6,5,home miquadradio,did amp secretly get married afternoontakeover^watch learn how use gun her needed me video afternoontakeover^enjoy hooking afternoonmami^last night areacodetrappin rt jamz rockn dat new vashit tho dem hoes legs gon up^russell wilson welcome daughter sienna princess weekendtakeover^icymi complete list grammy winners^leaves speechless the tonight show afternoontakeover^issasnack rocks blue hair bedazzled bikini barbados carnival afternoontakeover^officially joins american idol revival its first judge afternoontakeover^watch mama june introduce new boyfriend geno her daughters via ohhhh shoot now^elains controversial photos his hands around woman neck weekendtakeover,6,5,-1,11,0.5454545454545454,-0.09090909090909093,1
17045604,hot995,661,75490,616,128058,0,0,6,5,dc hit music station,after almost years business kim kourtney khloe kardashian done dash boutique clothing^rap star a ap rocky feels little jealous kendall jenner romance blake griffin^justin bieber one pursued selena gomez vice versa ...^hey see lookin amazing leaving dc today^justin bieber dating singer actress hailee steinfeld^justin bieber dating singer actress hailee steinfeld^jersey shore ronnie ortiz magro ex jen harley arrested charged domestic battery^taylor swift helped fan buy house finding temporarily homeless months pregnant^full schedule freeform nights halloween^jamie lynn spears pregnant second child the singer actress shared news sweet ig post^here full list nominations year billboard music awards,6,5,-1,11,0.5454545454545454,-0.09090909090909093,1
83851167,Chloe_Melas,1802,9200,184,10934,0,1,6,4,entertainment reporter retweets endorsements send news tips chloe.melas.com,my interview michael moore believes evil genius two term presid^a source tells embarrassed kanye west visit trump^it true i confirm kylie jenner pregnant she amp travis scott due baby feb^elle faces backlash false kim kardashian kanye west breakup tweet^channing tatum jenna dewan tatum announce separation^robert pattinson amp amp fka twigs cuddle close at met gala in front of ex kristen stewart^elle faces backlash false kim kardashian kanye west breakup tweet^big news paul marciano steps guess allegations harassment kate upton^'game thrones stars kit harington rose leslie married^billboard music awards check complete list winners^billboard music awards check complete list winners,6,5,-1,11,0.5454545454545454,-0.09090909090909093,1
1440641,nytimesarts,236,2642860,19552,165228,0,1,7,3,arts entertainment news the new york times,in interview fox news trump said planning first visit war zone troops glad he^a complete list winners emmy awards^a complete list winners emmy awards^caitlyn jenner publish memoir about her transformation^caitlyn jenner publish memoir transformation^caitlyn jenner publish memoir transformation^a debate ashlee simpson reality show s.n.l debacle plus answers questions new popca^in mid ashlee simpson platinum albums mtv reality show hear first two popcasts about^here best tv shows^here best tv shows^follow tony awards coverage tonight complete list nominations,7,4,-3,11,0.6363636363636364,-0.2727272727272727,1
407666947,HuffPostUKLife,1576,110728,666,87069,0,0,7,4,sex relationships health mental health wellness money green living we got covered,angelina jolie finally breaks silence brad pitt split^jennifer aniston justin theroux 'lovingly split amicable divorce^jennifer aniston justin theroux 'lovingly split amicable divorce^selena gomez reveals kidney transplant^selena gomez reveals kidney transplant^selena gomez reveals kidney transplant treat lupus^selena gomez reveals she had a kidney transplant^prince harry asks big brother william best man royalwedding^janet jackson shares first adorable photo baby boy eissa al mana^enrique iglesias anna kournikova share first photos newborn twins n'aaaaw^prince harry meghan markle reveal wedding cake details,7,4,-3,11,0.6363636363636364,-0.2727272727272727,1
208470869,GHmagazine,3422,39781,501,46271,0,0,7,4,the uk biggest selling lifestyle magazine tried tested years instagram,the duchess cambridge genius hack keep shoes tights slipping^why duchess cambridge often one photographs kids^the dress duchess cambridge loves much multiple colours^the duchess cambridge reveals family moment cherishes^this much money george clooney makes every hour^this much money george clooney makes every hour^meghan markle might dropped biggest hint moving uk prince harry^prince william reveals earned treet cred prince george^kit harington rose leslie married amp many game thrones stars wedding^the best royal wedding dresses time^reese witherspoon confirms legally blonde happening snippet video,7,4,-3,11,0.6363636363636364,-0.2727272727272727,1
38647512,IndianExpress,378,3211039,4894,606426,5,3,3,0,the indian eress brings latest news india world breaking round clock the journalism courage starts,the second us immigration bill populalry known 'conservative bill also failed pass house repr^indian american aruna miller fray enter us house representatives^just in us house representatives narrowly passes bipartisan budget measure ending government shutdown^eressbiz the us election results showed democrats wresting control house representatives ru^rocky road ahead dreamer immigrants bill us house representatives^eressopinion pm modi speech framed continuities nuance foreign policy it needs full force india ex^donald trump asking congress mexico pay border wall^china us currently locked ongoing trade war country introduced tariffs goods trade^never say never kim kardashian considering career politics^north korea considering strike guam donald trump warns fire fury^georgeclooney wife amal welcome twins announce hilarious statement,8,3,-5,11,0.7272727272727273,-0.4545454545454545,1
711760467383877632,WIONews,84,81002,566,91129,4,1,4,2,wion world is one welcome india first global news network we present global stories indian perspective,loyal supporters house representatives nominated us president name for^a bill seeks strengthen us strategic relationship india introduced house^two indian americans democraticparty thrown hats ring us house representa^us house representatives moves bill end 'non defence aid pakistan^china us currently locked ongoing trade war country introduced tariffs goods trade^did mileycyrus liamhemsworth get married secretly april^emma stone eressed `crazy stupid love` dear wonderful friend recently i^justin theroux opened divorce jennifer aniston first time actor says sepa^singer receives emotional support fellow singer cardib emotional breakdown^watch koko gorilla mastered sign language dies^defending champion serenawilliams withdraws australian open,8,3,-5,11,0.7272727272727273,-0.4545454545454545,1
14297868,SheKnows,3859,56217,1176,43482,0,1,8,2,women inspiring women,popular baby names state say^jennifer aniston isn wasting time being heartbroken over justin theroux divorce^a definitive timeline meghan markle prince harry relationship^shannen doherty is singing new tune about controversial charmed reboot^the real reason jennifer lopez amp alex rodriguez aren talking about marriage^gives birth baby boy ace^emma stone 'ca n't imagine life without ryan gosling amp honestly same^jennifer aniston isn wasting time being heartbroken over justin theroux divorce^jennifer lopez instagram alex rodriguez shows how love they really are^kaley cuoco marries karl cook becomes 'legally kcsquared^all things binge watch holidays the best netflix new offerings december,8,3,-5,11,0.7272727272727273,-0.4545454545454545,1
235181989,SPerryPeoplemag,994,10729,218,16852,0,0,8,3,chief foreign correspondent people magazine consulting producer the story diana abc netfli the story royals abc,meghan duchess sussex carolina herrera dress come cheer prince harry turns play i^angelina jolie brad pitt reach agreement handle divorce privately we committed act via^meghan duchess sussex carolina herrera dress come cheer prince harry turns play i^jennifer garner confronted lindsay shookus about ben affleck relationship sources say via^royal pet news lupo rival anmer hall and thanks ferreting one via^kate carrying twins^excited coming next month the story royals diana meghan markle baby louis new p^meghan markle just dropped her own major royal baby hint via^grammy winner pink graces cover people beautiful issue her two kids via^every adorable photo prince george princess charlotte royal wedding via^does this photo prove amelia earhart survived her final flight via dodd,8,3,-5,11,0.7272727272727273,-0.4545454545454545,1
36038038,1003WNIC,2043,6177,97,97493,0,0,8,3,wnic home morning detroit christmas station check us,celebrities react trump withdraws steph curry white house invitation^celebrity reaction jimmy kimmel monologue on las vegas shooting and guns^jimmy kimmel talks donald trump harvey weinstein on 'gma^another royal baby way prince harry meghan markle eecting first child^ryan lochte charge dropped in rio robbery case^watch kim kardashian first interview since robbery on 'ellen degeneres show videos^celebrities react nfl players kneel lock arms during national anthem^chris soules 'devastated after killing kenny mosher in fatal accident^harry styles announces intimate world tour see the dates^hugh hefner cause death revealed^billboard music awards nominations see full list of bbmas nominees,8,3,-5,11,0.7272727272727273,-0.4545454545454545,1
18800265,guardianfilm,893,364609,5364,39713,0,0,9,2,latest film news reviews podcasts video,rachel weisz 'my parents refugees brexit feels like death^baftas full list winners^brad pitt angelina jolie search perfect pr hollywood divorce^actor terry crews i sexually assaulted hollywood executive^the brangelina industry jennifer aniston brad pitt angelina jolie keep making headlines^breathe review andrew garfield fronts poignant biopic wheelchair pioneer^danny boyle exit james bond throws franchise chaos^charlie says review matt smith magnetic charles manson unpersuasive cult drama^brad pitt quit acting 'in three years^leonardo dicaprio star quentin tarantino charles manson movie^daniel craig confirms play james bond,9,2,-7,11,0.8181818181818182,-0.6363636363636364,1
15905925,allhiphopcom,1516,333615,2996,77211,0,0,10,1,we are hip-hop culture information follow founders,did travis scott amp kylie jenner secretly get married^did travis scott amp kylie jenner secretly get married someone check on tyga^kylie jenner is pregnant with travis scott baby^is rihanna upset about drake hooking up with j lo allhiphop rumors it looks like new hip pop power cou ...^is rihanna upset about drake hooking up with j lo^is kim kardashian ready to divorce kanye west^is kim kardashian ready to divorce kanye west is there trouble in paradise for kimye again^travis scott pleads guilty to disorderly conduct for concert incident the butterfly effect performer avoids oth^kanye west confirms whether or not he will host an american idol reboot^kanye west confirms whether or not he will host an american idol reboot^fourth suspect arrested in xxxtentacion murder case,10,1,-9,11,0.9090909090909092,-0.8181818181818182,1
17215009,VirginRadioVan,275,29653,422,24791,0,0,10,1,vancouver hit music station,looks like first fight love birds selena gomez the weeknd whose side^angelina jolie brad pitt could getting married soon find the biz jonnyhollynira^looks like brad pitt crushing someone game thrones ... wants know tell^you believe real reason justin bieber selena gomez seattle last weekend w^is this real reason justin bieber selena gomez taking break tell the b^justin bieber says hailey baldwin always one ... not selena gomez give details^move selena gomez ... there new followed celebrity instagram take guesses^is taylor swift declaring war jennifer lawrence tell the biz mintues^david beckham victoria beckham biggest fight ever wandering eye ... .. tel^diva drama rihanna shades grey star dakota johnson find the biz jonnyhollynira^where cameron diaz she disappeared hollywood tell the biz minutes,10,1,-9,11,0.9090909090909092,-0.8181818181818182,1
28635395,CBS58,1540,24650,724,93015,0,0,10,1,we milwaukee news plus complete ready weather forecast snapchat cbs58news,'the immigrant project connecting people stories leaving politics aside^'the immigrant project connecting people stories leaving politics aside^'the immigrant project connecting people stories leaving politics aside^'the immigrant project connecting people stories leaving politics aside^'the immigrant project connecting people stories leaving politics aside^'the immigrant project connecting people stories leaving politics aside^'the immigrant project connecting people stories leaving politics aside^'the immigrant project connecting people stories leaving politics aside^'the immigrant project connecting people stories leaving politics aside^'the immigrant project connecting people stories leaving politics aside^koko gorilla knew sign language dies,10,1,-9,11,0.9090909090909092,-0.8181818181818182,1
3008083310,MSNArabia_EN,44,1584,43,19812,0,1,10,0,trusted news uae middle-east world stay know msn uae,us department agriculture agency told 'avoid using term climate change^how brad pitt make fortune spend^brad pitt 'apologises jennifer aniston 'absentee husband leaving angelina jolie^brad pitt 'apologises jennifer aniston 'absentee husband leaving angelina jolie^brad pitt 'apologises jennifer aniston 'absentee husband leaving angelina jolie^brad pitt 'apologises jennifer aniston 'absentee husband leaving angelina jolie^selena gomez betrayed by the weeknd^brad pitt 'apologises jennifer aniston 'absentee husband leaving angelina jolie^brad pitt 'apologises jennifer aniston 'absentee husband leaving angelina jolie^angelina jolie reveals 'i n't enjoy single amid new buzz brad pitt reconciling^is kate hudson brad pitt twins,10,1,-9,11,0.9090909090909092,-0.8181818181818182,1
25073877,realDonaldTrump,47,64938008,108995,44596,1,9,0,0,th president united states america,"in approximately ,000 pages code federal regulations today ,000 pag^top facts about crooked hillary clinton from trump 'stakes of the election address^watch interview face the nation also new cbs polls good media wo n't report^healthcare listening session w/ amp watch readthebill^busy day planned looking forward watching president macron france address joint session congress today^i interviewed sunday :00 a. m. enjoy^epic crowd moon township pennsylvania tonight thank get tuesday vote rick t^join live moon township pennsylvania :00pme great crowd maga rally^heading moon township pennsylvania really good person state representative rick saccone is^it jan. president obama end vacation early amp get back washington straighten obamacare catastrophe end",1,9,8,10,0.1,0.8,0
487118986,XHNews,61,12656954,13117,151189,0,9,1,0,china insight global view top science news amazing china latest sport news aerial photos videos,more income fast food more one third american adults consumed fast food typical day report by^according centers disease control prevention suicide percent us last two d^trump touts america first foreign policy attack globalism unga speech face blank stares headshake^overseas eerts laud xi speech china foreign policy china center major global affai^in face blank stares headshake frowning u.s. president donald trump tuesday delivered speech the^more income fast food more one third american adults consumed fast food typical day report by^new record four bridges linked beijing new airport rotated synchronization one another busy^supportfreetrade on washington willfully imposing extra tariffs chinese goods catherine boland moto^china eresses firm opposition office u.s. trade representative published list chinese goods sub^also list top viral videos u.s. singer halftime show super bowl li y,1,9,8,10,0.1,0.8,0
91966685,Joy997FM,81,1099846,483,208934,0,3,1,6,official twitter space joy fm bringing best news entertainment education engagement discerning audience rts endorsements,ghie american society civil engineers sign agreement info exchange^i believe removal enough however nation believes lost much face^a one hundred percent perfect plan use plan executed so put thought crafting reasona^raised barbadian guyanese parents ronald monica fenty alongside two younger broth^ent news angelina jolie claims she denied harvey weinstein unwanted advances after which she never worked with him again cosmopolitanmix^bill cosby found guilty sexual assault retrial joysms^entertainment news harvey weinstein accused raping multiple women cosmopolitanmix^tiger woods speaks out after his dui toxicology report is made public cosmopolitanmix^celine dion poses naked vogue.cosmopolitanmix^pink to receive mtv vmas video vanguard award cosmopolitanmix,1,9,8,10,0.1,0.8,0
13265132,abc3340,812,227622,1388,181213,1,2,0,7,breaking news weather sports birmingham tuscaloosa anniston alabama areas abc /40 news newsroom,live facebook pres.trump addresses nation afghanistan^obama campaign woos hispanics tv radio ads president barack obama election team running upbeat ad ...^watch live pres donald trump makes remarks gop retreat philadelphia^mario batali includes cinnamon roll recipe apology sexual misconduct^icymi koko gorilla knew sign language dies^abc reportedly renewed ten shows season revenge castle once upon time modern family ...^james franco denies sexual misconduct allegations^reports former fox news ceo roger ailes dead^oscars the complete list nominations winners^reports kylie jenner pregnant,1,9,8,10,0.1,0.8,0
16041234,RawStory,3927,202529,5494,217581,1,9,0,0,the official twitter,florida senator files probably doomed bill legalizing marijuana recreational use^john mccain torches trump bannon half baked nationalism liberty medal acceptance speech^mocks rudy giuliani telling fox news n't quote actual tv interview^watch willie horton attack ad mike huckabee romney campaign nearly ran^rudy giuliani claims donald trump allowed know informants provided mueller 'incriminating^'like murder suicide ex prosecutor stuns cnn brutal analysis rudy giuliani 'embarrassing^what sleazy thing morning joe zaps mike huckabee predictably stupid attack mika^sarah huckabee sanders hold white house press briefing trump helsinki disaster^watch live sarah huckabee sanders holds white house press briefing^cia says white house block director briefing senate,1,9,8,10,0.1,0.8,0
16311797,WSJPolitics,249,135998,4189,122078,0,9,1,0,wsj home politics policy national security news sign get capital journal newsletter every morning,read full transcript wsj exclusive interview president barack obama^rudy giuliani said president trump would sit interview robert mueller special counsel^rudy giuliani member legal team says new proposal interview mueller terribly diffe^will donald trump agree interview mueller rudy giuliani tells wsj latest thinking matter^two news outlets plan unsanctioned democratic presidential debate new hampshire february^'there always irritants relationships secretary state pompeo said played trump refusal to^obama announces new strategy afghanistan pakistan president barack obama announcement new stra..^here transcript interview president donald trump^here transcript interview president donald trump^trump defends beautiful confederate statues wake charlottesville violence,1,9,8,10,0.1,0.8,0
30050899,OpenSecretsDC,3424,134478,4654,41692,0,9,1,0,site center responsive politics comprehensive nonpartisan money-in-politics resource around donate,mi08 ks03 nc13 among new districts see spending league conservation voters^environmental advocacy groups like environment america league conservation voters spent millions the^concerned trump administration actions environment groups like like environment america the^yesterday filing deadline campaigns federal election commission what new filings reveal^bernie sanders presidential campaign settles case fec involving illegal use volunteers australia^following alleged breach contract former republican national committee official elliott broidy stop paying^of republicans mounting challenge montana democrat midterms failed com^mt latest fec filings show pro santorum red white blue fund spending 257k tv ads ohio source2012^over million ads aired congressional gubernatorial races since january one four those^ethics agency authority investigate us 'go buy ivanka stuff,1,9,8,10,0.1,0.8,0
827637158555033600,USAFacts,1577,111226,572,3893,1,9,0,0,a data-driven non-partisan portrait american population government finances government get newsletter opendata,"do know party controls house representatives us usa midterms2018 election2018^the american society civil engineers recommends long term consistent investment address co^new numbers centers disease control prevention show drug overdoses killed ,000 am^what presidents talk address nation state union elore sotu timelin^deliver first official sotu address joint session congress tuesday jan brush o^what presidents talk address nation state union elore sotu timelin^new numbers centers disease control prevention show drug overdoses killed ,000 am^do know presidents talk address nation state union how c^what presidents talk address nation state union elore sotu timelin^the us largest trade deficit china ert 206b goods services amp income impor",1,9,8,10,0.1,0.8,0
16453340,News_8,1607,97308,795,126053,0,6,1,3,the official twitter account wroctv local news local people the team you can trust certified most accurate forecast weatherate,ray stanford dinosaur fossil hunter made major discovery remote wilderness grounds^more people becoming sick salmonella outbreak prompted massive egg recall the centers diseas^the centers disease control prevention says popular kellogg cereal linked salmonella outb^vermont sen. bernie sanders laying groundwork launch bigger presidential campaign first ad^the u.s. department education eliminate 80 million debt former everest institute corinthia^according the centers disease control prevention farmers highest rate suicide othe^kellyanne conway plug white house 'go buy ivanka stuff^matt damon apologizes comments sexual misconduct^after years kermit frog getting new voice^taylor swift announces new album 'reputation,1,9,8,10,0.1,0.8,0
441389311,TND,1607,88861,2069,37618,0,7,1,2,tnd brings award-winning local storytelling newsrooms across usa live feeds throughout world,the centers disease control prevention dressing chickens halloween.^homeland security secretary kirstjen nielsen speaks security challenges face nation aspen co^president trump disputing new york times article questioned mike pence loyalty stating he one h^the centers disease control prevention dressing chickens halloween.^a vigil held chicago honor victims mercy hospital shooting^sarah sanders holds white house press briefing first time kicked virginia restaura^sarah sanders holds white house press briefing president trump continues interview potential supreme cour^kanye west returns twitter brief hiatus talks social media mind control^courtney love warned young women hollywood harvey weinstein^'brady bunch house sale nearly 1.9 million,1,9,8,10,0.1,0.8,0
34677788,northjersey,1091,64514,1012,131447,0,1,1,8,the record part network your primary source north jersey news for sports,an autistic new jersey teenager missing week found safe ohio marlboro^kevin hart confesses cheating pregnant wife^walmart remove 'cosmopolitan magazine checkout lines amid me too movement^walmart remove 'cosmopolitan checkout lines says 'business decision^new 'house cards teaser reveals fate kevin spacey frank underwood^avicii well known dj dead^avicii electronic dance music dj found dead oman^reports tv host brooke burke files divorce actor david charvet^reports priyanka chopra nick jonas engaged two months dating^reports kylie jenner pregnant,1,9,8,10,0.1,0.8,0
232681242,harveyjkaye,961,25335,511,268727,1,8,0,1,prof democracy author thomas paine promise america the fight four freedoms take hold our history make america radical again,inside fake news sausage factory this is all about income via^transcript democratic presidential debate via^at the new hampshire democratic presidential debate populism wins campaign for america future^transcript democratic presidential debate via^transcript hillary clinton official campaign launch speech vox^every generation needs know fighting fighting fighting^from people action a new u.n. report says united states highest income inequality western na^at trump hotel site immigrant workers wary via^white house press briefing we intelligence report^morning joe co hosts joe scarborough mika brzezinski get engaged deserve via,1,9,8,10,0.1,0.8,0
40604613,CurtisHouck,1447,11786,218,72192,0,9,1,0,managing editor proud state /manheim township grad via caps christ follower views mine,w/ along making perfectly clear merrick garland t^video the disgusting pompousness display already mocking trump interview on^it hard pay attention rudy giuliani interview molding together mind two^thread comments howard schultz shows 'd zero chance democratic presidential prima^video speaking democratic congressman refuses condemn comes^jim acosta right saying denounce trump comments migrant caravan be^... attention that fact see white house press briefing 'll see this n't all.^what gripping chyron cnn i feel like words amid currently favorite words i thi^the world n't end today guys sarah huckabee sanders called jim white house briefing we 'll l^i 'm team gt sage steele slammed instagram post protests airport for the win,1,9,8,10,0.1,0.8,0
16116116,ChilliGaz,293,8468,192,48160,0,0,1,9,the oldest newspaper west alleghenies digital age,trump assertion left wing protesters violent white supremacists charlottesville sets firestorm^tonya harding admits prior knowledge nancy kerrigan attack abc special^tonya harding admits prior knowledge nancy kerrigan attack abc special^the best memorial day sales home appliances^the best memorial day sales home appliances^summer phoenix files divorce husband casey affleck^summer phoenix files divorce husband casey affleck^serena williams withdraws australian open^serena williams withdraws australian open^oscars the complete winners list,1,9,8,10,0.1,0.8,0
1511639706,WGXAnews,1290,5930,177,66254,0,4,1,5,fox24/abc16 -- middle georgia news weather,the centers disease control prevention cdc advising consumers businesses eat serve sell^the centers disease control prevention cdc named fentanyl america deadliest drug^authorities say death centers disease control prevention employee whose body found river^the centers disease control prevention cdc named fentanyl america deadliest drug^former miss utah trump accuser holding press conference salt lake city^james franco denies sexual misconduct allegations^james franco denies sexual misconduct allegations^matt damon apologizes comments sexual misconduct^reports former fox news ceo roger ailes dead^reports kylie jenner pregnant,1,9,8,10,0.1,0.8,0
2445505148,YourGACountry,88,644,12,14585,1,1,0,8,your georgia country,read transcript sen. jeff flake speech comparing pres donald trump josef stalin^read transcript sen. jeff flake speech comparing pres donald trump josef stalin^james franco denies allegations sexual misconduct^photos miss north dakota cara mund crowned miss america^'superman star margot kidder dead^photos miss nebraska sarah rose summers crowned miss usa^storm chasers star joel taylor dead^labor day deals sales macy walmart best buy^celine dion donates concert proceeds victims las vegas shooting^michael jackson musical coming broadway,1,9,8,10,0.1,0.8,0
428333,cnnbrk,121,55885105,182912,67764,0,7,2,1,breaking news cnn digital now m strong check things cnn breaking download app custom alerts,mike pompeo deliver first major foreign policy speech secretary state monday unveil^rudy giuliani says special counsel mueller agreed narrow scope potential interview president t^french president macron address joint session congress two days meetings president trump f^a trump trade adviser said special place hell canadian prime minister trudeau appear^a police officer critical condition shooting chicago hospital officials say at least one offender^vice president joe biden make statement white house rose garden :10 p.m et watch live^trump considers revoking security clearances ex intelligence officials including james comey james clapper^prince william catherine duchess cambridge named third child^prince william catherine duchess cambridge named third child^gold medal winning gymnast aly raisman sues usa gymnastics us olympic committee others disgraced,2,8,6,10,0.2,0.6,0
16558796,7News,1114,319830,2713,261392,1,5,1,3,new england boston news breakingnews have tip tweet us hashtag news facebook news whdh boston instagram news snapchat whdh7news,breaking via federal prosecutors charge nyc subway bomb suspect say wrote facebook trump failed protect nation^watch vice president joe biden eected make statement rose garden mobile desk^watch live holding campaign rally las vegas nevada desk mobile^viewer voices what think former president george w. bush interview matt lauer nbc^watch live white house holds first press briefing since trump return europe^watch live white house holds daily briefing following weekend controversy press secretary asked leave rest^channing tatum wife jenna dewan tatum announce split^matt damon apologizes comments sexual misconduct^prince harry says wanted british royal family^april giraffe pregnant,2,8,6,10,0.2,0.6,0
22187085,CREWcrew,1470,284065,2938,50679,0,8,2,0,crew uses high-impact legal actions target government officials sacrifice common good special interests,"the white house transcript missing elosive part trump putin press conference it clear w^rudy giuliani new arguments limiting scope mueller interview trump shows much legal je^then may things got interesting newly hired trump lawyer rudy giuliani appeared confirm loa^not rudy giuliani increase trump legal jeopardy may security clearance needed di^michael cohen still deputy finance chair republican national committee finance committee^oge said yesterday trump submitted financial disclosure form reviewing report^the 130,000 payment made adult film star stormy daniels shortly election investigated^quite difference official statement issued president walk back lawyer^the federal ethics agency found kellyanne conway violated federal law using official position make p^it pretty clear mueller investigation witch hunt but since still seem",2,8,6,10,0.2,0.6,0
16313592,CBSDenver,14547,206807,2552,172923,2,8,0,0,covering colorado first denver area news breakingnews colorado cowx be sure also check us facebook,breaking melania trump undergoes kidney surgery walter reed medical center eected remain hospitali^george h.w bush st president united states died friday here look back life serv^president trump offered statement support journalists gunman fatally shot five people capit^michael bennet declares victory over darryl glenn in colorado u.s. senate race^breaking andrew romanoff called michael bennet concede election democratic nomination u.s. senate^ken buck called sen. michael bennet congratulate victory u.s. senate race^the race u.s. senate colorado set democrat michael bennet versus republican ken buck^incumbent michael bennet holds u.s. senate primary watch live^the life eectancy u.s. declined slightly last year according new data centers disease con^the life eectancy u.s. declined slightly last year according new data centers disease con,2,8,6,10,0.2,0.6,0
15138087,abcactionnews,657,159360,1574,152667,0,3,2,5,tampa bay news check traffic feed,during last flu season children died hundreds hospitalized due flu related illnesses according^during last flu season children died hundreds hospitalized due flu related illnesses according^breaking one dead least four others shot bar fight bradenton^dad turns driveway real life diagon alley harry potter^icymi channing tatum jenna dewan tatum announce separation saying lovingly chosen separate a^xxxtentacion second suspect arrested connection rapper murder^xxxtentacion second suspect arrested connection rapper murder^the bachelor season meet women vying arie luyendyk jr heart^richard simmons hospitalized monday evere indigestion richardsimmons more^richard simmons hospitalized evere indigestion,2,8,6,10,0.2,0.6,0
25735151,WRCB,2522,104120,742,186604,2,4,0,4,coverage you can count on,love letter today jenna bush hager host one hour special saturday honoring grandfather president^'dad hugging robin holding mom hand younger bush said referring george h.w bush barbar^reminder open enrollment patient protection affordable care act health insurance started today chanews^the u.s. department education announced thursday would automatically cancel 150 million student loans con^nbc 'meet the press seen morning nbc presents french open^rt watch matt lauer interview former president george w. bush video^kensington palace says prince charles walk meghan markle aisle royal wedding^legendary insult comedian don rickles dies rickles career spanned seven decades^former fox news ceo roger ailes dead roger ailes former chairman ceo fox news died thursday mo ...^what happens backstreet boys join jimmy fallon the roots perform hit i want it that way wit,2,8,6,10,0.2,0.6,0
34280715,FOXNashville,4038,80623,966,169485,1,6,1,2,watch fox news nashville :30 p.m. p.m. p.m. fox this morning weekdays a.m. 9 a.m,live people found dead execution style killings ohio presser liveonfox17^an angry nashville mom taking action says teacher put duct tape year old daughter mout^one occupants vehicle crashed tree hendersonville yard today shot we talked with^video bear sighting middle tennessee reporter interview fox news pm overto^family speaks man killed concrete slab thrown onto car watch interview fox news in^happening now fox news scene candlelight vigil held brandon adams shot^president obama issue statement scotus ruling rose garden liveonfox17^coming fox news :30 reality star kim kardashian pushing presidential pardon clarksvil^helicopter pilot amp troy gentry country music montgomery gentry killed helicopter crash near nj airport^watch live april giraffe pregnant here live look second time mom,2,8,6,10,0.2,0.6,0
2996801,WBUR,2245,79731,2610,158458,0,8,2,0,we boston npr station online air fm see pinned tweet info sections shows podcasts,transcript npr full interview sen. marco rubio^the u.s. centers disease control prevention reported native americans among highest opioi^in interview fox news trump advisers told president n't ask anyone potential list^i 'm self proclaimed sock man the louder brighter crazier pattern better george h. w. bush^full video npr chat transcript final presidential debate^transcript final presidential debate^the u.s. centers disease control prevention reported native americans among highest opioi^nbc first reported white house press secretary would receive high level security detailed th^kellyanne conway 'counseled telling americans 'go buy ivanka stuff^the british born year old prodigy sheku kanneh mason standout wedding prince harry meghan m,2,8,6,10,0.2,0.6,0
16544024,journalsentinel,2698,71514,1682,91201,0,7,2,1,news milwaukee wisconsin also,the u.s. centers disease control prevention reported life eectancy declined driven largely^the centers disease control prevention investigating tick spreading widely across usa^the u.s. centers disease control prevention reported life eectancy declined driven largely^the centers disease control prevention investigating tick spreading widely across usa^chicago police responding shooting near mercy hospital say left multiple victims of^it four days since voters cast ballots race despite kemp claiming victory one calle^one person killed saturday morning car crash shut four lanes i near kewaskum^katie couric breaking silence former today show co host matt lauer^after bizarre week included meeting president trump trip uganda kanye west returned twitte^in drama filled days leading royal wedding the big question meghan markle father walk,2,8,6,10,0.2,0.6,0
3380282686,talkRADIO,26,60879,411,44513,0,3,2,5,follow world exciting speech station best debate disagreement news views analysis,it mother all talk shows watch george galloway opening statement^art critic estelle lovatt we 've gone metoo mestupid was inappropriate national trust cov^george galloway mother all talk shows available watch full youtube channel join debate on^jennifer aniston justin theroux gone public divorce listen^a divorce lawyer claimed jennifer aniston justin theroux gone public listen^love island star sophie gradon dead read^love island star sophie gradon dead read^today independent republic mike graham gaza violence latest meghan markle dad decides atten^simon cowell 'rushed hospital accident home^simon pegg reveals new film ready player one working steven spielberg watch read mor,2,8,6,10,0.2,0.6,0
1472966124,silverscreenin,61,34751,80,39292,0,6,2,2,silverscreen media inc your one stop source indian movies the occasional book photos news interviews reviews for longer sentences visit us online,adangamaru press meet cssam music composer film actor raashikhanna event today.^in pictures aishwaryarajesh sathyaraj arunrajakamaraj anthonylruben ilavarasu others kanaa team^in pictures jayabachchan kalkikoechlin ashokamirthraj indo french press meet ashokamritraj^in picture gajaraj adangamaru press meet today he stars film directed karthikthangavelu with^photo day ritikasingh sivalinga press meet team silverscreen wishes offl happy birthd^in pictures aishwaryarajesh kanaa press meet today she plays lead role sathyaraj darshan i^goldenglobes2018 biglittlelies featuring nicole kidman reese witherspoon shailene woodley nomin^hot amp happening obamas strike deal streaming giant royal affair^a fashion show launch latest bridal trends organised naturals chennai celebrity hairstylist and^louisck accused sexual misconduct five women telugu version aval yet certified adah sharma,2,8,6,10,0.2,0.6,0
21036972,ABC7Kidd,2865,5377,138,9468,0,0,2,8,entertainment lifestyle reporter abc washington dc/ member `` good morning washington '' family/ wash-fm,kanye west concerts on hold ... indefinitely popnews^beyonce birth twins still hospital 'minor issue via^big little lies author teases season ... and what it would be about popnews^update edsheeran injures arm bike accident keeps us all suspense about upcoming tour shows^pink reveals christinaaguilera tried punch her 'she swung me club inthenow feedly^neil patrick harris family may have just won halloween again^lady gaga guides digital meditation after las vegas massacre e news^grey anatomy spin off coming abc inthenow^kate middleton announces due date baby no^shonda rhimes is leaving abc netflix tgit remains intact inthenow,2,8,6,10,0.2,0.6,0
58926235,Deena_Zaru,1950,5135,170,16976,1,7,1,1,deputy digital editor i write politics music pop culture alum deena.zaru.com,new rep. jim jordan announces plan run speaker house should american people entrust us w^pelosi says gop efforts impeach rosenstein make statement pres trump law the attack^pres trump personal attorney rudy giuliani says trump legal team close determining president^sarah sanders whether rudy giuliani harmed president trump former mayor interview fox news i don^happening now all eyes pres trump prepares make nomination fill supreme court vacancy le^happening now we 're days midterm elections abc news political director breakin^hhs secretary alex azar tells abc news president trump one hundred percent clear w^pres trump hugged american flag conclusion remarks national federation independent busi^caitlyn jenner latest celebrity float run political office i would look senatorial run^my latest the supreme court declines hear appeal brendan dassey whose murder conviction subject,2,8,6,10,0.2,0.6,0
15872418,ABSCBNNews,1073,6414177,7879,717858,0,5,3,2,stories video multimedia filipinos worldwide abs-cbn news current affairs philippines trusted news organization,when asked possibility vice president leni robredo heading transition commission give^aquino responds sen lacson statement names 'narcolist released publicly aquino say^sen. loren legarda delivers speech dfa th anniversary reminds agency foreign policy must be^mayor sara duterte struggles speech begins lose voice due cough 'tapang malasakit convention^'humble macron responds critics state union address^showbiz news nicole kidman keith urban welcome new baby girl /via showbiz^amal george clooney welcome boy girl twins^jessica simpson gives birth boy^'nypd blue creator steven bochco dead^talk show host seth meyers host golden globes,3,7,4,10,0.3,0.4,0
12993222,CityNews,1997,597001,2890,192294,0,6,3,1,the latest citynews join conversation sound citynews instagram,liberal strategist jim warren conservative strategist jason lietaer talk loses wi^federal conservative leader andrew scheer scheduled deliver keynote speech morning the^kathleen wynne arrives cityvote the debate saying looking forward talking care people of^throngs supporters greet ford horwath party leaders arrived cityvote the debate^supporters gather front citynews ahead cityvote the debate onpoli watch debate live p.m.^police say one four victims kensington market shooting canada day died^photos celebrities share happy father day wishes how celebrating father day^jessica simpson gives birth second child^queen elizabeth ii gives royal christmas message from buckingham palace the reigning monarch making th..^staying home holidays here list binge worthy shows netflix right courtesy of,3,7,4,10,0.3,0.4,0
16102208,Local12,652,199039,1462,292049,1,2,2,5,local cincinnati trusted source breaking news complete coverage weather authority add us snapchat local12,a food stamp audit found benefits going dead people spent ohio^weekend box office in battle sequels denzel 'equalizer sneaks past 'mamma mia^take look president trump concluded speech tuesday washington dc he speaking t^new year eve performance 'they foiled^new year eve performance 'they foiled^matt damon apologizes comments sexual misconduct^houston texans defensive end jj watt offered pay funerals victims friday school shoot^meryl streep joins cast 'big little lies season^aprilthegiraffe pregnant again^aprilthegiraffe pregnant again,3,7,4,10,0.3,0.4,0
19539716,foe_us,1869,165754,2847,50471,3,7,0,0,friends earth action inc. defends environment champions healthy world,dems seized control house representatives means climate change back congressional ag^democrats seized control house representatives means climate change back congression^democrats seized control house representatives means climate change back congression^trump administration wants destroy law saved bald eagle grizzly bear amp humpback whale^trump nominated pesticide exec usda chief scientist we 're sure n't tied^trump nominated dow pesticide exec usda chief scientist this administration could care less public^trump nominated dow pesticide exec usda chief scientist this administration could care less public^trump nominated dow pesticide exec usda chief scientist this administration could care less public^trump nominated pesticide exec usda chief scientist we 're sure n't tied^trump nominated pesticide exec usda chief scientist we 're sure n't tied,3,7,4,10,0.3,0.4,0
21091954,KTLAMorningNews,220,158695,1427,64060,0,1,3,6,this official ktla morning news twitter account watch weekdays a.m. noon weekends a.m. a.m,reports multiple victims after shooting near chicago mercy hospital officer critical condition police^save date prince harry meghan markle wed may^north korea vows strikes u.s. trump warns fire fury^host opens start business amp career highlights new episode the ne^family actor bill paxton files wrongful death lawsuit against cedars sinai surgeon^april giraffe gives birth much anticipated calf new york zoo^vince vaughn arrested hermosa beach suspicion dui^vince vaughn arrested manhattan beach police suspicion dui^don rickles legendary comedian actor dies age^judge declares mistrial bill cosby sexual assault case,3,7,4,10,0.3,0.4,0
18777618,KDVR,1738,155768,1939,207316,1,6,2,1,fox31 denver kdvr provides breaking news cowx cotraffic sports denver colorado have news tip visit,melania trump undergoes kidney surgery walter reed medical center^u.s. senate dem reporting michael bennet percent andrew romanoff percent^fox news nbc stop airing trump immigrant ad 'sunday night football backlash^chicago mercy hospital secured shooting injures officer multiple victims reported^the life character john mccain words^the life character john mccain words^the life character john mccain words^kylie jenner goes prom guy got turned^went prom guy got turned another girl^vince vaughn arrested suspicion dui california,3,7,4,10,0.3,0.4,0
32545745,41actionnews,1526,151049,1506,186699,0,1,3,6,kansas city clear complete coverage send tips story ideas tips.com tweet us photos kcmo kck,video fact checking democratic presidential candidate debate new hampshire^amal george clooney welcome twins^mariah carey they foiled^physician elains speculation kate middleton may carrying twins^ryan seacrest kelly ripa new co host 'live^photos 'the brady bunch house sale 1.885 million^nicholas 'duffy fudge star 'wicked tuna dead^mila kunis makes monthly donations planned parenthood mike pence name^richard simmons hospitalized evere indigestion^'april giraffe pregnant park announces viral giraffe mom due spring,3,7,4,10,0.3,0.4,0
1061029050,SenatorHeitkamp,822,116137,1650,12385,3,7,0,0,the archived tweets heidi heitkamp former u.s senator northdakota this inactive account,last month i helped pass bipartisan senate resolution throw netneutrality life preserver amp^yesterday repeal netneutrality officially went effect without internet div^in republicans us house representatives passed health care bill would hurt thousands o^in i honored wounded veteran eric marts able join president state unio^yesterday administration announced plans addtl 200 billion tariffs chinese goods continuing s^in retaliation administration escalating trade war european union imposed 3.4 billion tariffs on^recently administration escalating trade war provoked 3.4 billion retaliatory tariffs us goods the^nd erts china ag products on friday china retaliatory tariffs us goods took effe^with passing day administration trade policies cause concern nd amp rural america wher^recently canada announced new tariffs us goods amp eu imposed 3.4 billion retaliatory tariffs,3,7,4,10,0.3,0.4,0
14573926,MikeLevinCA,14150,111054,1092,8768,3,7,0,0,proud husband/dad socal native clean energy advocate environmental attorney stanford/duke alum u.s. representative ca-49 all tweets,if democrats win congressional races trump country win california th district tru^thanks coming house party encinitas evening so much enthusiasm take back distri^if democrats win district voted trump almost points win california th^terrific visit friends league conservation voters morning so grateful^the environmental clean energy community uniting around campaign i honored joint event yes^i thrilled announce endorsement california league conservation voters i honored clcv h^thanks much friends environmental clean energy community showing overwhelming support toda^i honored announce endorsement league conservation voters i look forward working with^it great first step give authority centers disease control prevention conduct research o^why bigger deal michael cohen deputy finance chair republican national committee t,3,7,4,10,0.3,0.4,0
21213416,thestarhalifax,1973,104721,867,63332,0,3,3,4,local stories covered journalists live plus best investigations opinion national international news,he hero the orlando police department honoured pulse valor award invited trump s^the teamsters international brotherhood electrical workers told cprail posi^the teamsters international brotherhood electrical workers told cprail posi^is meghan markle already miserable royal we tongue cheek scoop tabloids^summon trumpeters town criers meghan duchess sussex child you heard first that^summon trumpeters town criers meghan duchess sussex child you heard first that^did know meghan markle brief case carrying model deal no deal howie mandel ca n't remembe^prince charles walk meghan markle aisle royal wedding stepping father br^prince charles walk meghan markle aisle royal wedding stepping father br^what you president why tweeting jimmy fallon responded donald trump,3,7,4,10,0.3,0.4,0
21214977,thestarcalgary,2545,78278,977,74312,0,3,3,4,local stories covered journalists live plus best investigations opinion national international news,the teamsters international brotherhood electrical workers told cprail posi^if ucp platform product advertisement would come one drug warnings sa^in world fakenews spreads like wildfire facebook trump tweet shake alliances trudea^is meghan markle already miserable royal we tongue cheek scoop tabloids^summon trumpeters town criers meghan duchess sussex child you heard first that^summon trumpeters town criers meghan duchess sussex child you heard first that^in comedian said standup act bill cosby lot rape allegations ... when^did know meghan markle brief case carrying model deal no deal howie mandel ca n't remembe^prince charles walk meghan markle aisle royal wedding stepping father br^prince charles walk meghan markle aisle royal wedding stepping father br,3,7,4,10,0.3,0.4,0
15752446,WiStateJournal,1553,71683,1599,246482,0,7,3,0,madison largest reporting team the best source news analysis features wisconsin business politics crime entertainment sports,podcast slicing scott walker convention speech opinion^the popular baby names children '80s^what popular baby names state year born^what popular baby names state year born^what popular baby names state year born^chicago police multiple victims reported shooting hospital^breaking chicago police multiple victims reported shooting hospital^mlb predictions who come top^nfl predictions who come top draft^today birthdays sept. beyonce knowles,3,7,4,10,0.3,0.4,0
70961675,GoodDayAtlanta,1401,44077,577,131293,0,2,3,5,wake early us we bring latest news updates need day ... fun,the death centers disease control prevention employee whose body found river atlanta n^breaking white house vice president joe biden make statement rose garden^kate middleton proudly held new bundle joy prince william left hospital welcoming bab^kate middleton prince william leave hospital welcoming baby boy^how brad pitt angelina jolie divide 400 million fortune^'superman star margot kidder dead^'wicked tuna star nicholas 'duffy fudge dead^breaking former fox news chairman ceo roger ailes dead^ap britain royal palace says prince harry asked elder brother prince william best man wedding next month^jennifer garner ben affleck officially file divorce,3,7,4,10,0.3,0.4,0
21866939,itvnews,1468,2161665,7591,198534,0,0,4,6,breaking news biggest stories uk around world bulletins weekdays :30pm :30pm pm itv email yourstory.com,meghan duchess sussex speaks cameras first time since royal wedding new documentary queen of^meghan duchess sussex speaks cameras first time since royal wedding new documentary queen of^david beckham set court appearance bentley speeding charge^david beckham fight speeding claim technicality^pop singer announced engagement girlfriend cherry seaborn saying pair got engaged b^rapper nelly arrested suspicion rape lawyers say allegation 'completely fabricated^prince harry meets us first lady melania trump canada ahead opening ceremony invictus games^as prince harry meghan markle announce engagement everything know bride^meghan markle confirms father attend royal wedding reports live^actress bella thorne says sexually abused age,4,6,2,10,0.4,0.2,0
14854462,HOT97,986,1044587,3563,143295,0,0,4,6,,chance the rapper responds to donald trump after receiving praise from president^people are upset kim kardashian using r word ... do you accept her apology^kim kardashian kanye west struggling over where to raise their baby^kanye west to be the next judge in a new american idol^a second suspect arrested connection xxx tentacion murder^forth suspect arrested in xxxtentacion murder^a second suspect arrested connection xxx tentacion murder^do think jet blue made right decision kick family plane cake ebrointhemorning^yes true stacey dash running congress california thoughts ebrointhemorning listen live^damn serena williams withdraws australian open,4,6,2,10,0.4,0.2,0
10424112,ndn,2301,75110,863,161578,2,0,2,6,breaking news weather sports newspaper record naples florida part usa today network email us news.com,former president george h.w bush letter estero councilor son died remains treasured memento^friday front page estero woman recalls moving letter sent president george h.w bush her^frequently asked questions habitat humanity^kevin hart confesses cheating pregnant wife^ex 'dance moms star abby lee miller sentenced year prison^walmart remove 'cosmopolitan checkout lines says 'business decision^the best memorial day sales home appliances^summer phoenix files divorce husband casey affleck^summer phoenix files divorce husband casey affleck^live stream judge declares mistrial bill cosby sexual assault case,4,6,2,10,0.4,0.2,0
16760131,wcbs880,844,21330,786,108243,1,6,3,0,newsradio new york radio home `` play w-c-b-s-eight-eighty '' smart devices,update federal prosecutors charge suspect underground port authority bus terminal bombing say wrote face^kudlow betrayed slamming u.s. tariffs right^rudy giuliani tells odds trump mueller interview '50 talked those^while trying make case trump sit interview robert mueller team would n't accom^nygovdebate calls mini me molinaro accuses cuomo running^nyc former mayor giuliani getting award new hampshire^former mayor rudy giuliani in new hampshire today^jenniferaniston justintheroux announced year marriage^as speak packages inspected top elosive eerts major federal inve^a royal baby way prince harry meghan markle eecting first child next spring.,4,6,2,10,0.4,0.2,0
24091188,JimHeathTV,4919,11474,385,42076,1,6,3,0,walter cronkite emmy award winning broadcast journalist author opinions are based on facts lucifans buckeyes firstamendment,full transcript sen amazing amp important speech freedom press made today senat^full transcript sen amazing amp important speech freedom press made today senat^every time i hear car ad kid rock born free song takes back covering zillion romney campaign rallies^hearing kid rock song car ad brings back memories dozens amp dozens romney campaign stops ohio bornfree ugh^gingrich appear today nbc meet press cbs face nation abc this week payback marianne interview^today the democratic national committee asked columbus mayor michael coleman submit bid host '16 dem national convention^years ago i covered president obama cincinnati labor day picnic polls changed dramatically since^dancing with the stars facing dilemma some contestants risk making mockery of show via^dancing with the stars dodges a bullet grocery store joe should be doomed in double elimination week^voting controversy on dancing with the stars via dwts,4,6,2,10,0.4,0.2,0
23405846,NewsX,160,559101,834,347222,0,3,6,1,india leading english news channel choice young aspiring urbane livetv sports news sports,obamaonrday meet the indo us track ii czars modi obama 's agreement moment watch live intercontinental broadcast only on newsx^us shooting chicago hospital leaves multiple victims chicago chicagoshooting mercyhospital usshooting^stay tuned newsx pm modi president trump shortly issuing joint statement rose garden in^it jennifer aniston calls quit husband justin theroux years marriage^go buy ivanka stuff kellyanne conway draws condemnation product endorsement^georgeclooney wife amal ready 300 million divorce^george clooney wife amal ready 300 million divorce^actor george clooney wife amal welcome twins style1^katie holmes dines mystery man one month filing divorce tom cruise actress katie holmes ...^judge declares mistrial comedian bill cosby sexual assault case,6,4,-2,10,0.6,-0.2,1
35792884,hot1079atl,1939,178575,1006,101544,0,0,6,4,hot atlanta hip hop station listen amazon echo enable hot amazon alexa once enabled say alexa play hot1079,amp americanidol bizarre facts that will make your day^kodak black tells kim kardashian to ditch kanye west for him^end of days trump warns north korea they will be met fire and fury^kanye west amp nick cannon squashed their beyond burger beef over kim kardashian^kanye west is back on twitter talking about mind control can buy his publishing^kanye west amp nick cannon squashed their beyond burger beef over kim kardashian^report scandal is coming to an end after seventh season^jennifer hudson joins the voice as season coach^is phaedra parks returning to the real housewives of atlanta^kylie jenner slams reports claiming she is pregnant,6,4,-2,10,0.6,-0.2,1
1612349160,Studio10au,2233,26529,203,44344,0,1,6,3,studio10 weekdays 0am pm,do n't think speaks broadly well disgusting amp despicable people hijack someone else'^new studio10 co host kerri anne kennerley hosted charity event toowoomba special guest keith urban^justin bieber amp selena gomez spotted locking lips public does confirm jelena back together^new photos 'the crown gives fans sneak peek series recreating iconic moment prince^daniel craig amp rachel weisz welcomed first child together studio10^years shock split angelina jolie amp brad pitt taking custody battle court studio10^kathy lette debunked claims billy connolly losing battle health amp assured fans wit s^get ready another royal wedding announced princess eugenie engaged long term boyfriend the^julia louis dreyfus revealed diagnosed breast cancer studio10^a musical life amp legacy michael jackson coming broadway studio10,6,4,-2,10,0.6,-0.2,1
1058104100,HOT969Boston,7668,14845,109,51508,0,0,6,4,boston throwbacks the best new hip hop and r b home weekdays -10am,fans say footage shows mileycyrus baby bump^police responded call shots fired block alpine drive beverly hills kanyewest^the latest details selena gomez breakdown sad ...^years split brad pitt angelina jolie turning custody battle notch^prince harry duke sussex the duchess sussex depart following wedding st george chapel wind^'keeping up with kardashians star kylie jenner announced face new campaign adidas ori^prince charles officially made announcement morning son prince harry engaged girl^anne hathaway took social media call white privilege wake murder year old nia wilson.^the third four suspect murder xxxtentacion arrested^watch taylor swift new music video end game ed sheeran future,6,4,-2,10,0.6,-0.2,1
36198924,Star941Atlanta,2451,11502,276,15654,0,0,6,4,more hits your hits crew,did lindsaylohan convert to islam^george clooney amal welcome twins^rt celeb dirt breaking news angelina jolie brad pitt married saturday france per spokesman couple^rumors swirling dating robert pattinson see the photo everyone talking^icymi complete list grammy winners^did lindsaylohan convert to islam^have mercy uncle jesse eecting first child fianc e caitlin mchugh gt^jennifer lawrence single details split director boyfriend /^richard simmons hospitalized severe indigestion details^announced going return new halloween movie next year,6,4,-2,10,0.6,-0.2,1
19955831,1067Litefm,404,9091,149,31489,0,0,6,4,new york best variety,watch liamhemsworth prank mileycyrus^watch liamhemsworth prank mileycyrus^justinbieber may married not selenagomez details^report jessica simpson pregnant trending via^selenagomez reveals kidney transplant best friend donor^selenagomez reveals kidney transplant best friend donor^here help victims lasvegas mass shooting right nyc^heatherlocklear arrested battery attacking cop and emt^everyone favorite muppet kermitthefrog getting new voice years^everyone favorite muppet kermitthefrog getting new voice years,6,4,-2,10,0.6,-0.2,1
793820001077690368,ExtraIRL,315,1611,16,19717,0,1,6,3,the latest irish news sport entertainment business plus whole lot take extra look news,staff fired department social protection one sacking health four years^the complete list winners emmy awards^the complete list winners emmy awards^'i n't enjoy single says angelina jolie one year filing divorce brad pitt^julia roberts gives fans rare glimpse loving embrace hubby^actors daniel craig rachel weisz welcomed baby girl together^the new mum kept pregnancy wraps slowly bringing stormi spotlight kyliejenner^enrique iglesias anna kournikova welcome secret twins^prince harry officially asks brother william best man royalwedding^it justintheroux first interview since split jenniferaniston,6,4,-2,10,0.6,-0.2,1
1115874631,CGTNOfficial,43,14232986,7628,100214,3,1,4,2,china global television network cgtn multi-language multi-platform media grouping,hours long us government shutdown ends working day begins house representatives narrowly passes budge^us house representatives set tuesday vote bill avoid government shutdown^federal prosecutors charge nyc subway bomb suspect say wrote facebook trump failed protect nation^us goods trade deficit widens 75.8bln august tradefriction^mostwatched newborn princelouis wears white jumper trousers photos taken kensington palace catheri^newborn prince louis wears white jumper trousers photos taken kensington palace catherine duchess^mostwatched newborn princelouis wears white jumper trousers photos taken kensington palace catheri^newborn prince louis wears white jumper trousers photos taken kensington palace catherine duchess^ivankatrump announced closing eponymous fashion brand following firestorm criticism p^announces new album reputation set november release,7,3,-4,10,0.7,-0.4,1
40302362,ForbesLife,3101,117270,2197,94856,0,0,7,3,the definitive destination finest fashion travel homes art dining and life indulgences,the highest paid actresses julia roberts ranked no 13 million earnings can guess topp^the founders tequila enemigo george clooney changed tequila business casamigos^the highest paid actresses julia roberts ranked no 13 million earnings can guess topp^brad pitt angelina jolie lose court case french miraval castle^brad pitt angelina jolie lose court case french miraval castle^the highest paid actresses julia roberts ranked no 13 million earnings can guess topp^the highest paid actresses julia roberts ranked no 13 million earnings can guess topp^what hairstyle meghan markle opt wedding day pippa middleton hairdresser weighs^which hairstyle meghan markle wear wedding day pippa middleton hairdresser weighs^prince william prince harry best man royal wedding inside brotherly bond.,7,3,-4,10,0.7,-0.4,1
34741439,screenertv,2541,79850,2088,122607,0,0,7,3,watch better,kim kardashian vs teen moms bring catfight^katie holmes dines lawyer mystery man^christina aguilera engaged boyfriend matt rutler see giant ring^did matt lauer affair get dumped wife annette roque^'dancing with stars blake shelton gets 'footloose julianne hough^kourtney kardashian scott disick always family^kourtney kardashian scott disick always family^'once upon time 'modern family plus five abc shows officially renewed season^'the walking dead season promotes three actors series regular^'once upon time season everything need know 'frozen premie ...,7,3,-4,10,0.7,-0.4,1
18472223,glamsham,2,55226,212,55818,0,0,7,3,global entertainment digital destination since offering ott news reviews gossip instagram facebook,puts loved display girlfriend readmore ... glamsham hollywood^when lucaguadagnino made dakotajohnson 'uncomfortable readmore ... glamsham^angelina jolie enjoys children custody agreement read more ... glamsham^meghanmarkle wedding a saintly fashioned fairy tale glamsham hollywood^looking family friendly role checkout ... glamsham hollywood^angelina jolie enjoys children custody agreement read more ... glamsham^danielcraig rachelweisz welcome first child read more ... glamsham hollywood^cover richest self made women issue glamsham kyliejenner^thinks getting nose job 'every day checkout ... glamsham^merylstreep joins 'big little lies season gt,7,3,-4,10,0.7,-0.4,1
196276297,OnAirWithRick,1487,26503,232,75939,0,0,7,3,daddy dog dad hoosier radio nerdweekdays -10am go colts,it official gwen stefani mentoring blake shelton team 'the voice season cou^pregnant bride miley cyrus regrets bleaching her hair^blake shelton sultry new single turnin me on was inspired gwen stefani listen^pregnant bride miley cyrus regrets bleaching her hair^music news christina aguilera engaged boyfriend matt rutler indiana star1069fm^entertainment news christina aguilera engaged boyfriend matt rutler indiana star1069fm^watch rachel reinert play it forward covering sheryl crow strong enough boise^comedian actor charlie murphy brother eddie murphy dies leukemia^tim mcgraw collapses onstage during performance ireland boise boisestate boiseidaho meridianidaho^jason aldean wife brittany are eecting baby no,7,3,-4,10,0.7,-0.4,1
26023025,RadioNOW1009,7107,17494,260,83055,0,0,7,3,wake up every morning w/ -10am listen amazon echo enable radio now amazon alexa once enabled say alexa play radionow1009 '',kim kardashian miserable hopeless in marriage with kanye west^fergie amp josh duhamel split and her mom had no idea^tristan thompson told khloe kardashian to sign a list of demands for him to stay with her^angelina jolie i don enjoy being single^jessica simpson gives birth to son and gives him a very weird name^justin theroux opened up about his divorce from jennifer aniston^kim kardashian arrives in nyc with massive security detail still terrified^congrats kevin hart and wife eniko parrish are eecting their first child together^tamar braxton files for divorce from vincent herbert month before wedding anniversary^kylie jenner slams reports claiming she is pregnant,7,3,-4,10,0.7,-0.4,1
60100860,AwardsCircuit,1001,10417,213,56682,0,0,7,3,awardscircuit film tv awards owner jr bfca nyfco btja aafca latino-black q a moderator pod yosoyleja,i know new network stop calling season americanidol season seasons came before^vince vaughn wedding crashers^telluride review destroyer delivers outstanding nicole kidman performance via^telluride review 'destroyer delivers outstanding nicole kidman performance sundaymorning destroyer^telluride review 'the favourite delectable mischievious romp thefavourite telluride oscars^watch jennifer lawrence looks terrified new clip 'mother^film review melissa mccarthy truly is 'life party adriaarjona benfalcone damonjones debbyryan^emma roberts returns 'american horror story cult^pop superstar katy perry host mtv video music awards vmas katyperry^watch 'ready player one shines light director steven spielberg with behind scenes trailer adamsomner,7,3,-4,10,0.7,-0.4,1
73228608,gulftoday,41,9531,777,182878,0,2,7,1,keeping informed news opinions uae middle east,croatia goalkeeper saves three spot kicks penalty shootout side beat denmark reach last eight of^palestinian southern education direction member safa'a amro prepares one thousand four hundred metres square ke^clooney amal ready 300 million divorce says report georgeclooney amalclooney^jennifer aniston brad pitt might getting back together^robert pattinson fka twigs reportedly call wedding^prince william catherine duchess cambridge give world first look new son^prince william catherine duchess cambridge give world first look new son^britain prince harry duke sussex wife meghan duchess sussex visit irish sculptor rowan gillespi^david beckham face trial speeding offence^'harry potter star matthew lewis marries angela jones,7,3,-4,10,0.7,-0.4,1
16211434,TravelLeisure,981,4028986,14986,114677,0,0,8,2,your connection world travel brought editors questions stories please share social media terms,yep duchess cambridge founded exclusive alcohol club^these engaged royals moving next door prince harry meghan markle^these engaged royals moving next door prince harry meghan markle^these engaged royals moving next door prince harry meghan markle^these engaged royals moving next door prince harry meghan markle^these engaged royals moving next door prince harry meghan markle^prince harry one regret royal wedding meghan markle^prince harry one regret royal wedding meghan markle^meghan markle getting wax figure madame tussauds prince harry alone^all details prince harry meghan markle wedding rings adorable gesture harry his,8,2,-6,10,0.8,-0.6,1
256495314,firstpost,1006,2030159,4016,559970,2,2,6,0,incisive opinions in-depth analysis views matter read last word news,donaldtrump issue executive order ban facebook across us^former us president helped steer america end coldwar died age h^imran peech foreign policy bereft policy directions strategic heft substance leave alone gr^the discovery prompted public records requests american oversight the group executive director aust^northkorea warns attacks us trump fire fury remark rextillerson rushes repair job^prepare unforgettable eerience top storey pay tribute legends pop like michae^kristen stewart jealous fka twigs^katie holmes great dinner mystery man^katie holmes spotted mystery man^missionimpossiblefallout best action movie since fury road best spy thriller since the bourne ultim,8,2,-6,10,0.8,-0.6,1
325260518,OnAirWithRyan,5864,224465,1252,54538,0,0,8,2,seacrestshow call -800-520-1027,"ca n't wait hear listen live :30a pt^*live look meredith right now* excited become uncle^happy friday here live look getting ready call^on air ryan seacrest offering chance win 1,000 night ryan thanks capital one qu^ca n't wait hear listen live :30a pt^*live look meredith right now* excited become uncle^happy friday here live look getting ready call^on air ryan seacrest offering chance win 1,000 night ryan thanks capital one qu^rachelmcadams is reportedly pregnant with her first child^it official david foster katharine mcphee engaged",8,2,-6,10,0.8,-0.6,1
90329963,spinorbinmusic,8768,113825,301,44935,0,0,8,2,music musings bite-sized pieces world bloggers social media awards best gossip entertainment blog -time singapore blog awards winner,americanidol season got top finalists gt gt competing finale and^royalbaby way huge congratulations prince harry amp meghan markle^who excited 'taki taki collaboration amp ozuna o^friends reportedly terrified pair reunite i guess fans terrified ... fb^chris brown girlfriend terrified rihanna cray cray fans they want kill lol fb^we dedicate track playlist entitled sweet sweet revenge karma is a bitch jennifer aniston gt gt gt^engaged boyfriend matt rutler matt proposed valentine day accepted aww best valentine gift ever^who excited 'taki taki collaboration amp ozuna o^engaged german basketball player andr murillo^american idol alum alaina engaged longtime boyfriend alex hopkins congratulations happy,8,2,-6,10,0.8,-0.6,1
21886583,Q102Philly,3150,103371,940,122020,0,2,8,0,philly hit music station -10a ontheradio a-3p -7p p-12m keepitonq,most popular baby names state state^most popular baby names state state^happy birthday we hope treats well today not.. commercialfree musi^happy birthday we hope treats well today not.. commercialfree musi^did see moment americanidol last night katyperry seemed shade taylorswift and you^did see moment americanidol last night katyperry seemed shade taylorswift and you^happy birthday we hope treats well today not.. commercialfree musi^happy birthday we hope treats well today not.. commercialfree musi^did see moment americanidol last night katyperry seemed shade taylorswift and you^did see moment americanidol last night katyperry seemed shade taylorswift and you,8,2,-6,10,0.8,-0.6,1
510502151,sunny981sd,2466,2140,31,8510,0,0,8,2,sunny981sd,the voice blake shelton serenades gwen stefani birthday check cute video aj amp sara^the voice blake shelton serenades gwen stefani birthday check cute video aj amp sara^when u see ad 'll know upset marketing film 'red shoes amp the dwarfs^the voice blake shelton serenades gwen stefani birthday check cute video aj amp sara^the voice blake shelton serenades gwen stefani birthday check cute video aj amp sara^the voice blake shelton serenades gwen stefani birthday check cute video aj amp sara^icymi complete list grammy winners^the voice blake shelton serenades gwen stefani birthday check cute video aj amp sara^pink kids cover people beautiful issue talks honor ellen show c^'superman star margot kidder dead via,8,2,-6,10,0.8,-0.6,1
33512799,NileFM,1046,2876891,392,69890,0,0,9,1,egypt hit music station bringing world biggest artists songs hottest djs entertainment news since nilefm,can matchthemouth guess said quote a ashton kutcher b brad pitt c justin theroux d george cloo^can matchthemouth guess said quote a ashton kutcher b brad pitt c justin theroux d george cloo^can matchthemouth guess said quote a ashton kutcher b brad pitt c justin theroux d george cloo^reunion short lived after split starboy singer spotte^son law hell elosive fights advisors worried abou^bigdrivehome gossip column taylorswift amp enjoy a dinner date with fellow gorgeous couple rosie huntington amp jason stathem^shares thoughts negative effects socialmedia mind control^son law hell elosive fights advisors worried abou^can matchthemouth guess said quote a ashton kutcher b brad pitt c justin theroux d george cloo^wants 'marry frances mcdormand nilefmentertainment,9,1,-8,10,0.9,-0.8,1
34993020,peopleschoice,1753,572549,2104,34898,0,0,9,1,voting open pcas celebrate best pop culture make sure favorites win vote watch show sunday nov e,did brad pitt george clooney purposely plan getting married year^vote tom cruise mission impossible fallout retweeting post tomcruise themalemoviestar pcas^vote tom cruise mission impossible fallout retweeting post tomcruise theactionmoviestar pcas^vote jay z retweeting post jayz themaleartist pcas^vote emily blunt a quiet place retweeting post emilyblunt thedramamoviestar pcas^vote emily blunt a quiet place retweeting post emilyblunt thefemalemoviestar pcas^vote kylie jenner retweeting post kyliejenner thesocialcelebrity pcas^vote live kelly ryan retweeting post livewithkellyandryan thedaytimetalkshow pcas^rt brad pitt quit acting 'three years say ai n't^nashville the e people choice awards airstream roadtripping across country check instagram amp s,9,1,-8,10,0.9,-0.8,1
20455625,esquire,3519,419957,7878,134191,0,0,9,1,nan,brad pitt crushing dad style dodgers game^helen mirren retired breasts glad kim kardashian n't nsfw^bow street style/culture gods known justin theroux kuma^justin theroux shows give fucks given attitude still looking put together^justin theroux shows give fucks given attitude still looking put together^the day academy snubbed david oyelowo brad pitt saw him his new film nightingale^bow street style/culture gods known justin theroux kuma^justin theroux shows give fucks given attitude still looking put together^justin theroux shows give fucks given attitude still looking put together^after months speculation gameofthrones prequel officially happening,9,1,-8,10,0.9,-0.8,1
45541231,4Music,2114,159097,637,61958,0,0,9,1,freeview */ sky virgin *we moved channel may need re-tune freeview box,nevermind drake hooking madonna ex^kourtney kardashian said jealous kim wealth^kristenstewart sent robertpattinson ultimatum rebound relationships^kristenstewart sent robertpattinson ultimatum rebound relationships^'won marry would hurt finances kardashian empire flagging financially^hurt fat insults but thinks kim gorgeous so^'won marry would hurt finances kardashian empire flagging financially^hurt fat insults but thinks kim gorgeous so^kylie jenner returned spotlight new photoshoot fans think proves pregnant ... t^the worst kept secret prince harry engaged twitter gone overload ve,9,1,-8,10,0.9,-0.8,1
19501656,CollegeCandy,742,12895,406,36007,2,0,7,1,a college girl not-so-guilty pleasure cc guide dating fashion celebrity gossip facebook/instagram,shutting drug use rumors suspicious snapchat photo the truth lol worthy.^people were found dead shot execution style in rural ohio^katy perry joined madonna on stage and things got raunchy fast^did justin bieber hailey baldwin get married already^caitlyn jenner ex wife threw eert shade missing brody jenner wedding^katy perry shades taylor swift americanidol when squash beef good^kim kardashian fights kanye west controlling^so rihanna might be pregnant with chris brown baby this saga just wo n't quit^katy perry shades taylor swift americanidol when squash beef good^netflix giving us even shows binge watch holidays winterbreakplans,9,1,-8,10,0.9,-0.8,1
1516597370,CarolynDurand,423,10022,172,10168,0,0,9,1,writer/storyteller special events producer royal reporter contributor elle magazine american london amarone lover,meghan harry looking happy love spend last day beautiful tonga heading back to^a palace spokesman said meghan mom doria happy lovely news looking forward welcomi^kate meeting scouts near home anmer hall norfolk^the photos princegeorge taken anmer hall month by matt porteous^william kate release new photo princesscharlotte nd birthday taken duchessofcambridge t^the set princesscharlotte photos taken kate duchessofcambridge anmer hall^she adorable princesscharlotte georges cheeks photos takes kate anmer hall^archbishop canterbury speaks princeharry meghanmarkle upcoming wedding saying was^kensington palace confirms princeharry meghanmarkle dukeandduchessofsussex moving official residen^new wedding details announced kp meghan markle mother accompany car royal wedding her,9,1,-8,10,0.9,-0.8,1
16184358,CNNBusiness,966,1758600,20241,163425,1,7,0,1,your guide tech media finance future,"facebook ceo mark zuckerberg appear european parliament warns 'll much tou^trade war fallout soybean prices plunge year low^in exclusive interview tim cook calls recent bloomberg report alleging china infiltrated apple chips^in exclusive interview tim cook calls recent bloomberg report alleging china infiltrated apple chips^nbc fox news pull trump campaign racist ad 'sunday night football backlash^mark zuckerberg sister randi weighed brother controversial comments holocaust deniers exclus^mark zuckerberg sister randi weighed brother controversial comments holocaust deniers exclus^the us china tariffs gone effect ,300 goods suddenly eensive yesterday c^kylie jenner happy snapchat new redesign",1,8,7,9,0.1111111111111111,0.7777777777777778,0
60919240,donnabrazile,5428,655576,9049,55888,1,8,0,0,former chair adjunct lecturer georgetown university fox news contributor king lecture chair howard university dcstatehood whodatnation,prayers speedy recovery first lady melania trump undergoes kidney surgery walter reed medical ce^why i had an abortion at weeks planned parenthood action center via^hype sen. rand paul says obama 'is advocating drone strike program america misleader^sunday 'this week white house national security adviser john bolton sen. chris murphy abc news via^dnc chair wasserman schultz announces leah daughtry ceo democratic national convention committee^great column esteemed paul krugman short political memories^great column nobel laureate paul krugman health care horror hooey^kanyewest set us back years wish sojournertruth could met outside white house and^a comprehensive investigation voter impersonation finds credible incidents one billion ballots cast,1,8,7,9,0.1111111111111111,0.7777777777777778,0
27583598,KPRC2,1623,646245,2398,199125,0,1,1,7,houstonstrong nbc tv affiliate local news station houston breakingnews houstonweather kprc2 follow kprc2 reporters,be sure tune exclusive interview former president george w. bush^khloekardashian rocks string thong dirty shoot after tristanthompson cheating episode kuwtk^if missed ... image awards winners the complete list gt^daytime emmy awards the complete winners list^nickjonas priyankachopra are engaged kprc2^carrie fisher debbie reynolds personal items auction home sold kprc2^singer comes pansexual interview but exactly mean^billboard music awards check complete list winners gt^billboard music awards check complete list winners gt,1,8,7,9,0.1111111111111111,0.7777777777777778,0
9648652,FOXLA,16634,231035,3190,165143,0,2,1,6,official fox los angeles account la news send news tips fox11news.com use call -584-2025 follow,mccain pushes lieberman defense job arizona republican sen. john mccain said interview cnn wedne ...^breaking president trump makes remarks joint republican issues conference philadelphia pa. watch^tmz kyliejenner pregnant travis scott baby^harry potter river cruise set sail summer cost serious cash via^'pirates caribbean dead men tell no tales premieres hollywood via^actor vince vaughn arrested suspicion dui resisting arrest manhattan beach checkpoint^'superman star margot kidder dead^richard simmons hospitalized california monday severe indigestion according tmz^it years since prince super bowl halftime show recalled many best ever,1,8,7,9,0.1111111111111111,0.7777777777777778,0
21728303,keithboykin,976,187691,3395,43716,0,8,1,0,commentator new york times bestselling author dartmouth harvard law columbia iraas former white house aide,the chairwoman republican national committee ronna mcdaniel warning anyone dares disagree^timely new column paul krugman shows black single mothers cause effect joblessness^nobody knows system better i alone fix donald trump speech^read nowhere transcript meet the press susan rice say benghazi terrorist attack^i promise united supreme court nominee hillary clinton president^there certainly long historical precedent supreme court fewer justices sen. ted cruz r t vowi^if hillary clinton becomes president i going everything i make sure four years st^wait kellyanne conway actually said melania trump superior first lady michelle obama i guess i missed t^chance the rapper responds donald trump i 'd never support someone made career hatred racism,1,8,7,9,0.1111111111111111,0.7777777777777778,0
18247597,fox5sandiego,651,186748,2166,97148,0,2,1,6,news around san diego staffed editors sosandiego,mitt romney stars campaign ad^live video vice president joe biden make statement rose garden^jenner lifelong republican latest celebrity float run office^donald trump star hollywood walk fame vandalized^after years kermit frog getting new voice^legendary comedian don rickles dies^clueless actress stacey dash running congress california^ellen degeneres cries receiving best birthday gift portia de rossi^ellen degeneres cries receiving best birthday gift portia de rossi,1,8,7,9,0.1111111111111111,0.7777777777777778,0
14976738,3onyourside,810,166808,981,177911,1,1,0,7,memphis mid-south breaking news weather sports region television station,melania trump undergoes kidney surgery walter reed medical center^chicago hospital secured shooting injures officer multiple victims reported^april giraffe gives birth million online^april giraffe gives birth million online^ellen degeneres cries receiving best birthday gift portia de rossi^ellen degeneres cries receiving best birthday gift portia de rossi^ellen degeneres cries receiving best birthday gift portia de rossi^fiona baby hippo dad henry dies^april giraffe pregnant,1,8,7,9,0.1111111111111111,0.7777777777777778,0
13657922,DMRegister,4989,153711,2385,102794,1,8,0,0,the news iowans depended upon since winner pulitzer prizes support local journalism subscribing,the constant din anger dominates media blind us fact substantial majorities americ^nine people become sick eating romaine lettuce amid e. coli outbreak according centers f^at least states affected salmonella outbreak linked cereal according centers d^kasich said sunday abc this week with george stephanopoulos earnest conversations go^nine people become sick eating romaine lettuce amid e. coli outbreak according centers f^one woman told cnn freeman subjected sexually charged comments unwanted touches near daily bas^what bill clinton george w. bush agree a rare joint interview two former presidents^it versus change past versus future obama says^it versus change past versus future obama says,1,8,7,9,0.1111111111111111,0.7777777777777778,0
27882000,jamiedupree,42,149743,3173,61089,0,8,1,0,minton tile correspondent wsb atlanta wdbo orlando wokv jacksonville whio dayton krmg tulsa wgau athens national murrow award winner jamie dupree,in fox news interview rep trey gowdy r sc breaks trump claims fbi misconduct^my last tweet tuesday night sen jim demint r sc says oppose obama gop tax deal^vice president biden making statement rose garden :10^no senate intelligence committee come conclusion well^at campaign rally las vegas president trump praises judge brett kavanaugh one finest human beings ... impeccable reputation^at white house briefing sh sanders wo n't say four judges president met today supreme court^sh sanders starts white house briefing talking asked leave virginia restaurant saturday^president trump getting briefing hour white house hurricane michael press coverage sch^just like no way out kevin costner runs georgetown gets metro i,1,8,7,9,0.1111111111111111,0.7777777777777778,0
71349174,CNNPR,640,138572,2479,24704,0,8,1,0,tweets communications team latest news announcements behind-the-scenes look cnn worldwide factsfirst,final rush transcript//cnn democratic presidential primary debate brooklyn ny^final rush transcript//cnn democratic presidential primary debate flint mi^final rush transcript//cnn democratic presidential primary debate brooklyn ny^final rush transcript//cnn democratic presidential primary debate flint mi^final rush transcript//cnn republican presidential primary debate university miami^final rush transcript//cnn democratic presidential primary debate brooklyn ny^final rush transcript//cnn democratic presidential primary debate flint mi^final rush transcript//cnn democratic presidential primary debate brooklyn ny^the top announced learn organizations vote,1,8,7,9,0.1111111111111111,0.7777777777777778,0
16187637,ChadPergram,17938,99535,2481,90778,1,8,0,0,chad pergram covers congress fox news he edward r. murrow award joan barone award reporting capitol hill,pelosi hse dems the public entrusted us save democracy it patriotic duty deliver more^schumer the administration backtrack zte another example president weak face anothe^mbrs voted last she roll call mbrs there r amp d that means vote needs yeas pass^wh under president trump leadership republican national committee raised quarter billion do^senate intel cmte chair burr russian interference election any statement vladimir putin contrary these^dem ct sen murphy asks pompeo telll statement trump amp policy murphy cites us^hillary clinton hr long dinner tonight capitol hideaway office sen feinstein d ca they salmon amp stag leap chardonnay^sen. patrick leahy d vt doj ig hrng says lot irony hearing leahy if fbi wer^presidents nominated sens senate confirmable positions since wwii none voted sen harold hitz,1,8,7,9,0.1111111111111111,0.7777777777777778,0
15627208,daytondailynews,984,88521,1007,215998,0,5,1,3,complete local news information dayton ohio area,icymi featured new jihadist recruitment video^chicago mercy hospital shooting the victims identified officer samuel jimenez dr. tamara e. o neal a^chicago mercy hospital shooting what know victims^chicago hospital shooting nurse critically wounded police officer among multiple victims shot^vice president joe biden speaks coney island labor day picnic^katie couric breaks silence news matt lauer dismissal 'today^meghan markle dad heart surgery wo n't attend royal wedding report says^more former fox news ceo roger ailes dead^actor ving rhames says police held gunpoint home neighbor reported burglary,1,8,7,9,0.1111111111111111,0.7777777777777778,0
15572679,jaxdotcom,2505,68264,959,104061,0,8,1,0,sharing latest news information the florida times-union follow media marketing solutions,"overall million u.s. deaths nearly ,000 previous year ce^the figure reported friday centers disease control prevention exceeds child deaths reported^more half suicides subgroup states among people known mental health conditi^the five story ,000 square foot mangurian building mayoclinic serve state art treatment c^the five story ,000 square foot mangurian building mayoclinic serve state art treatment c^overall million u.s. deaths nearly ,000 previous year ce^chicago pizza owner cliff comastro stood jaxlanding courtyard wednesday night crowd sang am^top stories week no tyrone gayle already served spokesman nation senio^he announced monday year michael strahan exited show good morning america",1,8,7,9,0.1111111111111111,0.7777777777777778,0
15822299,TDOnline,2841,53197,829,112551,1,2,0,6,latest news tallahassee daily newspaper tallahassee democrat part usa today network,nancy pelosi fights regain house speaker role la auto show keystone xl things know wednesday^updated polls show obama beat mccain third final presidential debate a snap cnn/opinion resear..^shooting near chicago hospital leaves multiple victims^tonya harding admits prior knowledge nancy kerrigan attack abc special^the best memorial day sales home appliances^summer phoenix files divorce husband casey affleck^here popular halloween candy every state^serena williams withdraws australian open^april giraffe pregnant due next year,1,8,7,9,0.1111111111111111,0.7777777777777778,0
55520972,Afrihost,6257,51227,277,203563,0,0,1,8,the internet way fibre fixed wireless dsl find right package needs pureinternetjoy,california teenager gets turned down prom shows up with kylie jenner instead^youtube star austin jones arrested child pornography charges^from bloody shoes tattoos how game thrones cast is saying farewell^american horror story season will officially be long awaited murder house/coven crossover^this trailer elains why ant man is n't avengers infinity war^omg groot is actually dead and baby groot is his son^henry cavill says goodbye his mustache hilariously dramatic video^check out colorful new thor ragnarok posters^leonardo dicaprio has titanic reunion with kate winslet billy zane his foundation gala,1,8,7,9,0.1111111111111111,0.7777777777777778,0
24776950,WEAU13News,551,24802,380,52827,0,7,1,1,weau nbc affiliate western wisconsin including eau claire la crosse communityfirst weau skywarn13 ss13,"the centers disease control prevention say growing concerned acute flaccid myelitis^according centers disease control prevention children america identified^the centers disease control prevention cdc asking pet owners dress chickens hallow^wisconsin taayers spent nearly 41,000 send state senators state trips since including pres^the centers disease control prevention say growing concerned acute flaccid myelitis^the centers disease control prevention cdc asking pet owners dress chickens hallow^chicago police say responding shooting near chicago hospital 'reports multiple victims^bishop michael curry recently rose international notoriety speaking royal wedding prince harry a^kensington palace says britain prince harry meghan markle requesting 'understanding respect mark",1,8,7,9,0.1111111111111111,0.7777777777777778,0
21004741,NewarkAdvocate,909,11201,196,56135,0,0,1,8,this twitter account the advocate newark ohio we licking county source news,trump assertion left wing protesters violent white supremacists charlottesville sets firestorm^tonya harding admits prior knowledge nancy kerrigan attack abc special^tonya harding admits prior knowledge nancy kerrigan attack abc special^the best memorial day sales home appliances^summer phoenix files divorce husband casey affleck^summer phoenix files divorce husband casey affleck^serena williams withdraws australian open^serena williams withdraws australian open^oscars the complete winners list,1,8,7,9,0.1111111111111111,0.7777777777777778,0
15673261,TimesRecorder,136,9282,178,44532,0,0,1,8,this twitter account zanesville times recorder zanesville ohio we covering news muskingum valley since,trump assertion left wing protesters violent white supremacists charlottesville sets firestorm^tonya harding admits prior knowledge nancy kerrigan attack abc special^tonya harding admits prior knowledge nancy kerrigan attack abc special^the best memorial day sales home appliances^summer phoenix files divorce husband casey affleck^summer phoenix files divorce husband casey affleck^serena williams withdraws australian open^serena williams withdraws australian open^oscars the complete winners list,1,8,7,9,0.1111111111111111,0.7777777777777778,0
454100672,mjbeckel,2182,5896,297,20350,1,8,0,0,manager research investigations policy analysis alum following money politics since rts endorsements,in january every lawmakers serving us house representatives freshman according t^darkmoney illuminated the league conservation voters disclose donors identifi^the democratic national convention committee already spent nearly 1.6 million^as first presidential debate democrat vpdebate wearing red republican spor^host committee democratic national convention yet received c3 approval irs may morph c6^pro santorum red white amp blue fund superpac drops 281k ads laprimary docs filed today w/fec show source2012^pro santorum red white blue fund superpac dropped 494k ads wiprimary tuesday fec docs show source2012^pro santorum superpac red white amp blue fund going louisiana today w/ ads reports^latest fec filings show pro santorum superpac red white blue fund spending 257k new tv ads ohio source2012,1,8,7,9,0.1111111111111111,0.7777777777777778,0
22011288,deafgeoff,311,4976,230,68179,0,0,1,8,entertainment reporter seo specialist deaf dj motivational speaker lipreading tweets su basketball more,george takei running congress best april fools day pranks aprilfoolsday^emmy nominations complete list emmys nominees^pm buzz meghan markle dad wo n't attend royal wedding 'mystic pizza^big black dead mtv 'rob amp big star christopher boykin dies suddenly^oprah winfrey confirms wo n't run president 'i n't dna^fergie josh duhamel split years marriage^pm buzz taylor swift announces new album reputation shailene woodley running congress^am buzz '13 reasons why renewed season snl highlights 'edge tomorrow sequel more^msnbc 'morning joe co hosts joe scarborough mika brzezinski engaged,1,8,7,9,0.1111111111111111,0.7777777777777778,0
37874853,STcom,139,1021240,6080,366063,2,6,0,1,stay know latest news singapore around world breaking news exclusives opinion,actor denzel washington hit fake facebook news story donald trump^inside fake news sausage factory 'this income^amber hunters 'chasing dinosaurs myanmar conflict ridden north^happeningnow democrat hillaryclinton republican donaldtrump first presidential debate debatenight^transcript final us presidential debate hillary clinton donald trump^football arsenal arrive singapore icc^us trade deficit hits month low record erts may firms rush ship goods uschina trade war^record us imports drive goods trade deficit china high august^taylorswift announces new album reputation week court victory,2,7,5,9,0.2222222222222222,0.5555555555555556,0
892153969,GistReel,93,229422,398,31819,0,1,2,6,news entertainment lifestyle fashion contact us admin.com ads ads.com whatsapp +234-817-997-5099 subscribe youtube,faan issues statement after aremu afolayan video accusing immigration officers of collecting bribe went viral^george clooney wife amal welcome twins^don jazzy drops hilarious comment rihanna page says might pregnant^selena gomez the weeknd split after months it been hard months^selena gomez the weeknd split after months it been hard months^royal rules meghan markle has follow now that she duchess sussex^royal rules meghan markle has follow now that she duchess sussex^kylie jenner gives birth first child with travis scott^nick jonas priyanka chopra are reportedly engaged,2,7,5,9,0.2222222222222222,0.5555555555555556,0
122207745,SpecialReport,1111,204339,1787,12274,0,7,2,0,follow things special report,my interview house speaker paul ryan aired last night specialreport fox news foxnews midterms^on america newsroom morning discuss interview president trump ig report due toda^do n't miss exclusive interview nicaragua president daniel ortega tonight specialreport amid growing u^the republican national committee monday backed comments president trump critical retired navy a^discussing balance power brit hume fox news sunday chris wallace course bill hemmer t^sunday night plans i hope watch threedaysinmoscow tonight fox news n't forget set yo^cnn requests emergency briefing white house looks revoke jim acosta credential^goodmorningnews catherine duchess cambridge gave birth baby boy monday morning according kensing^las vegas shooting celebrities react massacre jason aldean concert,2,7,5,9,0.2222222222222222,0.5555555555555556,0
24928809,CBSLA,2338,202052,3403,161884,0,0,2,7,cbsla cbs2 kcal9 local breaking news sports weather best la oc download app breaking news,tonight miley cyrus liam hemsworth secretly get married don miss etnow^is blake griffin part of a kardashian curse^celebrity chef mario batali fired hit show the chew friday following allegations sexual misconduct s^breaking tiger woods arrested monday jupiter florida dui charge^'jeopardy host alex trebek recovering from surgery for blood clots on brain sends message to fans^tom hanks reportedly tapped play tv beloved mr. rogers upcoming biopic you are my friend for^police released booking photo vince vaughn arrested today suspicion driving inf^update blac chyna granted temporary restraining order ex fiancee rob kardashian^tonight fergie josh duhamel split years marriage don miss etnow,2,7,5,9,0.2222222222222222,0.5555555555555556,0
17121146,6News,1136,175739,888,194901,0,6,2,1,wate on your side provides latest news weather sports traffic updates east tennessee,the us centers disease control prevention national center health statistics say rate drug^the centers disease control prevention said investigating total cases states including^report fentanyl frequently found drug overdose deaths u.s. surpassing heroin according^the us centers disease control prevention national center health statistics say rate drug^the centers disease control prevention said investigating total cases states including^report fentanyl frequently found drug overdose deaths u.s. surpassing heroin according^david cassidy fighting memory loss wants 'enjoy life wate^vanessa marquez gained attention last year said george clooney helped blacklist hollywood d^prince harry meghan markle requesting understanding respect markle father reported,2,7,5,9,0.2222222222222222,0.5555555555555556,0
19422491,grantstern,10057,75829,926,127697,0,7,2,0,author books miami native mon -7pm writer heatlifer,"i put sherlock holmes cap wrote ,000 word story charts use trumprussia dossie^jared kushner damage american foreign policy middle east fifteen minute speech pe^i wrote story last march identifying april foreign policy speech mayflower hotel the^i published trumprussia dossier decoded yes there really was a massive oil deal last march st key point do^republican national committee chairman ronna romney mcdaniel conceded losing house seats midtermelection2018^michael cohen blocked writing story last june since quit role republican nationa^meet florida house victory candidates endorsed president barack obama florida house victory via^this million billion works miami mas davidbeckham forking over^this million billion works miami mas davidbeckham forking over",2,7,5,9,0.2222222222222222,0.5555555555555556,0
115564212,IsaacDovere,954,55450,1653,43290,1,7,1,0,staff writer the atlantic isaac at,i know you somebody gets things done better anybody. donald trump nancy pelosi no^snapshot world big foreign policy speech democracy assault authoritarian governments^american university message location foreign policy speech begin^warren finishes foreign policy speech invoking mitch mcconnell kind contribution brand the cha^today speech it ironic elizabeth warren chosen launch campaign with^senator could happen giving big speech foreign policy americans washington the^heard number dems standing convention floor philadelphia bloomberg convention speec^the president clearly watching tv news says n't care n't watch c^palin today part job requirement read news every day a,2,7,5,9,0.2222222222222222,0.5555555555555556,0
13947902,exclaimdotca,2554,53447,1040,71759,0,0,2,7,canada authority music film comedy,selena gomez reveals kidney transplant new instagram post^reveals kidney transplant new instagram post^courtney love warned women harvey weinstein way back^donald trump almost played president 'sharknado^justin timberlake announces the man woods tour^a night sweden reportedly resulted geazy getting arrested assault cocaine possession^lena dunham joins 'american horror story season^meryl streep joins cast 'big little lies season^beyonc weeknd eminem set headline coachella,2,7,5,9,0.2222222222222222,0.5555555555555556,0
26513255,wbznewsradio,1935,41299,1049,153980,2,7,0,0,boston news radio am hd-2 listen live stream app say `` play wbz newsradio iheartradio '',in true compromise bill came us senate nearly votes that bill came house repr^federal prosecutors charge nyc subway bomb suspect say wrote facebook trump failed protect nation^the next democratic presidential debate take place thursday night :00 university new hampshire durham wbz^just in white house vice president joe biden make statement rose garden^president obama eected make statement shortly rose garden irandeal watch live^mark zuckerberg resumes testimony house energy commerce committee^zuckerbergtestimony mark zuckerberg testimony house energy commerce committee^meat produced farmers maine going nationwide state department agriculture signed agreem^one man killed shooting dorchester last night four others wounded two shootings happe,2,7,5,9,0.2222222222222222,0.5555555555555556,0
17041374,wgbhnews,3367,29649,916,75563,2,7,0,0,local reporting analysis context massachusetts beyond story ideas tweet us email us wgbhnews.org,"former president george h. w. bush died friday political career spanned decades straddle^is recycling risk massachusetts our last glass recycling plant closed paper recyclable^the u.s. centers disease control prevention reporting five people died food poisoning aft^the latest sign pointing toward presidential run a speech laying vision populis^the latest sign pointing toward presidential run a speech laying vision populis^the u.s. department education sending emails ,000 people around country telling you 've g^the u.s. department education sending emails ,000 people around country telling you 've g^democratic challenger governor race i 'm former health insurance ceo thinks need get^washington ap white house vice president joe biden make statement rose garden",2,7,5,9,0.2222222222222222,0.5555555555555556,0
60017224,PeninsulaQatar,212,29441,970,189016,1,7,1,0,the official account the peninsula english daily newspaper qatar doha,now democrats control us house representatives need choose leader tha^the centers disease control prevention says popular kelloggs cereal linked salmonella out^worldhealthorganization head says n't need eerts centers disease control prevention or^trump lawyer rudygiuliani said president may open interview special counsel robertmueller even^donald trump lawyer rudygiuliani said special counsel robertmueller indicated willing narrow s^worldhealthorganization head says n't need eerts centers disease control prevention or^thirty six years losing parents sister four year old daughter one india worst sectarian m^president donaldtrump targeting china saying us longer tolerate unfair trade arrangements al^four new photographs princesscharlotte anmer hall..,2,7,5,9,0.2222222222222222,0.5555555555555556,0
26332143,SPECNewsBuffalo,418,22400,513,88256,0,6,2,1,spectrum news offers best -hour local news coverage buffalo plus weather sports favorite features,sen. schumer says years federal funding programs remained flat despite rise suicides acco^trading barbs campaign trail gop candidate governor mark molinaro new york become nation most^coming up delivers speech convention long island watch online^live vice president joe biden make statement rose garden watch gt^soon deliver remarks ny delegates philadelphia watch live^one year ago today ef tornado buzzed fairgrounds hamburgny weeks start th^gov cuomo says welcomes cynthia nin primary challenger but name recognition i^miss press conference update salt miners rescued lansing watch here gt via^icymi police say golf great tiger woods arrested dui charge florida,2,7,5,9,0.2222222222222222,0.5555555555555556,0
21766435,SPECNewsCNY,802,20548,510,93540,0,6,2,1,spectrum news offers best -hour local news politics weather coverage central new york southern tier,coming up delivers speech convention long island watch online^with lot stake lots issues facing northcountry nation hear three candida^live vice president joe biden make statement rose garden watch gt^headline obama speaks afl cio labor day picnic president obama cincinnati monday af..^headline obama address union labor day picnic president barack obama speaking health care..^soon deliver remarks ny delegates philadelphia watch live^if name recognition i 'm hoping brad pitt angelina jolie billy joel n't get r^miss press conference update salt miners rescued lansing watch full presser gt^in case missed aprilthegiraffe pregnant here see oliver excitement baby no with,2,7,5,9,0.2222222222222222,0.5555555555555556,0
39795556,RedDeerAdvocate,1521,11460,222,56141,0,0,2,7,local credible news red deer advocate team news tip let talk part,kim kardashian meeting trump prison reform^perspective bruce springsteen aging fine broadway^james franco denies sexual misconduct allegations^tiger woods arrested florida dui charge released tiger woods arrested early monday dui charge in^nelly criminal investigation u.k. alleged sexual assault^seth meyers host golden globes^colin trevorrow back direct jurassic world^judge declares mistrial bill cosby sexual assault case^pregnant april giraffe calf due march,2,7,5,9,0.2222222222222222,0.5555555555555556,0
343702041,KGNSnews,214,8195,157,82736,0,6,2,1,watch us kgns news app check livestream mykgnsnews,"the centers disease control prevention released shocking numbers last year flu season^potential democratic voters webb county came together watch presidential debate^the centers disease control prevention says cereal honey smacks linked salmonella outbrea^the centers disease control prevention released shocking numbers last year flu season^the u.s. department agriculture says ,000,000 pounds ground beef recalled due possible sa^police denver still working identify suspect following shooting left one person dead four ot^kim kardashian returned white house today meeting senior aides part administration ef^fairy tale castle host prince harry meghan markle modern royal wedding^bill cosby found guilty sexual assault retrial",2,7,5,9,0.2222222222222222,0.5555555555555556,0
32281597,NewsPolitics,7225,6724,250,81941,1,7,1,0,breaking news editor fmr managing editor boston native,melania trump undergoes kidney surgery walter reed medical center^sarah palin cpac speech trashes gop and karl rove calls obama liar reality star video^sarah palin cpac speech trashes establishment gop calls obama liar reality star full speech video^sarah palin cpac speech trashes establishment gop calls obama liar reality star video of full speech^obama spiraling job approval ratings complicate negotiations with congressional republicans column by^obama spiraling job approval ratings complicate negotiations with congressional republicans column by^watch live sarah sanders holds first white house press briefing since red hen controversy via^cia says it 'false claim white house blocked gina haspel from briefing saudi arabia via^nytimes public editor says larry david insensitive op ed my son the terrorist missed the mark,2,7,5,9,0.2222222222222222,0.5555555555555556,0
582128734,1037ChuckFM,42,219,14,13629,1,1,1,6,did know chuck plays everything all music commercials -noon check chuck,read transcript sen. jeff flake speech comparing pres donald trump josef stalin^read transcript sen. jeff flake speech comparing pres donald trump josef stalin^prince harry meghan markle a relationship timeline^tamar braxton files divorce husband manager vincent herbert^photos miss north dakota cara mund crowned miss america^photos miss nebraska sarah rose summers crowned miss usa^meghan markle dad heart surgery wo n't attend royal wedding report says^labor day deals sales macy walmart best buy^celine dion donates concert proceeds victims las vegas shooting,2,7,5,9,0.2222222222222222,0.5555555555555556,0
49616273,globaltimesnews,488,1570645,3075,121495,2,6,1,0,china national english language newspaper people daily apps,us house minority leader nancy pelosi celebrates democrats winning majority us house representative^us democrats success house representatives midterm election divide us politics c^by china carbon intensity amount carbon dioxide emissions per unit gdp dropped percen^us president donald trump delivers first state union address joint session congress washingto^us president donald j. trump made first address joint session congress washington dc cfp/ jim lo s^us president trump arrives speak support republican congressional candidate sacconne make america^us farmers see crops pile trade frictions continue sales soybeans china already^a solar magnetic field telescope located wenquan bortala xinjiang uyghur autonomous region observes sola^days royal wedding prince harry meghan markle several chinese media embroiled controver,3,6,3,9,0.3333333333333333,0.3333333333333333,0
19740592,Nightline,446,1207111,6460,54134,1,3,2,3,news nightline anchored :35am et,morning alleged attack nyc bombing suspect wrote trump failed protect nation facebook accordi^arrives hofstra university first presidential debate debates^war over whaling iceland one two countries world allow commercial whaling despite inter^alert news special report vice president biden makes statement rose garden^winfrey actively considering running president close friend gayle king says.^oprah winfrey actively considering running president close friend gayle king says^i regretted i really wanted walk aisle father meghan markle duchess sussex br^super bowl the good bad viral covers talked moments^every giraffe produced win species april giraffe gained prominence live stream,3,6,3,9,0.3333333333333333,0.3333333333333333,0
16675569,smh,656,757137,6311,186482,2,3,1,3,australia leading news source independent always,us house representatives speaker paul ryan seek election leave post start^breaking george h. w. bush st president united states father george w. bush died age^planning babymoon pregnancy covered one four travel insurance policies^comment the current government irrelevant one four voters n't event know federal governme^china stared donald trump trade war threat says retaliate us60 billion tariffs u^billy connolly 'wonderful brain 'dulled parkinson says tv legend^laura dern wins outstanding supporting actress limited series movie big little lies emmys^meghan markle scandal hit dad 'wo n't attend royal wedding^new england patriots quarterback tom brady among players skip white house visit,3,6,3,9,0.3333333333333333,0.3333333333333333,0
16935292,democracynow,6480,697388,17129,90536,1,4,2,2,independent daily global news hour anchored amy goodman juan gonz lez stream m-f am et support independent media donate today,george h.w bush died eve world aids day irony lost many hiv/aids activists remember^presidential hopeful shuns his new book fed up our fight save america washington^watch speaks named platform committee democratic national convention^white house bars cia chief briefing senators khashoggi murder jamalkhashoggi^white house blocks cia director from briefing senate khashoggi murder jamalkhashoggi^threat nuclear war escalates trump warns north korea fire fury^today we spend hour journalist co author week major investigation revea^icymi former fox news ceo roger ailes dead^weinstein company file bankruptcy metoo,3,6,3,9,0.3333333333333333,0.3333333333333333,0
44900997,nigeriantribune,63,228241,463,678150,3,6,0,0,nigeria oldest informative news medium publishing articles politics business sports op-ed others,house reps seeks us support repatriating nigeria stolen funds the house representatives yesterday ...^reps seek us support repatriating nigeria stolen funds the house representatives yesterday sought ...^morgue employee cremated mistake taking nap^cia says white house prevent gina haspel briefing senate nigeriantribune^cia says white house prevent gina haspel briefing senate nigeriantribune^cia says white house prevent gina haspel briefing senate nigeriantribune^cia says white house prevent gina haspel briefing senate nigeriantribune^cia says white house prevent gina haspel briefing senate nigeriantribune^cia says white house prevent gina haspel briefing senate nigeriantribune,3,6,3,9,0.3333333333333333,0.3333333333333333,0
34580330,edinburghpaper,2404,157344,1104,137282,0,3,3,3,first news sport edinburgh lothians established follow us facebook,meet gizmo pug star edinburgh firms latest ad campaign^the royal bank scotland issued striking visual reminder scots stay safe online research reveals^the royal bank scotland issued striking visual reminder scots stay safe online research reveals^the teenage cellist played wedding prince harry meghan markle perform edinburgh inte^coming home billy connolly making major new bbc series scotland^david beckham due go trial alleged speeding offence^justin timberlake announces scottish date 'man woods uk tour^justin timberlake announces scottish date 'man woods uk tour^justin timberlake announces scottish date 'man woods uk tour,3,6,3,9,0.3333333333333333,0.3333333333333333,0
228981999,DubaiOneTV,67,134398,393,23933,0,0,3,6,dubai one english language channel caters arabs/non arab audience uae arab world,justinbieber upset ex girlfriend selenagomez continue seek treatment mental health facility.^bradpitt committed stunts set latest film adastra dubaionetv^trial date set bradpitt angelinajolie custody battle december dubaionetv^on occasion international women day iwd2018 modernfamily star sofiavergara partners inspirational^oprahwinfrey matches georgeclooney amalclooney 500k donation march our lives movement dubaionetv^the clooney foundation justice raises 2.25 million open schools syrian refugees dubaionetv^michael fassbender alicia vikander married dubaionetv^zaynmalik gigihadid announce break years dating dubaionetv^zaynmalik spotted wheelchair due leg injury dubaionetv,3,6,3,9,0.3333333333333333,0.3333333333333333,0
33142966,FOX40,576,123842,1052,182100,0,5,3,1,unique storytelling breaking news jim crandell exclusive sports news covering northern california sacramento stockton modesto tips news.com,these victims chicago mercy hospital shooting^these victims chicago mercy hospital shooting^these victims chicago mercy hospital shooting^these victims chicago mercy hospital shooting^gov brown newsom meet press discuss wildfire devastation^kellyanne conway plug from white house go buy ivanka stuff^north korea vows strikes us trump warns fire fury^mariah carey new year eve performance they foiled me^after years kermit frog getting new voice,3,6,3,9,0.3333333333333333,0.3333333333333333,0
17002185,nytmedia,16,73935,3045,21612,0,2,3,4,links breaking news commentary analysis media advertising industries the new york times,the morning president rally missouri house complaints anchors reporters br^it subtle exchange unusual show solidarity rival journalists white house briefing spo^hoda kotb replace matt lauer co host nbc flagship morning program today^hoda kotb longtime co host fourth hour nbc morning franchise today replace matt lauer^caitlyn jenner publish memoir about her transformation^walmart said plan remove cosmopolitan checkout lines business decision a nonprofit group taking^the weinstein company yet file bankruptcy leaving open possibility however unlikely two^the weinstein company yet file bankruptcy leaving open possibility however unlikely two^joe scarborough mika brzezinski co hosts morning joe engaged,3,6,3,9,0.3333333333333333,0.3333333333333333,0
21216178,starvancouver,3294,64784,1298,55916,0,2,3,4,local stories covered journalists live plus best investigations opinion national international news,he hero the orlando police department honoured pulse valor award invited trump s^the teamsters international brotherhood electrical workers told cprail posi^is meghan markle already miserable royal we tongue cheek scoop tabloids^summon trumpeters town criers meghan duchess sussex child you heard first that^summon trumpeters town criers meghan duchess sussex child you heard first that^did know meghan markle brief case carrying model deal no deal howie mandel ca n't remembe^prince charles walk meghan markle aisle royal wedding stepping father br^prince charles walk meghan markle aisle royal wedding stepping father br^what you president why tweeting jimmy fallon responded donald trump,3,6,3,9,0.3333333333333333,0.3333333333333333,0
2394806707,RScountry,667,54154,348,20339,0,0,3,6,music news exclusive interviews original videos things country music,golden globes the complete winners list^the avril lavigne death hoax that wo n't die^see faith hill gospel rave up aretha franklin funeral^neil diamond retires from touring after parkinson disease diagnosis^kelly clarkson 'when i was really skinny i wanted kill myself^cma awards the complete winners list^cmt music awards the complete winners list^roger ailes former fox news ceo dead^lady gaga announces las vegas residency,3,6,3,9,0.3333333333333333,0.3333333333333333,0
37119756,981THEBULL,98,44237,123,19106,0,0,3,6,better country the bull wbul we play minute bull rides day officer don deann weekdays a-10a bettercountry iheartcountry,carrie underwood forced mike fisher to retire for second baby^miranda lambert refuses to talk politics 'you ca n't win anyway^musicians react mel tillis death^here how help victims las vegas mass shooting^kelsea ballerini marries morgan evans mexico^ryan seacrest named kelly ripa new 'live co host^cmt music awards winners see the complete list^billboard music awards nominations see full list of bbmas nominees^taylor swift announces new album 'reputation,3,6,3,9,0.3333333333333333,0.3333333333333333,0
37535548,WalidPhares,63,42593,548,18094,3,6,0,0,fox news national security foreign policy eert co-secretary general transatlantic parliamenary group advisor professor author,the leadership forthcoming house representatives elect strike bill advanced republicans^with former speaker us house representatives us international delegations iranian oppo^my continuous commentary post midterm foreign policy the next years shaped opposition maj^:30 am est tomorrow friday discuss interview on^mp edouardo conducted first interview on^i commenting singapore summit sunday pm est^first brazilians vote president sunday if elect fight terr^the main pillars led singapore us5thfleet dialogue china tune sunday^chair middle east americans trump john hajjar mayor rudy giuliani campaigning new hampshire ...,3,6,3,9,0.3333333333333333,0.3333333333333333,0
18690078,FOX46News,1209,29585,499,101927,1,3,2,3,thank stopping fox46 -- place go local stories breaking news weather updates sports email newstips46.com,tepper i kind wake sometimes say 'thank god it i say god bless ameri^update rnc in clt the republican national committee approves charlotte official host rnc2020^the convention held august august dates set republican national co^the hashtag boycottcharlotte emerged republican national committee selected queen city offici^tmz kylie jenner pregnant travis scott baby^new royal on the way announced prince harry meghan markle eecting first child in^actor vince vaughn arrested suspicion dui resisting arrest manhattan beach checkpoint^royal wedding update prince charles walk meghan markle aisle royal wedding stepping afte^royal wedding update prince charles walk meghan markle aisle royal wedding stepping afte,3,6,3,9,0.3333333333333333,0.3333333333333333,0
27863115,metronewyork,7218,28056,875,45744,0,2,3,4,news sports gossip new york favorite free daily newspaper,these popular baby names state^map shows popular baby names state last years^here winners red carpet looks amas^hailee steinfeld get think dating justin bieber same^awesome sounding robert pattinson robert de niro olivier assayas film cancelled^surprise outlander star caitriona balfe engaged^everything know far american horror story season^everything need know freeform nights halloween schedule^breaking former fox news ceo roger ailes dead,3,6,3,9,0.3333333333333333,0.3333333333333333,0
237851661,NewsweekUK,1250,22875,911,52160,0,4,3,2,newsweek international premium weekly news magazine website bringing high-quality journalism readers around globe years,full transcript democratic debate miami the two democratic presidential candidates met miami on^read full transcript second u.s. presidential debate st louis missouri^read full transcript third final u.s. presidential debate^full transcript democratic debate miami the two democratic presidential candidates met miami on^is ben affleck quitting batman pushed^chloe grace moretz says appalled body shaming poster film 'red shoes amp the dwarfs'^meghan markle next move 'suits moving u.k. prince harry engagement says royal eert^hugh hefner cause death revealed^is sarah paulson going play princess diana 'feud,3,6,3,9,0.3333333333333333,0.3333333333333333,0
246361151,975WAMZ,100,5556,56,17165,0,2,3,4,a bunch friends love country music amazing kentuckiana derby city home wamz iheartcountry,state of the union from eric church^state of the union from eric church^carrie underwood forced mike fisher to retire for second baby^miranda lambert refuses to talk politics 'you ca n't win anyway^musicians react mel tillis death^kelsea ballerini marries morgan evans mexico^ryan seacrest named kelly ripa new 'live co host^cma awards the complete list winners amp nominees^billboard music awards nominations see full list of bbmas nominees,3,6,3,9,0.3333333333333333,0.3333333333333333,0
37034483,ndtv,13,11725362,12336,646894,0,3,4,2,breaking news alerts india,coming watch special election episode the big fight partnership twitter india tonight pm^there insinuations effect india involved threat president the president^juvenile convicts ca n't get death every rape murder top court judge^outside hospital kate middleton gave birth royal prank involving queen^for years george clooney claimed n't want kids twins^for years george clooney claimed n't want kids twins^britain prince harry duke sussex waves arrives st george chapel windsor castle wedding^bill cosby sexual assault case jury deadlocks judge declares mistrial ndtvnewsbeeps^bill cosby sexual assault case jury deadlocks judge declares mistrial,4,5,1,9,0.4444444444444444,0.1111111111111111,0
39453212,gmanews,700,5446047,8893,631075,1,1,3,4,welcome official twitter account gma news philippines,former speaker alvarez we undo past certainly shape future the house representative^live the final presidential debate republican candidate democratic candidate^ben affleck rumored quitting batman role^brad pitt wave starting flag year le mans hour car race june^lindsay lohan make us tv comeback mtv reality series^prince harry asks big brother william best man wedding^britain prince harry wanted royal family^taylor swift announces new album 'reputation week court victory^details meghan markle prince harry wedding rings revealed royalwedding,4,5,1,9,0.4444444444444444,0.1111111111111111,0
14697575,News24,2933,3024964,4801,288173,1,0,3,5,south africa premier online news resource follow action journalists sa trusted news source reuters institute,former us president george w. bush died age^brad pitt start le mans race^celebrities react death linkin park singer chester bennington^celebrities react death linkin park singer chester bennington^tina turner son craig dead apparent suicide^news24 icymi henri van breda spotted airport meghan markle dad wo n't attend royal^pics game thrones stars kit harington rose leslie married^judge declares mistrial bill cosby sexual assault case^kylie jenner pregnant reports according online reports kylie jenner pregnan ...,4,5,1,9,0.4444444444444444,0.1111111111111111,0
2172922045,OnePerfectShot,3190,495736,5013,152303,0,1,4,4,eloring beauty splendor film television one shot time the articles also free,it funnier believing one hundred percent^fury 2014 dp roman vasyanov director david ayer buy rent via amazon^if 've ever wished sean penn ejected planet hulu new show^into the wild 2007 dp eric gautier director sean penn buy rent via amazon^shooting sean penn space ... interesting idea^ready player one 2018 dp janusz kaminski director steven spielberg read watch 'ready player one then watch^what steven spielberg really think 'the shining find answer plus goodies list of^who wants watch steven spielberg jiggle member berries our review 'ready player one^ready player one 2018 dp janusz kaminski director steven spielberg read watch 'ready player one then watch,4,5,1,9,0.4444444444444444,0.1111111111111111,0
354838265,RepublicaNepal,45,271668,543,154267,0,4,4,1,official twitter feed english news portal nepal republic media pvt ltd. leading media house,opinion why parliamentary system the debate directly elected presidential system demeans disdains denigr^an animalrights group sued us department agriculture claiming blocked release information^us tariffs 34 billion chinese imports took effect deadline passed friday beijing vows respo^the us canada among top trade partners exchanging nearly us700bn goods services last^ed sheeran weighs taylor swift katy perry feud^ed sheeran weighs taylor swift katy perry feud^president kim kardashian next hollywood terrified donald trump victory^president kim kardashian next hollywood terrified donald trump victory^prince charles walk meghan markle aisle tomorrow royal wedding dad thomas pulled o,4,5,1,9,0.4444444444444444,0.1111111111111111,0
26793734,EsquireUK,1583,103779,1691,52655,0,2,4,3,the official twitter destination style substance,here the full transcript of obama speech calling out trump^here the full transcript of obama speech calling out trump^carrie fisher mark hamill and harrison ford talk their star wars love triangle in this long lost empire strikes b^brad pitt leonardo dicaprio amp quentin tarantino are fighting for millions owed by the weinstein company^critics are losing it for lady gaga and bradley cooper in a star is born^jennifer lawrence stills feels terrified following nude photo hack^'stranger things season everything we know so far^alicia vikander and michael fassbender are getting married and we 're happy for them honestly^daniel craig finally confirms he will play james bond again,4,5,1,9,0.4444444444444444,0.1111111111111111,0
26447054,WHOmagazine,2480,61354,354,13165,0,0,4,5,follow latest breaking celebrity news photos,this week who meghan amp harry ready baby the bachelor australia exclusive cheating secrets baby ne^reveals split blakeshelton mirandalambert gwenstefani^this week who jennifer aniston confirms big news george amal clooney twins turn one kendall jenner au^jessica simpson is pregnant again report^it official confirms i 'm pregnant again^bachelor ben higgins breaks silence following split lauren bushnell^reasonswhy renewed season^ben affleck jennifer garner officially file divorce^james bond star sir roger moore dead,4,5,1,9,0.4444444444444444,0.1111111111111111,0
119802433,data_nerd,13347,54508,3925,322651,2,3,2,2,data scientist nerd rt equal endorsement love sharing info datascience wit analytics,snapchat shutting down by end is a viral hoax terovesalainen pixabay reports snapchat anno ...^no puke pay snapchat shutting selfie lens store friday^breaking down sixth republican presidential debate for first time year republican presidential ...^declining confidence trump lower job ratings congressional leaders^us department agriculture recalls turkey products thanksgiving near business insider^dancing stars vanessa lachey maks chmerkovskiy dance empowering cha cha woman^trevor noah of the daily show being shot dead while greeting fans after concert is a death hoax^dancing stars jordan fisher lindsay arnold win season mirrorball trophy^your holiday binge watching guide netflix originals i love good netflix binge watch so weather ...,4,5,1,9,0.4444444444444444,0.1111111111111111,0
22568416,YahooCanadaNews,248,23944,719,74652,0,2,4,3,keeping informed entertained,watch live addresses orlando mass shooting^live soon address orlando mass shooting^annoyed refuses rest seems miserable says source^ashton kutcher calls tabloid cheating story 'these magazines lack integrity^reveals laying low earlier summer kidney transplant^faith hill roasted paying tribute aretha franklin^boyfriend ben hanisch split almost years dating^congratulations order reportedly pregnant first child^announces new album reputation november first single released tomorrow,4,5,1,9,0.4444444444444444,0.1111111111111111,0
80852229,985wkrz,1595,9242,127,31147,0,0,4,5,we play today best music wilkes-barre scranton the poconos northeast pa,ed sheeran weighs in taylor swift katy perry feud via^rumors swirling dating robert pattinson see the photo everyone talking^ed sheeran weighs in taylor swift katy perry feud via^icymi complete list grammy winners^yay it official becca kufrin is next bachelorette via^have mercy uncle jesse eecting first child fianc e caitlin mchugh gt^jennifer lawrence single details split director boyfriend /^richard simmons hospitalized severe indigestion details^announced going return new halloween movie next year,4,5,1,9,0.4444444444444444,0.1111111111111111,0
44366963,969thekat,4911,9154,137,35221,0,0,4,5,charlotte new country home mornings listen,watch monday 'll see official performance new duet^carrie underwood forced mike fisher to retire for second baby^miranda lambert refuses to talk politics 'you ca n't win anyway^musicians react mel tillis death^kelsea ballerini marries morgan evans mexico^tom brady criticized for kissing his son on the lips^april the giraffe finally gives birth it a boy we 've got it^cma awards the complete list winners amp nominees^'superman star margot kidder dead at,4,5,1,9,0.4444444444444444,0.1111111111111111,0
52832357,LIMHOF,1065,3193,90,19059,0,0,4,5,our mission celebrate recognize preserve rich music heritage li the long island music hall fame c 3 organization,long island lindsay lohan^james brolin reflects years marriage with barbra streisand exclusive ...^james brolin reflects years marriage with barbra streisand exclusive ...^clive davis gives superstar a list memorial day party judy collins rob thomas regis philbin david foster^neil diamond retires from touring after parkinson disease diagnosis^dancing with stars debbie gibson gets emotional first big performance since lyme disease diagnosis ...^watch nicki minaj open billboard music awards with star studded medley ...^jennifer lopez talks about reinvention self acceptance new beginnings ...^debbie gibson dancing with stars healed me more than any doctor ...,4,5,1,9,0.4444444444444444,0.1111111111111111,0
35279836,SOUNDCITYtv,23,607173,562,48567,0,0,5,4,the no.1 music lifestyle tv w/ radio network poweredbymusic available everywhere tv x radio x digital watch dstv ch gotv ch x app,which nominees best male category soundcitymvp lines song ghana girl say^in best female category soundcitymvp one nominees song mr p releas^remain hospital indefinitely^gameofthrones star sophie turner is engaged joe jonas i guess y'all n't know dating here^selena gomez suffered emotional breakdown here^second suspect xxxtentacion murder case has been arrested news^second suspect xxxtentacion murder case has been arrested news^soundcityscoop mac miller ariana grande longer thing report say two artists decided^taylor swift announces release date of album reputation new single out today,5,4,-1,9,0.5555555555555556,-0.1111111111111111,1
1220875086,NewDelhiTimes,170,188449,102,106745,0,1,5,3,new delhi times india newspaper providing editorial based reporting since new delhi newdelhitimes newsdelhi,ad firm worked cordray agency governor campaign^david cassidy fighting memory loss wants enjoy life^trump warns fire fury north korea threats don stop^katy perry avoids raunchy stage shows due cellulite^george clooney wife amal welcome twins ella alexander^singer jessica simpson gives birth to a boy^james franco denies sexual misconduct allegations^reports say kylie jenner pregnant first child^pregnant april giraffe calf due march,5,4,-1,9,0.5555555555555556,-0.1111111111111111,1
47618120,KiSS925,481,111510,765,242523,0,0,5,4,win home roz mocha sequoia grove homes,goldenglobes best actress limited series tv movie nicole kidman big little lies jessica lange feud be^rozandmocha chat meghan markle nephew new strain weed named royal course^kendall jenner broke tears called f* amp ing stupid asked pepsi commercial debacl^meghan markle might moving kensington palace prince harry 're slightly freaking out^justin bieber selena gomez soulmates case closed^if think blame mac miller problems got something say and a^luke skywalker returns cockpit millennium falcon new trailer star wars the last jedi^reports say pregnant^jennifer lawrence reportedly auditioned role serena gossip girl the role course went bl,5,4,-1,9,0.5555555555555556,-0.1111111111111111,1
112240656,screening,238,67017,1817,45074,0,0,5,4,entertainment obsessed movies television best hollywood sign newsletter,solange tweets serious shade grammys beyonc snub^drake publicly upset justin bieber selena gomez n't together^no beyonc get lip injections rep calling 'cowards^chlo grace moretz shocked 'red shoes ...^donald trump impressed stephen colbert 'filthy jokes^josh brolin joins 'deadpool sequel beefcake mutant cable^leonardo dicaprio reportedly star new quentin tarantino movie charles manson^in case missed reasonswhy officially renewed season start freaking^harry styles facetimes james corden announce week long 'late late show residency,5,4,-1,9,0.5555555555555556,-0.1111111111111111,1
24430861,HOLLYWIRE,4074,56960,522,42988,0,0,5,4,hollywood trendiest source lifestyle celebrities entertainment ig hollywire snapchat hollywiretv,celebrities react donald trump inauguration gt^celebrities react donald trump inauguration gt^did miley cyrus liam hemsworth cancel bora bora honeymoon^this never end are brad pitt amp angelina jolie actually stealing jennifer aniston wedding date^double date new movie thoughts guys meyers spotted dinner tonight jenniferaniston w new brown bob amp selena gomez^icymi stranger things star shannon purser comes bisexual^stranger things star shannon purser comes bisexual^netflix chill holiday movies to binge watch^netflix chill holiday movies to binge watch,5,4,-1,9,0.5555555555555556,-0.1111111111111111,1
166141649,YahooStyleUK,11553,26961,497,65286,0,0,5,4,your ultimate fashion beauty health life food fix plus royal news handle,with news royal engagement could imminent timeline prince harry meghanmarkle rela^has banned anna wintour^catch everyone wearing venicefilmfestival dakotajohnson ladygaga^icymi dakotajohnson rocked venicefilmfestival wearing checked official trouser suit drea^in light kyliejenner secret pregnancy 've rounded celebrities also kept newborns away f^pregnant i excited son^these all beauty essentials need festival season beauty festival^all details prince harry meghan markle wedding cake claire ptak behind the^prince william prince harry best man royal wedding,5,4,-1,9,0.5555555555555556,-0.1111111111111111,1
1612474406,MirrorRoyal,147,10799,218,14401,0,0,5,4,official daily mirror royal account follow depth news updates listen podcast podsavethequeen showbiz,meghan markle dad 'may told happy news^meghan markle words duchess thinks love work happiness^meghan markle words duchess thinks love work happiness^meghan markle looks happy relaxed boards flight fiji harry royaltour^meghan markle secret wild partying past could rival even prince harry^everything know far princess eugenie royal wedding jack brooksbank^meghan markle join prince harry pippa middleton wedding venue 'marry harry tv show set^details revealed prince harry meghan markle wedding rings^details revealed prince harry meghan markle wedding rings royalwedding,5,4,-1,9,0.5555555555555556,-0.1111111111111111,1
24734092,1045theriver,825,2801,59,25456,0,0,5,4,memphis continuous soft rock mornings ronandkaren memphis choose901 choose1045theriver,jennifer aniston invited brad pitt mom upcoming wedding did brad mom accept invite find :08 dirt alert^the police called brad pitt angelina jolie kids more dirt alert :08 mandy^did brad pitt angelina jolie get married we 'll fill :08 dirt alert mandy^are brad pitt angelina jolie getting married weekend mandy dirt alert :08^icymi complete list grammy winners^behind scenes acmawards ... .. everything you did n't see tv acm awards via^pink radio cover gt gt gt gt grammy winner pink graces cover people beautiful issu^congrats gt gt chrissy teigen gives birth baby no with john legend via^have mercy uncle jesse eecting first child fianc e caitlin mchugh gt,5,4,-1,9,0.5555555555555556,-0.1111111111111111,1
17710740,dna,371,2058311,3666,554090,2,1,4,2,follow us news photos videos latest trends india around world,aruna miller fray nd indian american woman enter us house representatives^sixteen us house democrats oppose nancy pelosi bid become speaker house representatives^four captains reported 'approach icc anti corruption unit last one year^are george clooney amal alamuddin headed 300 million divorce^jennifer aniston 'baby news absurd gossip^christina aguilera engaged boyfriend matt rutler^is kim kardashian jealous half sister kylie jenner^prince harry asks elder brother william best man wedding meghan markle^royal wedding meghan markle father walk aisle,6,3,-3,9,0.6666666666666666,-0.3333333333333333,1
68577507,jakpost,7,843824,3753,218591,0,1,6,2,always bold always independent,'dinosaur country fossil hunters south african paradise jakpost^chadwick boseman why 'black panther needed african accent jakpost^trump warns north korea 'fire fury jakpost^the crowd pleasing power pop diva celine dion jakpost^channing tatum wife jenna dewan tatum announce split jakpost^angelina jolie divorce brad pitt i enjoy single jakpost^lindsay lohan make us tv comeback mtv reality series jakpost^britain prince harry asks elder brother william best man wedding^'nypd blue creator steven bochco dead jakpost,6,3,-3,9,0.6666666666666666,-0.3333333333333333,1
225096034,TheMarySue,1373,85536,2777,81443,0,0,6,3,geek girls guide galaxy,everyone learn love especially comes watching loving star wars episode viii the last jedi^things we saw today sean penn mission mars hulu the first^kristen stewart takes down trump awesomely declares she so gay dude on saturday night live^responds terrible fat shaming red shoes dwarfs ad^chlo grace moretz responds terrible fat shaming red shoes dwarfs ad^the latest aquaman trailer gives us trident wielding nicole kidman^jada pinkett smith calls representation all eyez me inaccurate amp deeply hurtful^we anxious about reasonswhy being renewed season^we anxious about reasons why being renewed season,6,3,-3,9,0.6666666666666666,-0.3333333333333333,1
2976653309,IndyUSA,167,35911,705,52333,2,1,4,2,news comment features the us team,the democrats house representatives what actually mean^the democrats house representatives what actually mean^us department agriculture agency told 'avoid using term climate change^this royal title duchess cambridge receive prince william becomes king^this royal title duchess cambridge receive prince william becomes king^the crown cast new prince charles queen mother^the crown cast new prince charles queen mother^louis ck accused sexual misconduct five women^pirelli calendar stars gigi hadid misty copeland empowering women pursue dre,6,3,-3,9,0.6666666666666666,-0.3333333333333333,1
24143580,Magic899,142,710699,1500,77015,0,0,7,2,your favorite radio station. say hello djs listen live link bethemagic,tswizzle fans 'look what you made me do meant^confident demi lovato the rumoured reason kate hudson dumped nick jonas his tour demi lovato ...^miley cyrus really regrets her 'wrecking ball video^happy birthday super misses na come visit soon yes everythingsmagic^this guy showed kylie jenner prom go turned somebody else^this kid got turned prom brought kylie jenner instead^top5at5 monday kick headabovewater shallow bradley cooper^oof miles teller got arrested drunk public^in case missed here the most talked about moments from super bowl,7,2,-5,9,0.7777777777777778,-0.5555555555555556,1
39008044,EBONYMag,2350,414849,2608,87291,0,1,7,1,ebony iconic innovator black culture since ebony magazine shined spotlight worlds black people america worldwide our co,former republican national committee chairman michael steele went say believe trump demeanor is^leslie jones says stop holding comedians standard stop our job make ugliest stuff f^michael strahan co host third hour good morning america gma gmaday blackexcellence^ix9ine amp ye filming scenes 80m estate song upcoming project also features nicki m^i would lying i said drake amp i n't conversation seeing relief got t^michael strahan co host third hour good morning america gma gmaday blackexcellence^*again kanye west released several videos visiting africa well sharing thoughts mind con^reports claimed harveys headed divorce steve allegedly leaving wife kardash^kevin hart wife eniko parrish eecting first child together,7,2,-5,9,0.7777777777777778,-0.5555555555555556,1
2463511302,PulseGhana,376,84624,272,149757,1,0,6,2,ghana new media publisher /7 live news videos entertainment sports lifestyle celebrities to advertise email ads.com.gh,the new york bombing suspect wrote 'trump failed protect nation facebook right attack^video kim kardashian welcomes third child kanye west pulseghana pulsetv^prince william camilla duchess cornwall catherine duchess cambridge royalwedding pulseghana^prince william camilla duchess cornwall catherine duchess cambridge royalwedding pulseghana^peter berg hollywood producer defends nasty meme post caitlyn jenner m gt^caitlyn jenner top hollywood producer slams star nasty meme m gt^odd enough kate middleton cut hair people freaking^blac chyna model granted temporary restraining order rob kardashian^entertainment craig mack 'flava ya ear rapper dead,7,2,-5,9,0.7777777777777778,-0.5555555555555556,1
23624320,Edmontonsun,4110,77408,778,112656,0,0,7,2,for years kept dedication quality offers readers must-read content every day the best coverage edmonton alberta canada,more evidence justin bieber hailey baldwin already married^more evidence ace ventura ... err ... justin bieber hailey baldwin already married^nicole kidman trump 'we country need support whoever president^'they foiled mariah carey weighs disastrous new year eve performance^teri hatcher i 'm broke homeless^teri hatcher i 'm broke homeless^jennifer lawrence swears sex terrified getting sti^'storm chasers star joel taylor dead^bradley cooper girlfriend irina shayk welcome first child,7,2,-5,9,0.7777777777777778,-0.5555555555555556,1
111556877,Femail,805,59633,786,58000,0,0,7,2,fashion beauty health food relationship news daily mail femail teams london new york sydney follow us instagram,cheeky twitter users imagine meghan markle 'jealous reaction kate middleton newborn baby^mother compare very candid post birth photos kate middleton perfect appearance left hospital^selena gomez fans left terrified 'creepy new music video^viewers left frustrated footage meghan markle wedding veil repeated second episode of^sailor brinkley cook looks sensational julia roberts pretty woman character^are dakota johnson chris martin dating^meghan markle friend priyanka chopra says royal wedding like real 'fairy tale generation^deal no deal host howie mandel says n't remember meghan markle show^meghan markle admits 'misses acting suits,7,2,-5,9,0.7777777777777778,-0.5555555555555556,1
18124654,breatheheavycom,347,45967,602,49697,0,0,7,2,pop music news blog w breaking music news exclusive interviews world premieres inquiries breatheheavydotcom.com,asked rate talented least w^kendrick lamar bruno mars ed sheeran lead pack nominations apiece billboard music awar^selena gomez reveals kidney transplant treat lupus^selena gomez reveals kidney transplant treat lupus read emotional letter^keep^sorry garbage compared to^salute flawless stan high at^spotted beyonce made surprise appearance sports illustrated sportsperson year ceremony present s^kendrick lamar bruno mars ed sheeran lead pack nominations apiece billboard music awar,7,2,-5,9,0.7777777777777778,-0.5555555555555556,1
19046500,PostStyle,169,17884,796,26095,0,0,7,2,news features washington post style section follow team,kylie jenner mystery pregnancy might confusing kardashian situation ever^meghan markle prince harry wedding drama faq all gossip really want know^meghan markle prince harry wedding drama faq all gossip really want know^for years george clooney claimed n't want kids now twins^kim kardashian returned white house another meeting prison reform^meghan markle prince harry wedding drama faq all gossip really want know^kylie jenner mystery pregnancy might confusing kardashian situation ever^bristol palin joins cast mtv teen mom og ten years pregnancy tripp^billboard music awards top moments drake celine dion complete list winners,7,2,-5,9,0.7777777777777778,-0.5555555555555556,1
43993601,Grav1,1871,3438,244,51630,7,2,0,0,communication consultant partnercomm former houston chronicle politics editor eeputy managing editor fort worth star-telegram proud grandpa cajun,back 'real world texas politics state ag chief sid miller wo n't face charges jesus shot txlege^just one time texas agriculture commissioner rick perry backs second term current ag commish sid miller^battle texas ag commissioner continues trey blocker message falls flat mclennan county debate incu^icymi texas ag commissioner sid miller catches heat appointing maverick revoked medical licenses hea^for weekend listening pleasure ... this week edition texas take podcast joe barton sex pics sid^controversial gop incumbent says challenger 'does n't know first thing agriculture trey blocker takes on^there goes texas ag comish sid miller shares fake news story muslim judge trumpets trump takin^white house statement santafe attack 'president trump spoke texas gov greg abbott offer condolenc^former president george w. bush calls painting life passion interview daughter,7,2,-5,9,0.7777777777777778,-0.5555555555555556,1
187990554,zacharykussin,1717,2472,87,17861,0,1,7,1,award-winning features reporter once mall goth always mall goth opinions zkussin.com,criminal inquiry sought hillary clinton use email deleter free world^pregnant khlo 'went ballistic found tristan cheating via^jennifer lopez jokes 'no pressure alex rodriguez propose via i rea^sofia richie kourtney kardashian post competing thirst traps via i sure love news^sofia richie kourtney kardashian post competing thirst traps via i sure love news^sofia richie kourtney kardashian post competing thirst traps via i sure love news^sofia richie kourtney kardashian post competing thirst traps via i sure love news^sofia richie kourtney kardashian post competing thirst traps via i sure love news^michael jackson musical coming broadway via,7,2,-5,9,0.7777777777777778,-0.5555555555555556,1
19407788,1031KCDA,755,1274,58,13978,0,0,7,2,the best mix now,robert pattinson on movie roles 'people are trying to put you in a box^jamie foxx katie holmes finally out public as couple^celebrity reactions donald trump phoenix rally speech^celebrities react to hurricane irma^justin bieber dating singer actress hailee steinfeld^kim kardashian slams 'invasive surrogacy reports^jimmy fallon felt need to share 'heartfelt message about charlottesville^bachelor nick viall vanessa grimaldi split end engagement^taylor swift announces new album 'reputation see the cover art,7,2,-5,9,0.7777777777777778,-0.5555555555555556,1
373854960,emirateswoman,14,23803,155,11996,0,0,8,1,lifestyle fashion women middle east,the philanthropic penned one powerful essay angelinajolie^congratulations princeharry meghanmarkle happy news^meghan duchess sussex saw first birthday royal weekend celebrating another joyous occasion^the philanthropic penned one powerful essay angelinajolie^meghan duchess sussex saw first birthday royal weekend celebrating another joyous occasion^the philanthropic penned one powerful essay angelinajolie^the philanthropic penned one powerful essay angelinajolie^the philanthropic penned one powerful essay angelinajolie^priyanka chopra nick jonas engaged two months dating according reports,8,1,-7,9,0.8888888888888888,-0.7777777777777778,1
742143,BBCWorld,71,25849569,115039,300050,1,3,0,4,news features analysis world newsroom breaking news follow uk news latest sports news,denzel washington hit facebook fake news story trump^read full transcript exclusive interview us president barack obama^un high commission refugees warns situation libya border tunisia reaching 'crisis point afp^australian sunglasses firm apologises jasenovac ad campaign^it boy the moment april giraffe finally gives birth^watch moment april giraffe finally gives birth^justin bieber cancels remaining purpose world tour dates^lady gaga announces two year las vegas residency,1,7,6,8,0.125,0.75,0
18927441,IGN,908,7179084,24085,121120,0,2,1,5,we video games movies tv comics,the guardians galaxy cast released statement monday supporting former director james gunn h^icymi the main cast guardians issued statement supporting james gunn many calling t^how batman robin changed george clooney career^the walking dead season promotes three actors series regular status thewalkingdead^the cw fall premiere dates revealed including theflash arrow^good news outlander fans show renewed seasons bonus get sneak peek^the weinstein company file bankruptcy^watch steven spielberg use htc vive direct ready player one,1,7,6,8,0.125,0.75,0
878247600096509952,RealCandaceO,9,1703904,4866,3062,0,7,1,0,my book blackout available amazon barnes noble kindle,today represent watershed moment american history at :00pm et i deliver black state uni^black state union address bsotu^today represent watershed moment american history at :00pm et i deliver black state uni^black state union address bsotu^black lives matter launched war police officers colin kaepernick led effort disrespect troops and^today represent watershed moment american history at :00pm et i deliver black state uni^black state union address bsotu^not sure keeps blocking non controversial video i try ... when coverage regar,1,7,6,8,0.125,0.75,0
222436278,breakfastclubam,316,618321,1464,67648,0,0,1,7,dj envy angela yee charlamagne tha god the world most dangerous morning show listen podcast iheartradio,we retired jersey since divorce back ... reinducting kim kardashian hoe hall fame^the th suspect xxxtentacion murder finally arrested trayvon newsome charged murder i^the th suspect xxxtentacion murder finally arrested trayvon newsome charged murder i^stacey dash running congress california^rumorreport gt gt tiffany haddish cries after oprah surprises her the ellen degeneres show gt gt^year pop star announces las vegas residency launched december^demilovato remains hospitalized after suffering complications apparent overdose gt gt gt^rumorreport ving rhames says police held gunpoint home gt gt,1,7,6,8,0.125,0.75,0
36511031,SFGate,872,476324,6457,150246,0,2,1,5,twitter home the authority things san francisco bay area,most popular baby names every u.s. state last year^most popular baby names every u.s. state last year^kim kardashian visits trump talk prison reform^keri russell early talks join star wars episode ix cast^jesse camp former mtv vj reported missing riverside^julia louis dreyfus diagnosed breast cancer^julia louis dreyfus diagnosed breast cancer^ving rhames says police held gunpoint home,1,7,6,8,0.125,0.75,0
13493302,mmfa,2431,403629,10458,84858,0,7,1,0,media matters america nation premier progressive media watchdog research information center,wow infowars got promoted fox news tonight roger stone interview sean hannity^donald trump used weekly republican address push fox news fbi lie bret baier apologized^fox amp friends brett kavanaugh interview his whole life line^fox news sunday links disrespectful progressives confronting politicians verbally terrorist acts^why white house briefing president extreme anti lgbtq group alliance defending freedom kava^why white house briefing president extreme anti lgbtq group alliance defending freedom kava^nratv host dan bongino used doctored infowars video jim acosta white house press briefing^rush limbaugh katie couric stood matt lauer sexual misconduct today,1,7,6,8,0.125,0.75,0
16894445,WBTV_News,747,214346,1406,240988,0,5,1,2,your trusted local news certified accurate weather source charlotte area wbtvandme,cmpd responds video woman harassing rant sparks outrage social media spectrum woman former empl^police respond video woman harassing rant sparks outrage social media spectrum woman former emp^democratic national convention committee names studio vendors cltnews^the first presidential debate hillary clinton donald trump starting hofstra university right now^gop senators white house clash cia briefing khashoggi murder^kim kardashian n't running office considering maybe outlandish thing^meghan markle dad wo n't attend royal wedding reportedly due health reasons^april giraffe pregnant,1,7,6,8,0.125,0.75,0
1651522832,DrDenaGrayson,316,179994,965,59907,1,7,0,0,patriotic liberal former democratic candidate u.s. congress physician md scientist phd `` brain dead moron '' per trump trolls,on whether trump firemueller sarah sanders he certainly believes power we 've advi^trump lawyers also try defend trump admission obstructionofjustice interview w/ wh^this photo taken chamber inside capitol right president state t^breaking here full transcript stormydaniels interview trump stormy wow y^incredible times advocating reasonable republicans stop supporting republican national^this photo taken chamber inside capitol right president state t^gop rep tv ad featuring veteran posted dozens racist anti semitic amp anti muslim co^this photo taken chamber inside capitol right president state t,1,7,6,8,0.125,0.75,0
285626945,gaystarnews,8374,140563,1445,72203,0,1,1,6,the lgbti world -7,people protest chicago apostolic church god kicking parishioner married partner^sarah jessica parker wants ellen degeneres play samantha sex city^sam smith gender identity 'i feel much woman i man^shannon purser star stranger things riverdale comes bisexual^star jones ex husband al reynolds comes bisexual man^ellen degeneres favorite fashion moment dress what thoughts^the first look ryan murphy new series posefx energetic groundbreaking^sarah jessica parker wants ellen degeneres play samantha sex city,1,7,6,8,0.125,0.75,0
23948496,8NEWS,1793,99221,1040,137972,1,4,0,3,got news tip rva let us know -330-8000 ireport8.com,listen curious robocall seeks damaging information roy moore^people states sickened salmonella outbreak linked raw chicken centers disease^live blog behind scenes first presidential debate hofstra university^people states sickened salmonella outbreak linked raw chicken centers disease^breaking police officer among multiple victims reported shooting chicago hospital^judge declares mistrial bill cosby sexual assault case jury says hopelessly deadlocked^april giraffe gained fame captivated millions last year live streamed delivery pregnant aga^'april giraffe pregnant,1,7,6,8,0.125,0.75,0
9907172,NECN,327,93884,2005,225756,0,3,1,4,new england cable news nbc owned television stations,live video vice president joe biden make statement rose garden^just in white house vice president joe biden make statement rose garden story come^during campaign rally las vegas said 'd like punch protester face^ozzy osbourne sharon osbourne reportedly split years marriage^'game thrones season trailer promises the great war^andy spade breaks silence sets record straight reports surfacing one day wife kate^who billboard music awards complete list winners^a new family member coming new york april giraffe pregnant,1,7,6,8,0.125,0.75,0
16334281,CBSMiami,1381,92931,2030,178986,0,2,1,5,news insider info cbs4 news s. florida,watch live white house press briefing sarah huckabee sanders^watch live white house press briefing sarah sanders^first kiss prince harry duke sussex kisses wife meghan duchess sussex leave st george chapel^developing third suspect south florida rapper murder arrested rural georgia^meghan markle dad won attend royal wedding after staged photo fiasco^grammy nominated edm dj avicii dead at^reports say kylie jenner is pregnant with first child^did hear news aprilthegiraffe pregnant read watch live strea,1,7,6,8,0.125,0.75,0
16930125,edokeefe,19860,82910,2712,51980,0,7,1,0,political correspondent covering campaign2020 proudly irish latino alum member ed.okeefe.com,video amp transcript interview^tune in we wrapped another enlightening conversation four voters complete strangers differing^the senator correct i made similar point sunday pressure attention questions asked of^in larry kudlow says canadian pm trudeau betrayed trump g7 known better^via today th interview given since taking office and rd week^this week george h.w bush memorials beamed world television pool cameras manned affi^transcript rt i rise today set record straight feinstein cia search computers^at white house told us highly overrated lyin tex,1,7,6,8,0.125,0.75,0
15080288,WCCBCharlotte,1481,82827,1127,175714,0,5,1,2,wccb charlotte cw source news sports weather entertainment *if mention us consent wccb using content,mark harris released video statement today saying aware wrongdoing election process and^yesterday republican national committee announced charlotte host rnc august th th the^see key moments trump first address joint session congress seconds politics news wccb^chicago police say responding shooting near chicago hospital reports multiple victims. de^the founder stepping ceo he remain chairman board still company^channing tatum jenna dewan tatum announce separation via social media details^rapper nelly arrested released suspicion rape near seattle washington wccb^jennifer lawrence proud middle school dropout the oscar winner says quit school pursue,1,7,6,8,0.125,0.75,0
42946380,WHOhd,1733,74747,684,100870,1,7,0,0,official page iowa local news leader account managed digital team who-hd,melania trump undergoes kidney surgery walter reed medical center^iowa attorney general suing us department education^iowa attorney general suing us department education^iowa attorney general suing us department education^iowa attorney general suing us department education^trump asking congress not mexico pay border wall^trump asking congress not mexico pay border wall^trump asking congress not mexico pay border wall,1,7,6,8,0.125,0.75,0
315331161,Eugene_Scott,2997,54231,1167,92574,0,7,1,0,d.c. native political reporter vet board alum all politics identity politics,"the u.s. highest rate maternal mortality among developed countries rate deaths per ,000^a study centers disease control prevention atlanta estimated percent people in^michael cohen republican national committee deputy finance chair serve years prison financial^women republican right 70 percent gop women according nbc news/wall street journal poll remain b^lester holt registered republican first black presidential debate moderator since^the u.s. highest rate maternal mortality among developed countries rate deaths per ,000^you been verified us was yesterday talking central park questio^perhaps conservatives n't want stricter gun laws think shot heart f",1,7,6,8,0.125,0.75,0
15463486,KThomasDC,2564,30939,1478,32925,1,7,0,0,political reporter covering dems alum hoya saxa rts/links equal endorsements ken.thomas.com lgm,new york ap federal prosecutors charge nyc subway bomb suspect say wrote facebook trump failed protect nation^it would wise president come congress ensure rati^in foreign policy speech says us needs counter oligarchies authoritarianism a^inbox ceo democratic national convention committee^giuliani says n't made final decision potus interview w/ mueller says there'^the speech address joint session congress state union^washington ap white house vice president joe biden make statement rose garden^philadelphia ap democratic national committee offers `sincere apology sanders supporters `inexcusable remarks emails,1,7,6,8,0.125,0.75,0
40061315,abc_columbia,2216,23074,476,110504,1,4,0,3,am-7am noon pm pm pm download mobile app connect us fb ig,bakari sellers gives endorsement kambrell garvin us house representatives^just in abc republican national committee selects charlotte nc host convention we look forward see^new hillaryclinton postpones first event pres obama following orlando mass shooting pulseshooting^fact checking president trump address joint session congress jointsession^victims including police officer injured shooting near chicago hospital police say^report 'scandal end season^tracee ellis ross host the american music awards^trending technology playing vital role search mollietibbetts aprilthegiraffe pregnant,1,7,6,8,0.125,0.75,0
2473821354,FatherlyHQ,641,19106,309,43089,0,1,1,6,empowering men raise great kids lead fulfilling adult lives,here popular baby names state^bruce springsteen is teaching my son how count i couldn be happier^after years kermit frog getting new voice^after years kermit frog getting new voice^after years kermit frog getting new voice^after years kermit frog getting new voice^after years kermit frog getting new voice^april giraffe pregnant again,1,7,6,8,0.125,0.75,0
17514024,WHIORadio,198,13010,308,153334,0,4,1,3,whio-dayton news talk,tonight first presidential debate hofstra university for go blog click^chicago mercy hospital shooting the victims identified officer samuel jimenez dr. tamara e. o neal a^chicago mercy hospital shooting what know victims^chicago hospital shooting nurse critically wounded police officer among multiple victims shot^katie couric breaks silence news matt lauer dismissal 'today^meghan markle dad heart surgery wo n't attend royal wedding report says^more former fox news ceo roger ailes dead^actor ving rhames says police held gunpoint home neighbor reported burglary,1,7,6,8,0.125,0.75,0
15030133,Fradice,3173,2929,174,15923,0,0,1,7,emmy winning journalist producer director author musician aggregating content dynamic media landscape,here is complete list winners from billboard music awards via^tony awards nominations the complete list via^independent spirit awards complete list winners nominees rd indie spirits updating liv^daytime creative arts emmy awards the complete winners list via^daytime emmy awards the complete winners list via^congrats david foster katharine mcphee engaged via^billboard music awards complete winners list^here is complete list winners from billboard music awards via,1,7,6,8,0.125,0.75,0
859016395,TaylorPopielarz,249,2130,106,30445,0,7,1,0,covering ohio delegation capitol hill alum taylor.popielarz.com,the stormydaniels interview i recommend watching story reading transcript what you^this story based interviews conducted past year sources inside outside fox news s^update per three victims mercyhospital shooting died including chicago police offi^as :15 a.m. friday list prominent political figures mailed suspected bombs geo^former president george w. bush sit live interview feb.^president trump sits george stephanopoulos transcript a rare non fox interview for^president trump full washington post interview transcript annotated including remarkable exchange betwee^president the safety american people highest absolute priority. he says j,1,7,6,8,0.125,0.75,0
3668706497,shelby_heary,735,845,24,13371,0,1,1,6,wltx executive producer emmy nominated journalist univ south carolina gamma phi beta zeta sigma alumni opinions,shooting near chicago hospital leaves multiple victims via^mel b clarifies rehab reports 'no i alcoholic no i sex addict via^tonya harding admits prior knowledge nancy kerrigan attack abc special via^walmart remove 'cosmopolitan magazine checkout lines amid me too movement via^report meghan markle dad longer attend royal wedding via^cardi b confirms secretly married offset september 'engaged via^serena williams withdraws australian open via^reports jennifer garner ben affleck officially file divorce via,1,7,6,8,0.125,0.75,0
227837742,AC360,158,1323270,7084,66550,0,6,2,0,a behind scenes look anderson cooper watch ac360 m-f pm/et follow anderson twitter,we know trump born liar says possible obstruction case trump it firing comey i^coming show an exclusive interview first days trump administration^cnn asked veterans thoughts trump putin summit well president trump^part interview former president george w. bush coming ac360 cnn^legendary broadcaster sam donaldson if president trump thinks rules avoid answer jim acosta jo^michael cohen says loyalty first family country trump cnn john berma^says catherine duchess cambridge former kate middleton meghan markle differe^says catherine duchess cambridge former kate middleton meghan markle differe,2,6,4,8,0.25,0.5,0
100077645,PopWrapped,12306,563452,1783,57237,0,0,2,6,all your favorite entertainment news pop-culture tidbits movies music fandoms television technology video games wrapped up just reheat serve,icymi keeping up with the kardashians kris jenner not sure she would have oj simpson on her show story^keeping up with the kardashians kris jenner not sure she would have oj simpson on her show story^our dream casting may happening chastain talks join it sequel^icymi our dream casting may happening chastain talks join it sequel^icymi everything know prince harry engagement meghan markle^everything know prince harry engagement meghan markle^icymi hit show reasonswhy gets renewed for season story^hit show reasonswhy gets renewed for season story,2,6,4,8,0.25,0.5,0
16656350,FOX4,704,552584,2275,163770,1,2,1,4,breaking news headlines around north texas official twitter feed kdfw fox news,new york ap federal prosecutors charge nyc subway bomb suspect say wrote facebook trump failed protect nation^unusual list shows most popular baby names by state^philadelphia ap democratic national committee offers `sincere apology sanders supporters `inexcusable remarks emails^official photos released royal wedding prince harry meghan markle^second suspect arrested xxxtentacion murder^second suspect arrested xxxtentacion murder^actor vince vaughn arrested suspicion dui^tmz 'superman star margot kidder dead,2,6,4,8,0.25,0.5,0
205789121,MONEY,1395,396399,4763,99430,0,0,2,6,make sign newsletters,all members british royal family ranked net worth^kate middleton massive fortune duchess here know royal net worth^here popular halloween candy state^here popular halloween candy state^here popular halloween candy state^here popular halloween candy state^here popular halloween candy state^the weinstein company set file bankruptcy,2,6,4,8,0.25,0.5,0
5135521,stereogum,3075,340807,9877,71155,0,0,2,6,the original new music blog,mariah carey makes official statement new year eve debacle foiled^kanye west livestreamed speech africa mind control^beyonc surprises colin kaepernick sports illustrated muhammad ali legacy award^justin timberlake announces man of the woods tour unveils another goofy ass trailer^justin timberlake announces new album man of the woods^justin timberlake announces new album man of the woods^cardi b confirms offset secretly married there many moments i share world t^announces broadway musical based life coming,2,6,4,8,0.25,0.5,0
16440677,FOX59,6367,256735,1737,262628,0,2,2,4,serving central indiana breaking news sports weather community information,vp mike pence we calling lawmakers solve problem president vision articul^police four teens injured one critical condition following shooting birthday party lawrence^new photos britain newest royal prince louis big sister princess charlotte shared pri^new photos britain newest royal prince louis big sister princess charlotte shared pri^nicholas duffy fudge star wicked tuna dead^nicholas 'duffy fudge star 'wicked tuna dead fox59morning^icymi internet star april giraffe pregnant fox59morning^april giraffe pregnant,2,6,4,8,0.25,0.5,0
16243550,fox8news,2214,233022,1343,155166,1,0,1,6,cleveland fox news breaking news weather alerts tweets impact **your tweets could used air**,melania trump undergoes kidney surgery walter reed medical center^david cassidy fighting memory loss wants 'enjoy life^legendary comedian jerry lewis dies age^legendary comedian jerry lewis dies age^pictures april giraffe gives birth^jason aldean wife brittany fights back parent shamers vacation without newborn^ellen degeneres cries receiving 'best birthday gift portia de rossi via^ellen degeneres cries receiving best birthday gift portia de rossi,2,6,4,8,0.25,0.5,0
20563513,WHAS11,639,170718,1039,176856,0,1,2,5,whas11 news source louisville southern indiana news online on-air tegna foundation grant information,soon vice president biden deliver statement white house rose garden whas11^reports brad pitt accused child abuse investigation^ben higgins fights 'fake news split lauren bushnell romantic instagram^koko gorilla knew sign language dies^scott baio wife renee reveals microvascular brain disease diagnosis^scott baio wife renee reveals microvascular brain disease diagnosis^scott baio wife renee reveals microvascular brain disease diagnosis^'nypd blue creator steven bochco dead,2,6,4,8,0.25,0.5,0
24943151,48hours,1055,136420,785,47013,0,4,2,2,true crime real justice hours saturdays /9c -- watch latest episodes,heartbreaking the aunts missing year old jayme closs made emotional public statement teen y^more one victims chicago shooting dr. tamara o'neal gunman ex fianc e police say they^graham says white house promised cia briefing khashoggi soon^police say two women left four children one young months old alone hot car went s^kim kardashian west attends white house meeting prison reform^man posed justin bieber online entice girls sentenced^update police say former mtv vj jesse camp found reported missing^please please please reach jesse camp best known vj mtv late reported,2,6,4,8,0.25,0.5,0
22891564,chrisgeidner,5599,129753,3912,245597,2,6,0,0,currently collab previously buzzfeed news about sober writer gay queer bipolar buckeye law dork scotus tweets dms open,shorter paul ryan i 'm humble country speaker of the us house of representatives^what obama russia law michael lucas wear rainbow pin goes g20 summit russia^last night ended rudy giuliani giving new interview said things appeared to^from latest interview rudy giuliani he says trump page^here writeup today interview trump outside lawyer rudy giuliani it doozy.^my latest interview rudy giuliani he says focused mueller trump definitely t^i know everyone focused collusion part rudy fox amp friends interview morning i stuc^statement retired justice david hackett souter nominated supreme court president george h. w. bush,2,6,4,8,0.25,0.5,0
48088063,ballotpedia,18815,84864,1207,32879,2,6,0,0,the encyclopedia american politics,texas agriculture commissioner sid miller r endorsed trump second term miller fac^in race new hampshire house representatives hillsborough candidate connection survey respo^former naacp president ben jealous wins democratic nomination governor maryland jea^bernie sanders endorses greg edwards pa democratic primary edwards sanders supporter backs many t^republican national committee sets dates aug. convention charlotte more election ne^judge randolph d. moss federal judge washington ruled u.s. department education must implement a^the filing deadline alaska today find candidates state legislature akgov^recall election today dover wisconsin candidate wins vote runoff held august,2,6,4,8,0.25,0.5,0
19683725,KLTV7,1665,82041,493,81781,0,4,2,2,your east texas news leader an abc gray tv affiliate caring committed proud east texas,republican national committee take formal vote approve charlotte host city republican^a new survey released centers disease control prevention shows sex drug use among u.s. teens has^icymi find popular baby names girls state^find popular baby names girls state^kim kardashian n't running office considering really outlandish though^david cassidy fighting memory loss wants 'enjoy life^meghan markle dad wo n't attend royal wedding^game thrones power couple jon snow kit harington ygritte rose leslie getting married real life,2,6,4,8,0.25,0.5,0
229114225,MorningExp,311,76701,553,45009,0,3,2,3,top stories highlights morning eress m-f a-noon et,sen. john mccain warns 'half baked nationalism liberty medal acceptance speech^police say gunman chicago hospital shooting killed three people relationship one the^while president gave speech cincinnati yesterday first lady melania trump visited youngest vi^justin bieber hailey baldwin may already married source says the couple spotted new york city c^minnesota senator al franken accused groping kissing los angeles radio host leeann tweeden with^only days go royal wedding preparations well underway we still n't know walk meghan mark^'wicked tuna star nicholas 'duffy fudge dead fudge died uneectedly last week according obituary^'wicked tuna star nicholas 'duffy fudge dead fudge died uneectedly last week according obituary,2,6,4,8,0.25,0.5,0
2065391,tlrd,772,75270,2001,95410,0,1,2,5,towleroad lgbt news blog ... politics pop gay culture music viral videos travel tech equality issues influential..must read washington post,breaking obama briefed responds mass shooting gay orlando nightclub^caitlyn jenner considering bid us senate california^caitlyn jenner considering bid us senate california^angels america the band visit reign tony awards full list of winners^kevin spacey frank underwood dead new house cards trailer^kevin spacey frank underwood dead new house cards trailer^lcd soundsystem gavin russom comes out transgender^parks rec actress natalie morales comes out as queer in powerful essay,2,6,4,8,0.25,0.5,0
35947725,InStyleAus,1131,64732,615,16045,0,0,2,6,instyle magazine australia comprehensive style authority latest fashion beauty lifestyle celebrity news,jenniferaniston breaks her silence on brad pitt and angelina jolie divorce^angelinajolie has a new man following split with bradpitt^breaking injured on set of spy thriller the rhythm section^just in rachelmcadams welcomes her first child^everyone favourite star reportedly pregnant first child^megan fox shares very rare photo of her beautiful boys^justintheroux returns social media first time since split jenniferaniston^prince harry and meghan markle reveal weddingcake details,2,6,4,8,0.25,0.5,0
75357513,mediagazer,3,52254,2917,78125,1,5,1,1,mediagazer presents day must-read media news single page,sources cond nast shutting vogue wired gq channels snapchat letting go employees it^the internet archive new project preserves political tv ads journalists see ...^internet archive gather data political ads tv news markets^the economist stands decision host stage interview steve bannon open future festival se^fox news contributor david bossie offered apology sunday told african american guest fox amp friends^amid national furor trump admin policy separating children families white house held^sources trump rose garden videos meant make feel good remind earlier digital media virali^sources bill o'reilly talks return cable news newsmax tv one year forced fox,2,6,4,8,0.25,0.5,0
637351664,MSNNews,308,51045,341,52004,2,3,0,3,world-class news trusted sources,the incident became fodder facebook post texas agriculture commissioner sid miller wrote ...^melania trump undergoes kidney surgery walter reed medical center^criminal inquiry sought hillary clinton use email^full transcript the stormy daniels minutes interview^key moments trump interview fox friends with fact checks^koko gorilla knew sign language dies^former fox news ceo roger ailes dead^does photo prove amelia earhart survived final flight,2,6,4,8,0.25,0.5,0
65576332,HerCampus,2809,40615,749,70430,0,1,2,5,the bff likely check cover letter chug ros blood type iced coffee status probably napping pizza puppy enthusiast,know now new white house press briefing rules^but hailey baldwin hopped twitter refute claims justin bieber already tied knot i und^sorry guys dating^icymi nick jonas priyanka chopra engaged year old still crying corner holding my^icymi nick jonas priyanka chopra engaged year old still crying corner holding my^icymi nick jonas priyanka chopra engaged year old still crying corner holding my^icymi nick jonas priyanka chopra engaged year old still crying corner holding my^icymi nick jonas priyanka chopra engaged year old still crying corner holding my,2,6,4,8,0.25,0.5,0
22260999,lisatozzi,1899,25858,847,64925,2,3,0,3,master disaster former global news director buzzfeed nytimes alumna i buying hotdogs i giving good people,here transcript sen. jeff flake speech announcing seek reelection^new york city subway bomb suspect wrote trump failed protect nation facebook attempted attack^here transcript sen. jeff flake speech announcing seek reelection^here transcript trump minutes interview lesley stahl^i imagine city without it feels wrong i feel like guide the^prince charles walk meghan markle aisle saturday royal wedding^aly raisman sues the us olympic committee and usa gymnastics over nassar abuse^simone biles says sexually abused former usa gymnastics doctor larry nassar over women made si,2,6,4,8,0.25,0.5,0
1413698887,AtomicAnalyst,1266,21263,452,24785,2,6,0,0,nonresident senior fellow fellow editor/co-author atomic audit the costs consequences us nuclear weapons since,republicans control white house senate house representatives supreme court out^republicans control white house senate house representatives supreme court gove^there least three footballs primary one assigned president second^weirdo^but yes course the person probably get nod va secretary david shulkin^remember got on march trump heard south korean envoys white house briefing kim jong^let recall got on mar trump heard south korean envoys white house briefing k^how actually got on march trump heard south korean envoys white house briefing kim,2,6,4,8,0.25,0.5,0
54891614,brucejohnson9,11121,20529,418,22669,1,4,1,2,anchor/reporter/author cbs wusa-tv9,melania trump undergoes kidney surgery walter reed medical center cnn politics^full transcript president donald trump interview cbs news face nation cbs news^full transcript president donald trump interview cbs news face nation cbs news^senators demand cia briefing khashoggi admonish white house ahead key saudi vote^one worst nba finals warriors complete sweep cavaliers claim second straight nba championship thi^she intrigued ... considering gayle king says talking oprah bout running president.^surprise ariana grande pete davidson are engaged e news^serena williams pulls french open pectoral injury maria sharapova match,2,6,4,8,0.25,0.5,0
952086582,CelesteKatzNYC,6311,14484,482,36282,1,6,1,0,politics priors wbai cond newsweek siriusxm economistradio/mic nydailynews projo dachshundist celestekatz dm signal,full statement attorney general jeff sessions recusal matters related way campaigns for^jeb bush holds town hall meeting derry nh latergram election2016 derry opera house^updates breaking details letter jason chaffetz elijah cummings oge kellyanne conway^the technical advisory committee democratic national convention scoping nyc aug. amp^i uploaded public financial disclosure report donald trump readmore^monday flotus melania trump attended first official function private gathering gold star families af^a preview british pm theresa may remarks house retreat philadelphia today icymi^i 'm going comment martha i actually nothing say kellyanne conway 'go buy ivan,2,6,4,8,0.25,0.5,0
69686217,THRAwards,7,9877,363,10133,0,0,2,6,oscar emmy global awards show festival news,telluride nicole kidman 'destroyer tour de force could return her oscar contention^emmys what nominees are saying^jada pinkett smith calls out hfpa 'girls trip golden globes snub^tony awards nominations the complete list^mtv movie amp tv awards big sean noah cyrus set perform^daytime creative arts emmy awards the complete winners list^billboard latin music awards the complete winners list^rock roll hall fame bon jovi moody blues among inductees,2,6,4,8,0.25,0.5,0
34929057,knssradio,2234,4662,202,178111,1,2,1,4,knss wichita talk sign newsletter knssradio,federal prosecutors charge nyc subway bomb suspect say wrote facebook trump failed protect nation^memory lapse trump seeks distance from 'advisor with past ties mafia politics knssradio^the head centers disease control prevention taking pay cut complaints salary excessive news :30^christina aguilera engaged boyfriend matt rutler^'superman star margot kidder dead^former chairman ceo fox news channel roger ailes dead^queen elizabeth ii visits victims manchester arena attack hospital^andrew garfield claims 'i gay man right ... without physical act via,2,6,4,8,0.25,0.5,0
8736882,globeandmail,570,1774176,14290,471025,0,2,3,3,canada national news organization customer service share info us anonymously,the state union where canada labour movement go^the state union where canada labour movement go^caitlyn jenner going publish memoir life transformation^watch today women world summit featuring trudeau freeland lagarde katie couric streaming now^watch today women world summit featuring trudeau freeland lagarde katie couric many beginni^james franco denies sexual misconduct allegations^house the brady bunch sale nearly 1.9 million^serena williams withdraws australian open says feel ready yet from sports,3,5,2,8,0.375,0.25,0
56960258,newvisionwire,188,526945,603,170461,0,5,3,0,breaking news current events news analysis uganda leading daily epaper,today in history first us presidential debate democratic nominee hillary clinton vs republican donald trump a^forum democratic change fdc extended party presidential debate members vying top ...^today in history first us presidential debate democratic nominee hillary clinton vs republican donald trump a^today in history first us presidential debate democratic nominee hillary clinton vs republican donald trump a^donald trump wednesday called media stop endless hostility false attacks comments add^prince william catherine duchess cambridge give world first look royalbaby visionupdates afp^prince william catherine duchess cambridge give world first look royalbaby visionupdates afp^britain queen elizabeth ii britain prince philip duke edinburgh arrive wedding ceremony brit,3,5,2,8,0.375,0.25,0
472122299,PhilippineStar,1355,514673,1664,407411,0,4,3,1,the official twitter account the philippine star flagship title country successful print media enterprise,watch presidential spokesman salvador panelo statement superstar nora aunor non inclusion latest batch o^who said compulsively playing video games qualifies mental health condition the statement confirmed f^four suspects killed drug raids bulacan one pampanga quezon past two days.^based latest surveys percent filipinos oppose charter change one four aware federalism.^channing tatum wife jenna dewan tatum announce split^mariah carey they foiled^celebrity news gives birth baby boy^james franco denies sexual misconduct allegations,3,5,2,8,0.375,0.25,0
14602259,BostonDotCom,2499,463212,5498,212545,0,2,3,3,what boston really cares right,read transcript elizabeth warren big foreign policy speech^read full transcript presidential debate^channing tatum wife jenna dewan tatum announce split^jennifer holliday backs performance donald trump inauguration^no matt damon moving australia donald trump^james franco denies sexual misconduct allegations^summer phoenix reportedly files divorce casey affleck^matt damon apologizes comments sexual misconduct,3,5,2,8,0.375,0.25,0
15564045,fox12oregon,613,236719,1934,139062,1,2,2,3,first live local news portland oregon southwest washington watch the o clock news every night fox,breaking federal prosecutors charge nyc subway bomb suspect say wrote facebook trump failed protect nation^substation fire update the wasco county sheriff office issued level go evacuation order shearer^surprise furry passengers a teen shocked find one four bears car find t^david cassidy fighting memory loss wants 'enjoy life^kim kardashian not embarrassed kanye west visit trump^announces two year las vegas residency^celine dion donates concert proceeds las vegas shooting victims^pregnant april giraffe calf due march,3,5,2,8,0.375,0.25,0
29008249,WFSBnews,639,223591,1262,162052,1,1,2,4,the official twitter page wfsb channel eyewitness news,melania trump undergoes kidney surgery walter reed medical center^on way hofstra university first presidential debate stay air and^shameless sending courteney cox challenge lip sobriety^shameless sending courteney cox challenge lip sobriety^stranger things season coming here everything know far^stranger things season coming here everything know far^everything know star wars episode ix far^colin trevorrow back direct jurassic world,3,5,2,8,0.375,0.25,0
2435380381,newsonepk,79,203681,343,448208,0,5,3,0,news updates round clock newsonepk leading news channel keeping informed latest developments breaking happenings across globe,^^watch full program newsonepk mirza^newsonepk^newsonepk^george clooney amal alamuddin reportedly headed 300 million divorce^read jenniferaniston justintheroux lifestyle entertainment newsonepk aniston w^newsone bradleycooper venicefilmfestival ladygaga astarisborn,3,5,2,8,0.375,0.25,0
14301074,1NewsNZ,240,160339,1363,134953,1,1,2,4,stay ahead news instagram snapchat newsnz,republican paul ryan stepping speaker us house representatives^one us soldier killed four wounded attack extremists somalia^jacinda ardern wo n't follow kate middleton leaving hospital hours giving birth^kanye west name baby girl days struggling find name^koko gorilla knew sign language dies^prince harry asks william best man wedding meghan markle^love island uk contestant sophie gradon dead^meghan markle dad reportedly wants attend royal wedding changing mind,3,5,2,8,0.375,0.25,0
1507338108,Sifill_LDF,1021,132065,1430,54225,2,4,1,1,president director-counsel ldf naacp legal defense educational fund nation premier civil rights law organization tweets,mcconnell looks sanguine boldly announces artificial deadline vote but knows^attorney general sessions statement recusal^just watched program challenger disaster listened president reagan i agreed with^transcript tonight minutes intrvw officer killed unarmed motorist terrence crutcher tulsa^does russian ambassador normally attend new president address joint session congress is thing^just watched program challenger disaster listened president reagan i agreed with^love catch great articles.terrific the women hollywood speak out^i lean fear ... learn teach i pay attention amp i learn blackwomeninhollywood,3,5,2,8,0.375,0.25,0
15108530,ReutersUS,318,113441,4038,173598,2,2,1,3,top news united states,nancy pelosi top democrat u.s. house representatives agrees term limits smoothing road ho^sixteen democratic members congress oppose fellow democrat nancy pelosi bid become speaker u.s. hous^breaking u.s. democratic presidential candidate clinton says wants democratic party sanction new debate new hampshire next week^just in police arrest two suspects denver shooting killed one person left four wounded say attack was^amal george clooney welcome boy girl twins^the weinstein company file bankruptcy^the weinstein company file bankruptcy^the weinstein company file bankruptcy,3,5,2,8,0.375,0.25,0
9229672,fox5ny,459,113212,1865,133017,1,3,2,2,comments photos shared using fox5ny could used fox platforms,new york ap federal prosecutors charge nyc subway bomb suspect say wrote facebook trump failed protect nation^body missing n.j teen found pond authorities found body missing new jersey teenager fift ...^mccain lieberman defense secretary sen. john mccain republican arizona said interview cnn ...^breaking vice president joebiden make statement rose garden white house^mariah carey new year eve performance 'they foiled^happy th birthday regis philbin legend television celebrity birthday celebrate^breaking harvey weinstein arrested processed charged rape criminal sex act sex abuse sexual mi^dance moms star lee miller sentenced year day prison bankruptcy fraud amp reporting australi,3,5,2,8,0.375,0.25,0
74382140,7NewsBrisbane,179,100150,1188,176379,0,4,3,1,first news sport weather queensland weekdays pm nightly pm simulcast fm got news tip email news.com.au news,khawaja makes statement regarding arrest brother sydney fake documents containing alleged^a police officer two victims killed mass shooting chicago hospital earlier today poli^a jury heard woman trial accused murder told friend someone else responsible partn^returned field australian soil darwin four months one year ban follo^breaking another royal baby way meghan markle prince harry eecting first child^thrilled fans perth first performance down under news^the beckhams climbed harbour bridge ticking bucket list item trip sydney david beck^royal wedding meghan markle father decided walk aisle weekend royalwedding news,3,5,2,8,0.375,0.25,0
156306739,morgfair,10861,90301,2183,457444,1,5,2,0,actress foreign policy politics science humor texan loves art ballet old movies and rock n roll ig morganfairchild1,a fake photo emma gonz lez went viral far right parkland teens villains^seth meyers mocks rudy giuliani telling fox news n't quote actual tv interview^donald trump sets conditions defending nato allies against attack^at trump hotel site immigrant workers wary cc news diva^everything need know drone debate one faq cc^the disappearing white house press briefing^analysis trump alleged 'knew signed comment widow worth caution fits clear pattern^morning joe hosts trump bring national enquirer into their feud,3,5,2,8,0.375,0.25,0
16567309,hulu_support,3063,74225,416,574018,0,1,3,4,helping handmaids runaways everyone else things tweeting am-10pm pt phones chat available /7,hi jared the overall number channels go week while fyi^thanks following it sounds like 're affected known issue since been^hey just case recommend going keeping kardashians series page^you 're welcome lexi with live tv plan 'll able wat^no official news share yet similar events grammys golden globes etc streamed^hey matt our no commercials option applies ads hulu library everything listed^we rights stream seasons dubbed 'll definitely share request for^gotcha all episodes season currently available let us know notice ch,3,5,2,8,0.375,0.25,0
242374336,Politicsinsider,41,38802,1003,93976,1,4,2,1,the latest political news analysis,nyc bombing suspect wrote 'trump failed protect nation facebook feds say^awesome lines from sarah palin brilliant cpac speech lightning^rudy giuliani says n't want trump get stuck perjury trap interview mueller 'truth is^in emotional interview jake tapper john mccain says 'd like remembered^rudy giuliani on running for president anthony weiner and hanging out in new hampshire^trump long warm relationship oprah helped springboard presidential ambitions^billy bush confirms trump voice 'access hollywood tape^donald trump almost played president 'sharknado happened,3,5,2,8,0.375,0.25,0
14358172,MetroPhilly,1091,35525,802,44608,0,2,3,3,philly best free daily newspaper keeping updated news sports entertainment lifestyle all fit inform entertain,map shows popular baby names state last years^these popular baby names state^here winners red carpet looks amas^hailee steinfeld get think dating justin bieber same^awesome sounding robert pattinson robert de niro olivier assayas film cancelled^surprise outlander star caitriona balfe engaged^everything need know freeform nights halloween schedule^breaking former fox news ceo roger ailes dead,3,5,2,8,0.375,0.25,0
23256605,Hot963,2743,31774,236,162488,0,0,3,5,running hip hop naptown yrs hotrunsindy listen amazon echo enable hot amazon alexa once enabled say alexa play hot963 '',did kanye west make a diss track about donald trump^kanye west amp kim kardashian have one embryo left^kim kardashian arrives in nyc with massive security detail still terrified^tamar braxton files for divorce from vincent herbert^kim kardashian shares first photo of daughter chicago west photos^is phaedra parks returning to the real housewives of atlanta^is tristan thompson ready to leave khloe kardashian exclusive video^beyonce eminem the weeknd headline coachella,3,5,2,8,0.375,0.25,0
70425238,CdAGrp,10347,10882,123,30674,0,0,3,5,media production rights management from creation collection also follow,soulja boy starts ugly feud with chris brown over karrueche tran^oscars see full winners list updating live who win th annual academy awards there ...^here is complete list winners from billboard music awards updating live^tamar braxton files divorce from husband manager vincent herbert^'american horror story season title revealed american horror story title the upcoming seventh seaso ...^cher announces broadway musical based her life coming^here is complete list winners from billboard music awards updating live^mtv emas taylor swift leads nominations viacom mtv wednesday oct. unveiled nominations ...,3,5,2,8,0.375,0.25,0
183750912,MetroBOS,1103,9487,427,42677,0,2,3,3,boston best free daily newspaper keeping updated news sports entertainment lifestyle,these popular baby names state^map shows popular baby names state last years^here winners red carpet looks amas^hailee steinfeld get think dating justin bieber same^awesome sounding robert pattinson robert de niro olivier assayas film cancelled^surprise outlander star caitriona balfe engaged^everything need know freeform nights halloween schedule^breaking former fox news ceo roger ailes dead,3,5,2,8,0.375,0.25,0
26724955,1031FreshRadio,416,7905,160,41386,0,2,3,3,today best mix,today day structube grand opening today new location lowe plaza wonderland road you^looking freshen home new look well get structube today new location we ar^liz see first pictures amp official couple^k amp m~ is us kate middleton haircut everyone freaking look always^woodbridge amp who else deserves star hollywoodwalkoffame bradpitt and^best luck julia louis dreyfus diagnosed breast cancer^time get binge watching renewed season^woodbridge amp 've got time next year and a half may want check out,3,5,2,8,0.375,0.25,0
154246407,1053thebuzz,181,6176,34,20077,0,0,3,5,today best variety home kidd kraddick morning show,rumors swirling dating robert pattinson see the photo everyone talking^icymi complete list grammy winners^selena gomez reveals she had kidney transplant this summer^have mercy uncle jesse eecting first child fianc e caitlin mchugh gt^jennifer lawrence single details split director boyfriend /^watch taylor swift releases trailer end game music video featuring ed sheeran amp future^richard simmons hospitalized severe indigestion details^announced going return new halloween movie next year,3,5,2,8,0.375,0.25,0
739991989274464256,PeopleHome,633,2826,20,3839,0,0,3,5,no site celebrity news and subscribe snapchat discover channel,shares thing misses away home^shares thing misses away home^kim kardashian kanye west put hoodies secretly elored tokyo just us during birthday trip^kyle richards husband speaks out after home burglary nothing replaces family^kylie jenner shows off her foot gold christmas tree sneaks selfie stormi^mila kunis surprises parents home makeover 'i want give something i think deserve'^mila kunis surprises parents home makeover 'i want give something i think deserve'^mila kunis surprises parents home makeover 'i want give something i think deserve',3,5,2,8,0.375,0.25,0
237403203,AllenWest,974,758654,5301,14347,5,3,0,0,former fl rep retired army lt. col. author hold texas hold nation amazon candidate state chair rpt,when incoming house committee chairman sure constitutional concern us but^icymi did hear folks we major coverup occuring us house representatives to^we major coverup occuring us house representatives mention treason evidence of^have seen folks we major coverup occuring us house representatives mention trea^when incoming house committee chairman sure constitutional concern us but^icymi my interview last night tcot ccot bcot^appreciate kind words humbled guest sunday night life libert^icymi i 'm honored guest week life liberty amp levin i hope y,5,3,-2,8,0.625,-0.25,1
77696645,dailystarnews,166,626034,753,122385,3,2,2,1,bangladesh largest english daily the latest breaking news features analysis,us congressman william richard keating places resolution house representatives urging political leaders^the partially redacted memos handed us justice department three house representatives committees^forces attorney general threatens fight back democrats use new majority in^launched twitter feed confirms^watch the hair beard see movie one hundred percent real i shave entire head^angelinajolie bradpitt agree keep details divorce child custody dispute private^angelinajolie bradpitt agree keep details divorce child custody dispute private^us judge declares mistrial bill cosby sexual assault case,5,3,-2,8,0.625,-0.25,1
23614207,TheInsider,10253,266551,1397,49448,0,0,5,3,the insider brings hollywood inside -- stories everyone talking perspective one else telling,guess which celeb baby bump most searched katemiddleton omginsider^guess which celeb baby bump most searched katemiddleton omginsider^amber heard talks marriage johnny depp first time since wedding^jokes getting back together^katie holmes joshua jackson reconnect a dawson creek reunion works^harry styles message ex girlfriend taylor swift^richard simmons hospitalized severe indigestion^morningjoe co hosts joe scarborough mika brzezinski engaged,5,3,-2,8,0.625,-0.25,1
16259251,revolttv,405,239591,1782,140421,0,0,5,3,the power of hip hoplearn network celebrate la october -26 get your pass now revoltsummit,celebrities react white nationalists rally charlottesville va^rumorreport brad pitt investigation accused verbal physical child abuse^rumorreport brad pitt investigation accused verbal physical child abuse^revolt news yeezus tour postponed indefinitely after truck accident^revolt news yeezus tour postponed indefinitely after truck accident^flavor flav sues chuck d public enemy team unpaid royalties^why arianagrande petedavidson break did send pics macmiller has anyone ever gone your^recently demi lovato reveals contemplated suicide age thebreakfastclub,5,3,-2,8,0.625,-0.25,1
19706851,TelegraphWorld,609,234452,2860,82047,0,0,5,3,the latest world news,kellyanne conway 'counselled telling donald trump supporters 'go buy ivanka stuff possible ethics^oprah winfrey says waiting ign god run us president^jennifer aniston 'pregnant miracle baby aged husband justin theroux^blog jennifer aniston revenge angelina jolie sexy photo shoot^sarah jessica parker matthew broderick twins via surrogate^melania trump nudges donald remind raise hand national anthem^comedian louis ck accused sexual misconduct five women^don rickles toy story star legendary comedian dies aged,5,3,-2,8,0.625,-0.25,1
466376163,PeopleDailyKe,774,114393,161,108721,0,0,5,3,keeping know /7 for breaking news special reports etc latest sports follow talktopd pdwikendi,biggest celebrity scandals^biggest celebrity scandals^biggest celebrity scandals^biggest celebrity scandals^biggest celebrity scandals^beyonc gives birth twins jay z^beyonc gives birth twins jay z^beyonc gives birth twins jay z,5,3,-2,8,0.625,-0.25,1
138516405,MadameNoire,16673,83038,1314,106883,0,0,5,3,a space unapologetic black woman we passionate we real we love us,check list best ... worst sorry female superbowl halftime show performers superbowlxlviii^hoda kotb officially replace matt lauer co anchor today also maintaining post fourth^while hoda kotb replaced matt lauer today getting anywhere near salary find hoda^report kim kardashian and kanye west secretly wed in la^meghan markle told woman official tour australia although excited pregnancy she^chanel iman sterling shepard eecting baby girl congrats newlyweds^tamar braxton files divorce husband vincent herbert nearly years marriage^judge declares bill cosby sexual assault case a mistrial,5,3,-2,8,0.625,-0.25,1
1088334553,Showbiz_IT,182,73367,244,55861,0,0,5,3,entertainment account india largest-selling magazine india today follow us latest showbiz gossip photos celebrities much,are bradpitt jenniferaniston baby leaving angelinajolie livid^are bradpitt jenniferaniston baby leaving angelinajolie livid^jenniferaniston justintheroux split far less ugly bradpitt angelinajolie mess^angelinajolie split bradpitt i n't enjoy single it hard^is galgadot incest porn video the truth leave scared^gameofthrones kitharington rose leslie wedding date revealed^priyanka chopra nick jonas engaged congratulations first photo^meryl streep joins big little lies season,5,3,-2,8,0.625,-0.25,1
734866610,DenofGeekUS,2188,72897,681,94845,0,0,5,3,your best resource features news reviews tv movies video games comics culture contact us tips.us,netflix thecrown cast new actors prince charles queen mother^chloe grace moretz tell real story snow white red shoes seven dwarfs.^margot robbie replace gal gadot revenge thriller ruin holocaust survivor teams repentant e^nicole kidman returns dc universe time aquaman mother atlanna aquaman nicolekidman^timoth e chalamet elle fanning selena gomez cast woody allen next movie amazon.^it much everything know far episode ix maythe4thbewithyou happy star wars day^everything know rapidly approaching season americangods ...^here everything missed ironfist season binge spotted another easter egg n't let u,5,3,-2,8,0.625,-0.25,1
390412142,SocialMktgFella,7374,69429,1397,64981,2,0,3,3,cannabis connector brand executive partnerships growth as seen sometimes,texas church shooter being identified as an atheist on the dnc payroll is fake news^snapchat shutting down by end is a viral hoax^macaulay culkin claiming satanic hollywood executives ritually murder child actors is fake news^matt damon in hiding following sexual misconduct comments about harvey weinstein is false^ellen degeneres being labeled as boss from hell is fake news^'dance moms star abby lee miller sentenced to one year in prison for fraud^former fox news ceo roger ailes is dead^dancing stars jordan fisher lindsay arnold win season mirrorball trophy,5,3,-2,8,0.625,-0.25,1
34180086,mca_music,747,61849,291,55771,0,0,5,3,the official twitter mca music inc. company home biggest artists music listen new lover album,taylor swift boyfriend joe alwyn planning epic surprise romantic dinner amp intimate night in hotel^from billboard maddie poppe tears joy instantaneous crowned season winner america^exes selena gomez justin bieber 'hang together la home via^daily top international no tears left to cry gi^get taylor swift fix spotify follow stream greatest hits this is taylor swift ...^taylor swift tonight show performance makes jimmy fallon cry and story behind it will make everyone cry^eminem announces release date new album revival recently appeared saturday night live perform^mtv emas taylor swift leads nominations via,5,3,-2,8,0.625,-0.25,1
348044335,VirginRadioWPG,16594,48703,229,70759,0,0,5,3,winnipeg hit music station stream,it official amp getting cozy details next listen online^split back july liam tells^why jenniferaniston rumoured jealous details coming^julie bowen starring alongside melissa mccarthy life party^allegedly emotional breakdown she opens depression next iheartradionights^gigi hadid answers vogue questions^returning host oscars matt damon gon na like ...^meet new cast season,5,3,-2,8,0.625,-0.25,1
828841083257778176,latestly,318,41630,61,72117,1,0,4,3,focuses what when who how trending story helps readers analyses go beyond domain news,india can purchase s400 from russia without interference from us house of representatives passes bill to^selena gomez reportedly tried ripping iv hospitalised selenagomez selena jelena^aquaman movie new posters are lit af jason mamoa amber heard nicole kidman amp rest dceu superhero film cast wi^jenniferaniston divorce creates confusion twitterati mistakes canadian pm justintrudeau for ex husband^jenniferaniston justintheroux end marriage why celebrities calling quits jenniferaniston^koko gorilla used sign language dies age koko thegorillafoundation gorilla dead rip^priyankachopra nickjonas engagement live news updates and engaged see first pic^priyanka chopra nick jonas engaged see first pics couple here priyankachopraengagement,5,3,-2,8,0.625,-0.25,1
755890045,BuzzFeedRewind,648,30462,321,32636,0,0,5,3,everything old one place,sarah jessica parker hinted on ellen that there still might be a sex and the city^netflix revealed a bunch of new faces that will be appearing in the crown season including who will play princ^katie holmes and joshua jackson were touchy at the dawson creek reunion and people are losing it^katie holmes and joshua jackson were touchy at the dawson creek reunion and people are losing it^katie holmes and joshua jackson were touchy at the dawson creek reunion and people are losing^here freeform official nights of halloween schedule for everyone who loves october^here freeform official nights of halloween schedule for everyone who loves october via^here freeform official nights of halloween schedule for everyone who loves october via,5,3,-2,8,0.625,-0.25,1
125944392,etribune,126,935258,2199,385659,0,2,6,0,global standard local perspective follow breaking news special reports,'humble responds critics state union address^a former provincial chief minister son elected assembly brother murder^leaving jennifer aniston angelina jolie one biggest mistakes brad pitt^amal george clooney welcome boy girl twins^leaving jennifer aniston angelina jolie one biggest mistakes brad pitt^leaving jennifer aniston angelina jolie one biggest mistakes brad pitt^leaving jennifer aniston angelina jolie one biggest mistakes brad pitt^lindsay lohan sparks rumours converting islam,6,2,-4,8,0.75,-0.5,1
17291393,WillieGeist,1713,829342,3854,18279,0,2,6,0,host sundaytoday co-host joe sunday sitdown podcast producer credit lucie george geist ep,sundaytoday starts now we live hawaii volcanic eruption ... white house rudy^on joe quotes secretary state pompeo responding senators questions abs^icymi sundaytoday great conversation singing oklahoma beauty pageants kid r^icymi sundaytoday great conversation singing oklahoma beauty pageants kid r^icymi sundaytoday great conversation singing oklahoma beauty pageants kid r^icymi sundaytoday great conversation singing oklahoma beauty pageants kid r^icymi sundaytoday great conversation singing oklahoma beauty pageants kid r^icymi sundaytoday great conversation singing oklahoma beauty pageants kid r,6,2,-4,8,0.75,-0.5,1
24331426,JohnjayVanEs,5523,126366,476,94204,0,1,6,1,follow snapchat johnjayvanes loveup,during interview fox news monday chris wallace asked vladimir putin many enemies ended up^kim kardashian says kanye west got fight band aids it started tried put one mouth^brad pitt spotted cozying chelsea handler proving worse things benjamin button^kim kardashian says kanye west got fight band aids it started tried put one mouth^kim kardashian says kanye west got fight band aids it started tried put one mouth^angelina jolie reportedly devastated rumors brad pitt reconciling jennifer aniston not nearly a^a new study found air pollution could lower iq so air pollution something common watching^american idol renewed second season the news shocked tv viewers idea american idol first season abc,6,2,-4,8,0.75,-0.5,1
157997359,heraldscotland,1378,104119,987,193967,1,1,5,1,subscribe exclusive access eert opinion unrivalled insight,breaking george hw bush st president united states died age spokesman said^man arrested murder charge hostage incident los angeles supermarket^angela haggerty kim kardashian n't need backlash advertising appetite suppressants needs help^angela haggerty kim kardashian n't need backlash advertising appetite suppressants needs help^sir billy connolly wife pamela stephenson hits back parkinson tv host said comedian failed recognise^sir michael parkinson billy connolly wonderful brain dulled^sir michael parkinson billy connolly wonderful brain dulled^billboard music awards stars pay tribute avicii,6,2,-4,8,0.75,-0.5,1
12663042,scj,812,26542,437,150719,0,2,6,0,home sioux city journal siouxcity iowa serving readers since send us photos opinions tips suggestions reach us -293-4250,what popular baby names state year born^chicago police multiple victims reported shooting hospital^maddie 'poppe larity leads 'american idol season win^maddie 'poppe larity leads 'american idol season win^maddie 'poppe larity leads 'american idol season win^nfl predictions who come top draft^mlb predictions who come top^today birthdays sept. beyonce knowles,6,2,-4,8,0.75,-0.5,1
1039015705,NewsNationTV,413,149720,613,272426,0,0,7,1,latest breaking news alerts india world retweets endorsements,happy new boyfriend alex rodrguez^i n't enjoy single says angelinajolie split bradpitt^angelinajolie jolie 'relieved dcfs closes child abuse case estranged husband bradpitt^who handsome new man angelinajolie life^selfie obsession ridiculous says kim kardashian^davidbeckham face trial speeding offence^myanmar dam overflow displaces thousands myanmarflood^madonna throws gypsy themed birthday party,7,1,-6,8,0.875,-0.75,1
16788263,OnSMASH,3269,74854,1143,176155,0,0,7,1,your favorite website favorite website destination music videos sports lifestyle since often imitated never duplicated,kanye west called drake mrs. kim kardashian west^breaking kanye west ix9ine amp nicki minaj music video set shot beverly hills story^mrs. west announces new release date yandhi album^yandhi pushed back kim kardashian announces new release date kanye album^kanye west went another rant said i best living recording artist he also talked mind contro^kanye west called drake mrs. kim kardashian west^quentin tarantino casts charles manson amp bruce lee actors once upon a time in hollywood film^cardi b confirms offset secretly got married last year,7,1,-6,8,0.875,-0.75,1
28288336,KristynBurtt,1034,10384,377,89422,0,1,7,0,dance eert commercial dance journalist host tothepointe dancedishwithkb correspondent business inquiries dancedishwithkb.com,good news the emmys back sunday sunday september .^runs ... books trip lindsay lohan beach club like^maks chmerkovskiy skipped dwts performance due 'big chemistry issue with partner vanessa lachey dwts^derek hough live kelly ryan today^derek hough live kelly ryan today^are dating katie holmes jamie foxx keep us guessing via privacyiskey^dancing with the stars season cast cheryl burke wants blake shelton producer wants jane fonda dwts^maks chmerkovskiy skipped dwts performance due 'big chemistry issue with partner vanessa lachey dwts,7,1,-6,8,0.875,-0.75,1
1705116025,973NASH,355,1225,15,13629,0,0,7,1,home country music peoria w/ brian official station,miranda lambert blake shelton affair ex claims via^miranda lambert blake shelton affair ex claims via^blake shelton sultry new single turnin me on was inspired gwen stefani listen^miranda lambert blake shelton affair ex claims via^miranda lambert blake shelton affair ex claims via^watch rachel reinert play it forward covering sheryl crow strong enough^miranda lambert blake shelton affair ex claims via^jason aldean wife brittany are eecting baby no,7,1,-6,8,0.875,-0.75,1
303862998,PDChina,5233,7076968,7252,76471,1,6,0,0,the largest newspaper group china timely updates,us congresswoman urged house representatives officially recognize chinese lunar new year as^china eected fulfill reduction target greenhouse gases emission given drop the^china agreed allow import us rice first time history us department agriculture announced o^china foreign ministry wed said us accusations higher chinese tariffs us goods pilfering us innovations^existing trade agreements void us imposes tariffs chinese goods spokesman ministry foreign^the white house saturday announced members us delegation participate trade talks chin^commentary in current china us trade war us repeatedly accused china cheating trade but fa,1,6,5,7,0.14285714285714285,0.7142857142857143,0
16490974,KarenCivil,1423,457695,3312,90259,0,0,1,6,philanthropist entrepreneur harvard business alumna tedx talk making things happen,civilcourt who come top betawards^second suspect arrested in xxxtentacion murder case^second suspect arrested in xxxtentacion murder case^kendrick lamar sza team black panther soundtrack all the stars^the winners announced bet awards winners see complete list here^icymi eminem announces release date revival album^he back justin timberlake announces release date new album 'man of the woods,1,6,5,7,0.14285714285714285,0.7142857142857143,0
2982269822,TheQuint,313,323665,1087,276898,0,5,1,1,mobile-first digital news platform we signal noise,video samiuddin survived blows mob rumours cow slaughter hapur says police not^mehul choksi lawyer told court prevention money laundering act fit travel^economist arun shourie exclusive interview the quint said hollande claims confirmed everyt^economist arun shourie exclusive interview the quint said hollande claims confirmed everyt^video virat kohli weighed disastrous tour chatter rivalry james a^check official photographs royal wedding prince harry meghan markle royalwedding2018^inpics they engaged private roka guests chopra mu,1,6,5,7,0.14285714285714285,0.7142857142857143,0
11855772,NBCNewsWorld,361,281650,3699,78557,0,5,1,1,a dynamic look world events,assistant commissioner specialist operations neil basu makes statement following death woman england^in us saudi trade goods services worth 45b top erts us including aircraft^just in president trump directs u.s. trade rep identify 200b worth chinese goods additional tariffs^in us saudi trade goods services worth 45b top erts us including aircraft^in us saudi trade goods services worth 45b top erts us including aircraft^prince harry meghan markle delighted able share happy news public^kensington palace says britain prince harry meghan markle requesting understanding respect mark,1,6,5,7,0.14285714285714285,0.7142857142857143,0
12089642,VancouverSun,1020,244308,4055,280355,0,0,1,6,western canada largest news team send tips vantips.com follow us,jennifer aniston denies brad pitt houlder cry justin theroux split^princess charlotte smiles mum photos first day nursery school^meghan markle half sister fires back prince harry tactless comment family never^meghan markle half sister fires back prince harry tactless comment family never^steve martin martin short 'colonoscopy parties tom hanks^prince harry brings girlfriend meghan markle pippa middleton wedding reception^relive meghan markle prince harry big day the best royal wedding photos,1,6,5,7,0.14285714285714285,0.7142857142857143,0
71080496,NEWS1130,9903,232654,2634,293567,0,1,1,5,vancouver breaking news traffic weather station,israeli prime minister benjamin netanyahu says justin trudeau among personally asked israel evac^ent amal george clooney welcome birth twins^former fox news ceo roger ailes dead^a man whose network key success donald trump dead disgraced former fox news ceo roger ailes passed away morning^former fox news ceo roger ailes dead^richard simmons hospitalized his reps say went several days severe indigestion discomfo^uk actor daniel craig confirms play james bond,1,6,5,7,0.14285714285714285,0.7142857142857143,0
15169290,LibraryJournal,389,209927,6019,37039,1,6,0,0,library views news book reviews lj staffers,update statement association research libraries arl urges us house representatives restore net ne^internet archive political tv ad archive receives new funding continue vital work^rt internet archive political tv ad archive receives new funding continue vital work^icymi research tools data sets better understand presidential debates provided political tv ad archive^rt the internet archive new political tv ad archive now live online politics advertising^internet archive political tv ad archive receives new funding continue vital work^rt the internet archive new political tv ad archive now live online politics advertising,1,6,5,7,0.14285714285714285,0.7142857142857143,0
21780652,PittsburghPG,651,165440,2192,224724,0,0,1,6,the pittsburgh post-gazette serving western pa. years,the abc reboot american idol aka season continues tradition hometown visit finalists^'dance moms tv star abby lee miller sentenced year day prison^'dance moms star abby lee miller sentenced year day prison^nelly criminal investigation britain alleged sexual assault^between break ariana grande dui arrest followed last thing mac miller needed be^how get away murder star karla souza alleges raped violently attacked director^judge declares mistrial bill cosby sexual assault case,1,6,5,7,0.14285714285714285,0.7142857142857143,0
13215132,io9,647,145296,7311,91017,0,0,1,6,we come future by,robert pattinson almost fired twilight acting miserable felt^beyonc turned role beauty beast beneath^natalie portman n't take sass star wars prequels new snl rap^natalie portman n't take sass star wars prequels new snl rap^the biggest winners losers san diego comic con^the biggest winners losers san diego comic con^san diego comic con biggest winners losers,1,6,5,7,0.14285714285714285,0.7142857142857143,0
380662828,KenToddBH,302,137284,326,7090,0,0,1,6,i restaurateur bar owner yrs eerience owning londons los angeles top restaurants bars husband,jax taylor from 'vanderpump rules got himself involved in the kourtney kardashian breakup ... googlealerts^lisa vanderpump mourns death her beloved pink dog ''we are devastated '' googlealerts^vanderpump rules lala kent just made peace with enemies stassi schroeder katie maloney googlealerts^watch vanderpump rules new season opening credits now googlealerts^lisa vanderpump brings extra dash glamour beverly hills dog show googlealerts^real housewives beverly hills season update dorit kemsley will be back googlealerts^lisa vanderpump sounds off luann de lesseps divorce ''it shame '' googlealerts,1,6,5,7,0.14285714285714285,0.7142857142857143,0
16469116,news10nbc,1797,118728,848,129286,1,6,0,0,we rochester ny nbc affiliate featuring nys eed rochester rocs make sure like us,breaking joe robach statement says pursue seat us house representatives^brandon wentz passing nov. came near end year saw record number drug overdose deat^president donald trump asked republican national committee chairwoman ronna mcdaniel serve second term^the u.s. department education announced week automatically cancel 150 million student loan^brandon wentz passing nov. came near end year saw record number drug overdose deat^chicago police tell nbc news police officer possible offender among four victims critical con^we n't decide stuff like it national nbc decision made weeks months advance,1,6,5,7,0.14285714285714285,0.7142857142857143,0
2395148376,complex_uk,3694,117629,550,53956,0,0,1,6,making culture pop ig complex uk,california teenager gets turned prom shows kylie jenner instead^meet playboy first transgender playmate ines rau^everything know stranger things season far^justin timberlake announces release date new album 'man woods^kanye west writing philosophy book real time twitter^beyonc eminem weeknd headline coachella^'game thrones final season premieres first half,1,6,5,7,0.14285714285714285,0.7142857142857143,0
18228178,KOINNews,1002,114501,1675,168528,0,4,1,2,portland cbs affiliate breaking news in-depth investigations wx traffic,watch live vice president biden delivers statement rose garden^the last time john mccain spoke koin news october watch full interview^the last time john mccain spoke koin news october watch full interview^hosting thanksgiving year the u.s. department agriculture tips prepare safe thanksgiv^channing tatum wife jenna dewan tatum announce split^koko gorilla knew sign language dies^james franco denies sexual misconduct allegations,1,6,5,7,0.14285714285714285,0.7142857142857143,0
245424983,rweingarten,3086,95859,2007,132477,1,6,0,0,president aft- union professionals years old committed public schooling health care public services children families communities,thank delegation house representatives meeting us listening^so proud aft amp members ... inspire me.. amp sticking union great pittsbu^as i said state union speech yesterday state affairs normal i silent n^as i said state union speech yesterday state affairs normal i silent n^trump america ... .words matter incitement matters.. it coincidence soros clintons targets^make mistake pastorek u.s. department education secretary betsy devos share vision education clos^the eu enemy trump backward russia attacked democracy european democracies friends,1,6,5,7,0.14285714285714285,0.7142857142857143,0
55376380,MattGertz,1644,93592,1340,52310,0,6,1,0,senior fellow views eressed husband dad definitely gop congressman mgertz.org,as far i tell today fox news reported hannity interview trump last night camp^here rudy giuliani july interview sean hannity giuliani says trump made clear le^times subject jurisdiction thereof argument made fox amp friends morning *6:05 via clip of^on sunday discussed caravan shows fox news presidency action with^/4 rob ford rt congressional job approval lowest approval rating history^trump rambling place based transcript went record lot and sole news source fox amp friends^taylor swift endorsed democrats fox amp friends feelings charlie kirk look taylor swift,1,6,5,7,0.14285714285714285,0.7142857142857143,0
15292065,vcstar,328,75446,784,94057,0,4,1,2,news stories selected ventura county star team local business sports crime food politics education,amid new e. coli outbreak americans eat romaine lettuce centers disease control a^after social media blew debate laurel vs. yanny recorded audio wo^amid new e. coli outbreak americans eat romaine lettuce centers disease control a^at least third accident week pacific coast highway south mugu rock sends bicyclist hospital.^the seven finalists rebooted season plus season winner the^emmy winning actress julia louis dreyfus announces twitter diagnosed breast cancer^jennifer lawrence darren aronofsky apparently split one year dating,1,6,5,7,0.14285714285714285,0.7142857142857143,0
97106823,bobcesca_go,1002,47763,1145,79782,0,6,1,0,bob cesca show writer stephanie miller show john fugelsang siriusxm,from the blog staff i watched sarah palin cpac speech so you don have to^i watched sarah palin cpac speech so you don have to p2 tcot cpac^daily banter staff i watched sarah palin cpac speech so you don have to^my latest at banter i watched sarah palin cpac speech so you don have to^i watched sarah palin cpac speech so you don have to^a year 'll talking democratic presidential debates i n't think i 'm ready^why room 're tabulating votes orange county is msnbc *trying* give rep,1,6,5,7,0.14285714285714285,0.7142857142857143,0
17900402,BlackBookMedia_,8494,46809,1194,38299,0,0,1,6,the culture now,blackbook exclusive recipes from exalted chef ruth rogers new 'river cafe london ruthrogers rivercafelondon^prince harry is engaged meghan markle princeharry princeharryengaged meghanmarkle royalfamily thequeen^queen elizabeth sits front row at london fashion week next anna wintour annawintour queenelizabeth london^reese witherspoon may getting role lifetime look back best^justin timberlake announces new album titled 'man woods justintimberlake jessicabiel manofthewoods^lady gaga announces opening dates for las vegas residency lasvegas ladygaga enigma^a michael jackson musical is coming broadway michaeljackson broadway musicals,1,6,5,7,0.14285714285714285,0.7142857142857143,0
16950863,KRLD,920,38466,950,114635,1,3,0,3,dallas-fort worth radio station news weather traffic streaming,texas ag commissioner blames staffer offensive tweet first saying account hacked.^react news orlando mass shooting^the dallas county sheriff office person want talk fatal accident saturday morning^vice president joe biden set deliver statement rose garden watch live^justin timberlake announces man of the woods tour coming to dallas^country music legend loretta lynn admitted hospital nashville last night suffering stroke^april the giraffe is pregnant again,1,6,5,7,0.14285714285714285,0.7142857142857143,0
28645139,wdefnews12,1594,35340,501,93499,0,5,1,1,anytime anywhere,..house democratic leader nancy pelosi said matthew whitaker recuse revie^^jeff glor speaks scotland see preview^trump holds campaign style rally las vegas live stream^well i think lot foes i think european union foe us trade now wo^mariah carey new year eve performance 'they foiled^john dickerson replaces charlie rose cbs this morning,1,6,5,7,0.14285714285714285,0.7142857142857143,0
824720523904978944,WTFJHT,1,31559,512,13011,0,6,1,0,today essential political news logging daily shock awe national politics read moderation curated daily kiser,rudy giuliani said robert mueller agreed limit scope potential interview trump two topics in^trump would agree interview robert mueller long questions obstruction jus^rudy giuliani robert mueller end investigation possible obstruction justice sept. trum^michael cohen resigned post deputy finance chair republican national committee^trump held interview fox friends white house lawn musing twitter maybe i'll^trump i think european union foe^trump rescinds rules bathrooms transgender students,1,6,5,7,0.14285714285714285,0.7142857142857143,0
12673222,93wibc,1795,29111,693,98260,1,4,0,2,on level on go -9am am-1pm am-11am pm-7pm instagram,news ohio police called search year old devin holston body found home p^republican congressman elect dan crenshaw texas repeatedly challenged three newly elected democrats defend th^news president trump indy weekend deliver speech national ffa convention.^monday afternoon joined show talk president trump sunday interview fo^wants know hillary clinton sen. joe donnelly getting free pass racist comme^wibc poll do n't forget still time vote whether think right man pla^jj watt going pay funerals victims santa fe high school shooting the world could use,1,6,5,7,0.14285714285714285,0.7142857142857143,0
67958182,MicahGrimes,3877,26616,1044,104807,1,5,0,1,head social -- foreign domestic reporting analysis context breaking news connecting dots humour,rt cnn rumored shutting snapchat show nbc news whose parent company significant investment s^in latest statement white house press sec sanders says stand statement revocation journa^and live interview morning show fox friends^in tweet rep. tulsi gabbard slams president trump saudi arabia bitch president statement^the president tweet ms waters contained false statement insult sounds like threat but e^in us saudi trade goods services worth 45b top erts us inc^just in loretta lynn admitted nashville hospital suffering stroke home statement website says shows postponed,1,6,5,7,0.14285714285714285,0.7142857142857143,0
218347440,chrisdonovan,1670,19254,407,15410,0,6,1,0,executive editorial producer abc news/dedicated red sox patriots fan,on day history significant events st century u.s. foreign policy oct war afghanistan b^here transcript interview rudy giuliani morning^video full must watch interview rudy giuliani^reminder history giuliani amp biden flashback biden democratic presidential debate oct^years ago today december tim russert debuted moderator meet press my favorite words of^a reminder less months ago president trump argued north korea stood dicta^in interviews released today president donald trump criticized jim comey showboat amp stephen colbert talking filthy,1,6,5,7,0.14285714285714285,0.7142857142857143,0
22662550,NickReisman,1550,17970,574,72562,0,6,1,0,new york state politics reporter spectrum news send tips complaints nick dot reisman charter dot com contact signal,cuomo campaign announce today endorsement league conservation voters^new york league conservation voters endorses marcellino^onondaga county gop endorsed rep. john katko day delivers weekly republican address^our revolution political organization grew sen. bernie sanders presidential campaign endors^cuomo speech interrupted democratic convention protesters chanting end overdose deaths w^via hillary clinton give keynote speech nys democratic convention^cuomo if name recognition i 'm hoping brad pitt angelina jolie billy joel n't get race,1,6,5,7,0.14285714285714285,0.7142857142857143,0
36510873,davidjoachim,5114,15626,654,49889,0,6,1,0,everyone needs editor investigations bloomberg ex-nyt ex-gwu adjunct opinions mine mine mine dm signal,scoop trump legal team prepared written responses mueller questions wo n't submit t^several prominent democrats worked paul manafort dragged court filings ahead fr^bloomberg trump former personal lawyer michael cohen resigned position republican national com^that written donald trump jr. /12/17 the president involved drafting statement^politico says giuliani still considering run hired spokeswoman new hampshire^trump tough talk hedge fund taxes does n't match his plan^trump frequently used word 'nigger host reality television show 'celebrity apprenti,1,6,5,7,0.14285714285714285,0.7142857142857143,0
351669463,KSNTNews,609,11904,357,80803,0,3,1,3,official twitter account ksnt news got news tip tweet us email news.com,the centers disease control prevention says popular kellogg cereal linked salmonella outb^live blog behind scenes first presidential debate hofstra university^white house vice president joe biden make statement rose garden^calling royals fans icymi another royal wedding took place yesterday five months prince harry megh^james franco denies sexual misconduct allegations^former fox news ceo roger ailes dead^new york ap msnbc confirmed morning joe co hosts joe scarborough mika brzezinski engaged,1,6,5,7,0.14285714285714285,0.7142857142857143,0
14952204,yidio,2119,11159,134,19811,0,0,1,6,watch tv movies one place staying up-to-date latest entertainment news editors,is dating^parties new woman after split click link details^alec baldwin president click link find plans run potus^priyanka chopra are engaged^freeform abc stations air sunday benefit concert manchester england u.s.^new parents george amal clooney took break parental duties enjoy date night lake como italy.^amp jennifer garner officially file divorce,1,6,5,7,0.14285714285714285,0.7142857142857143,0
20607098,EagleGazette,73,5836,145,31142,0,1,1,5,this twitter account lancaster eagle-gazette lancaster ohio we covering news fairfield county since,fairfield county engineer jeremiah upp attended president donald trump address joint session congress^trump assertion left wing protesters violent white supremacists charlottesville sets firestorm^the best memorial day sales home appliances^the best memorial day sales home appliances^summer phoenix files divorce husband casey affleck^summer phoenix files divorce husband casey affleck^oscars the complete winners list,1,6,5,7,0.14285714285714285,0.7142857142857143,0
120264410,echerneff,2472,2761,68,18492,0,1,1,5,prono churn-eff producer previously alumna volunteer redsoxnation rts endorsements,'stormin mormon mitt romney would election 'd used campaign ads ...^she good person married person terrible things and make go o^the south park meme though ... 'steven seagal is that you twitter roasts actor after live interview from russia^ca n't say surprise 'the bachelor nick viall vanessa grimaldi end their engagement^more royal wedding news meghan markle dad says he won attend her wedding after all h/t^aww poor jodie haters gon na hate gt rt i think nbc live streamed first televised midlife crisis goldenglobes^if 're like want know royal fashion details gt meghan markle engagement,1,6,5,7,0.14285714285714285,0.7142857142857143,0
31066684,JasonCalabretta,704,2339,72,16392,0,2,1,4,producer alum instagram email jason.calabretta.com,president trump make statement rose garden :30pmet^wh president obama deliver statement :30pm et paris agreement rose garden^north korea threatens guam trump warns regime fire fury reports^nbc next live musical 'jesus christ superstar live^the 'brady bunch house sale 2 million^meryl streep joins big little lies season^michael jackson musical coming broadway,1,6,5,7,0.14285714285714285,0.7142857142857143,0
157129202,WGNTCW27,1112,1854,60,23088,0,0,1,6,hampton roads cw affiliate the home of tamronhall drphil judgejudy like us facebook,taylor swift new music video a guide means^tmz superman star margot kidder dead^justin timberlake announces new album man woods^storm chasers star joel taylor dead^ellen degeneres cries receiving best birthday gift portia de rossi^taylor swift announces new album reputation^meryl streep joins big little lies season,1,6,5,7,0.14285714285714285,0.7142857142857143,0
14352556,seattletimes,12723,636803,7014,168522,1,5,1,0,local news sports business politics entertainment travel restaurants opinion seattle pacific northwest tweet us news tips dm,major u.s. stock markets closed wednesday national day mourning honor former president george h.w bush^the league conservation voters victory fund anti rossi ad campaign largest among 15 mill^the report program trustees says medicare become insolvent three years earlier previously f^betsy devos proposed narrowing schools obligations comes responding sexual misconduct startin^seattle music licensing firm sues cruz campaign songs ads^seattle music licensing firm audiosocket sues ted cruz campaign songs used ads^what covfefe mysterious trump tweet unites bewildered nation,2,5,3,7,0.2857142857142857,0.42857142857142855,0
13557972,blackvoices,19382,426080,4669,84421,0,0,2,5,black news culture entertainment opinion allblacklivesmatter need help huffpost login membership tweet,hannibal buress arrested disorderly intoxication miami^gayle king says oprah intrigued idea running president^will smith jada pinkett smith married years n't like call marr^will smith jada pinkett smith married years n't like call marr^star jones ex husband al reynolds comes bisexual^jennifer hudson set join the voice coach season^actor ving rhames says police officers held gunpoint home santa monica neighbors r,2,5,3,7,0.2857142857142857,0.42857142857142855,0
94761188,NewIndianXpress,532,375533,1372,548584,2,3,0,2,all tweets breaking news views facebook youtube,indian american aruna miller vying enter house representatives lower chamber us congress^congressman ted poe said house representatives pakistan receive financial support from^claiming reverse countdown begun narendra modi government centre upa chairperson sonia ga^the planned us trade sanctions beijing include restrictions chinese investment ert controls percen^ten days ago white house announced truce trade hostilities china us treasury secretary steven m^the first months year strongest first quarter gold jewellery demand united states sinc^tweeted disapproval redesign company video messaging app snapchat calling sad,2,5,3,7,0.2857142857142857,0.42857142857142855,0
19050000,FinancialReview,327,291685,3337,174718,1,4,1,1,for years the australian financial review authority business finance political news australia,paul ryan top republican us house representatives uneectedly says wo n't seek election no^us department agriculture updated crop forecasts keenly awaited ausbiz^only one four say banks take responsibility mistakes keep promises customers according findings i^china raise import duties 45.6b list american goods retaliation us tariff hikes chinese goo^us president set approve 67b tariffs chinese goods politics trade^how brad pitt angelina jolie split huge empire wealth divorce legal^the queen royal staff reportedly called emergency meeting buckingham palace palace,2,5,3,7,0.2857142857142857,0.42857142857142855,0
69329527,BBCNorthAmerica,806,261609,3980,67073,1,1,1,4,the latest news feature stories reporters united states canada,three people suspected gunman found dead shooting nursing home ohio^us president barack obama launches twitter feed white house confirms^serena williams john mcenroe believes would struggle men circuit^kelly clarkson 'when i really skinny i wanted kill^justin bieber cancels remaining purpose world tour dates^royal wedding meghan markle father walk aisle^lady gaga announces two year las vegas residency,2,5,3,7,0.2857142857142857,0.42857142857142855,0
5692662,austin360,9094,250484,2848,59229,0,1,2,4,entertainment food music live music capital world,what texans naming babies here top popular baby names state^one place one weekend all projects solved the rd annual austin fall home amp garden show meet the^get home improvement questions answered the rd annual austin fall home amp garden show meet the^tom petty dead last played austin may erwin center^meghan markle maid honor royal wedding^actor vince vaughn arrested suspicion dui california^michael jackson musical coming broadway,2,5,3,7,0.2857142857142857,0.42857142857142855,0
14838173,NC5,543,243650,1320,134926,0,4,2,1,safe informed connected,the centers disease control prevention issued alert tuesday warning consumers eat type rom^the us centers disease control prevention warning us consumers tuesday eat romaine lettuce as^the centers disease control prevention issued alert tuesday warning consumers eat type rom^the us centers disease control prevention warning us consumers tuesday eat romaine lettuce as^amal george clooney welcome twins^caitlyn jenner latest celebrity float run office^prince harry market he proposed engaged actress meghan markle,2,5,3,7,0.2857142857142857,0.42857142857142855,0
25049056,France24_en,1161,218874,5277,268967,0,2,2,3,the french international news channel live /7 paris follow us top stories business politics sports breaking alerts,europe migrant crisis salvini statement distorsion going right^us lists chinese goods face tariffs latest trade war salvo^trump warns north korea 'fire fury^brad pitt start le mans hour race^aisle meghan markle dad ca n't attend royal wedding^legendary us comedian don rickles dies age^'nypd blue creator steven bochco dead,2,5,3,7,0.2857142857142857,0.42857142857142855,0
8942262,newsobserver,559,213657,2531,135840,0,5,2,0,the news observer brings best news sports photos video raleigh durham chapel hill cary central eastern north carolina,the centers disease control prevention warn chickenpox serious even life threatening especially^the centers disease control prevention warn chickenpox serious even life threatening especially^state health plan fix back thursday legislation bail state health plan eected back before..^state health plan fix hold legislation shore state health plan bogging concerns that..^four north carolina children hospitals rank among top pediatric hospitals nationwide least one speci^raleigh man korean bbq tacos look love live kelly ryan^raleigh man korean bbq tacos look love live kelly ryan,2,5,3,7,0.2857142857142857,0.42857142857142855,0
10946932,WMCActionNews5,2215,197276,1318,143464,0,0,2,5,tweets newsroom wmc action news featuring memphis/mid-south breaking news traffic weather wmc5,nascar owners threaten fire drivers protest national anthem^channing tatum wife jenna dewan tatum announce split wmc5^walmart remove 'cosmopolitan checkout lines wmc5^meghan markle dad wo n't attend royal wedding wmc5^colin trevorrow back direct jurassic world wmc5^beyonce eminem the weeknd headline coachella gt gt^april giraffe pregnant wmc5 gt gt,2,5,3,7,0.2857142857142857,0.42857142857142855,0
15823826,THV11,931,160329,892,180644,0,2,2,3,official page thv11 little rock arkansas covering news weather sports call 501 -4564 email news.com,here full transcript stormydaniels minutes interview aired tonight.^breaking vice president make statement rose garden :10 p.m^reports brad pitt accused child abuse investigation^stars react texas church shooting grief disbelief 'no words numb again^koko gorilla knew sign language dies^walmart remove 'cosmopolitan magazine checkout lines amid metoo movement 'one less drop hyper sexual^'nypd blue creator steven bochco dead,2,5,3,7,0.2857142857142857,0.42857142857142855,0
18058293,waff48,603,138146,904,125428,0,0,2,5,your first alert breaking news weather throughout tennessee valley,actor chris pratt officially files divorce wife anna faris gt gt^david cassidy fighting memory loss wants 'enjoy life^walmart remove 'cosmopolitan checkout lines^meghan markle dad wo n't attend royal wedding^actor jeremy london arrested ms domestic violence gt gt^actor chris pratt officially files divorce wife anna faris gt gt^april giraffe pregnant gt gt,2,5,3,7,0.2857142857142857,0.42857142857142855,0
10878852,CBSDFW,1203,137008,2229,190682,1,3,1,2,breaking local news staff cbs news d/fw,texas ag commissioner blames staffer offensive tweet first saying account hacked.^according report released centers disease control prevention week suicide rates nationwid^react news orlando mass shooting^vice president joe biden set deliver statement rose garden watch live^the american clergyman preached power love royal wedding prince harry meghan markle^justin timberlake announces man of the woods tour coming to dallas^country music legend loretta lynn admitted hospital nashville last night suffering stroke,2,5,3,7,0.2857142857142857,0.42857142857142855,0
43930301,WDRBNews,1368,132482,813,224710,2,0,0,5,wdrb news fox affiliate louisville providing news sports weather traffic strongest journalism team kentucky,new york ap federal prosecutors charge nyc subway bomb suspect say wrote facebook trump failed t^melania trump undergoes kidney surgery walter reed medical center^the jury deadlocked sexual assault case bill cosby^'superman star margot kidder dead^erin moran star 'happy days found dead southern indiana^'big bang theory star kaley cuoco marries equestrian karl cook^wwe star vader dead ...,2,5,3,7,0.2857142857142857,0.42857142857142855,0
14592411,cbsaustin,13929,100861,1796,156239,0,3,2,2,news weather sports updates cbs austin austin texas,just in at austin meeting republican national committee selects charlotte north carolina host convention^today join roundtable discussion president trump st address joint session congress watch live^watch live trump campaigns rudy giuliani new hampshire^report angelina jolie named bizarre lax terror threat sent police^former miss utah trump accuser holding press conference salt lake city^mario batali includes cinnamon roll recipe apology sexual misconduct^third suspect arrested xxxtentacion murder,2,5,3,7,0.2857142857142857,0.42857142857142855,0
171802941,9NewsSyd,194,99970,985,248083,0,1,2,4,sydney no.1 news knight nightly 0pm news,the trial man accused killing wife milperra home opened today year old warren rog^the colourful language wicked sense humour sharp observations billy connolly seem slowly leaving u^in service lasting hours performers including faith hill ariana grande jennifer hudson stevie wonder pa^actress heather locklear arrested domestic violence allegedly assaulting police officer news^breaking prince charles walk meghan markle aisle tomorrow royal wedding news^the royal wedding days away tonight event turmoil reports meghan markle father n^new details released wedding year meghan markle prince harry revealing is,2,5,3,7,0.2857142857142857,0.42857142857142855,0
16296575,KRDONC13,4016,82178,983,133485,2,4,0,1,colorado springs pueblo breakingnews cowx krdo newschannel reply news tips call newsroom -575-6285,"breaking george hw bush died age^doj code federal regulations reason recused russian investigation sessionshearing^andrew romanoff contender us senate pulls ahead sen. michael bennet colorado democratic caucus right ...^u.s. senate democrat ,458 precincts reporting 14 michael bennet ,02449 andrew romanoff ...^election democrat andrew romanoff concedes michael bennet u.s. senate race romanoff bennet^the year old called the champion magazine features one four covers december 'men ye^aly raisman sues us olympic committee usa gymnastics",2,5,3,7,0.2857142857142857,0.42857142857142855,0
18720099,tmj4,967,67247,1028,86233,0,2,2,3,breaking news accurate weather call news tipline -963-4444,the centers disease control prevention simply trying warn americans dangers posed ticks^good news the u.s. centers disease control prevention declared safe eat leafy green o^amal george clooney welcome twins^mariah carey releases audiotape elanation nye debacle they foiled^that stunt wendy williams faints live tv^'the brady bunch house sale 1.885 million take look inside^mila kunis makes monthly donations planned parenthood mike pence name,2,5,3,7,0.2857142857142857,0.42857142857142855,0
26676275,SPECNewsAlbany,1403,66436,713,85310,0,4,2,1,spectrum news offers best -hour local news coverage capital region plus weather sports favorite features,coming up delivers speech convention long island watch online^live vice president joe biden make statement rose garden watch gt^headline obama address union labor day picnic president barack obama speaking health care..^soon deliver remarks ny delegates philadelphia watch live^if name recognition i 'm hoping brad pitt angelina jolie billy joel n't get r^miss press conference update salt miners rescued lansing watch here gt via^in case missed aprilthegiraffe pregnant here see oliver excitement baby no with,2,5,3,7,0.2857142857142857,0.42857142857142855,0
2785973124,AccelerateTV,122,58266,44,17622,0,0,2,5,more entertainment african stories educate entertain empower ig tv /youtube,check out the full winners list for emmy awards^its a bond girl daniel craig amp rachel weisz welcome st child^second suspect arrested in xxxtentacion murder^second suspect arrested in xxxtentacion murder^fourth amp final suspect arrested in murder of xxxtentacion^justin timberlake announces new album man woods^kim kardashian shares first photo baby chicago west,2,5,3,7,0.2857142857142857,0.42857142857142855,0
17813513,jeremynewberger,7612,50159,442,77969,0,5,2,0,political satirist filmmaker daily riffing potus army sycophants liars thieves tweeting way collective zeitgeist,he also brought holocaust denier state union total boner racist douche bag like^cuomo cnn chyron right reads brought holocaust denier state union^cuomo cnn chyron right reads brought holocaust denier state union^corey dumb ass confused rosanne barr o'donnell fox news sunday foxnewssunday^at today white house briefing sarah sanders plans put jim acosta lap pull trousers paddl^i enjoy single. angelina jolie how happen^nbc really fudged lester holt interview letting trump confess russian collusion without taping w,2,5,3,7,0.2857142857142857,0.42857142857142855,0
25106589,NACAC,1448,37979,861,27093,2,5,0,0,"nacac org ,000 professionals around world dedicated serving students make choices pursuing higher education nacac",take action us stop house representatives passing prosperact bill would^take action us stop house representatives passing prosperact bill would help preda^nacac past president patrick o'connor first school counselor selected us department educati^nacac past president patrick o'connor first school counselor selected us department educat^the us department education wants help students avoid common errors share tips student^the us department education wants help students avoid common errors share tips student^nacac past president patrick o'connor first school counselor selected us department educati,2,5,3,7,0.2857142857142857,0.42857142857142855,0
14416109,alexanderrusso,7111,27703,1249,78951,1,5,1,0,award-winning journalist examining media coverage education issues more newsletter signup archive,virginia republican wants schools to check children genitals before using bathroom occupy democrats^while top agencies hit foia suits remained justice homeland security u.s. department education^the latest best week newsletter featuring debate school discipline reform coverage an^the president tweet ms waters contained false statement insult sounds like threat but e^news big stories of the day for education chief stimulus means power money risk nyt arne duncan must dec..^more newark students going college one four earns degree within six years new report finds^trump rescinds rules bathrooms transgender students,2,5,3,7,0.2857142857142857,0.42857142857142855,0
828978119138701312,msianinsight,14,24346,161,176531,0,5,2,0,an unvarnished view issues day sidelined sands time download app the malaysian insight free android ios,in week episode toomuchinformation host dissects reaction finance minister^rosmah mansor arrived macc statement taken probe src international subsidiary^motion make dr mahathir un speech foreign policy framework^dr mahathir un speech basis foreign policy^us escalates trade war slap tariffs rm806 billion chinese goods^trump warns north korea fire fury^myanmar dam overflow displaces tens thousands,2,5,3,7,0.2857142857142857,0.42857142857142855,0
18939358,hunterschwarz,1776,21146,795,57123,1,3,1,2,reporter author yello zine email newsletter culture branding visual rhetoric politics america subscribe,melania trump undergoes kidney surgery walter reed medical center^sarah palin zinger nazis delivered cpac speech^here future first lady efforts combat online bullying going far minutes transc^the year bernie sanders announcing second presidential campaign he steps lectern tap^henry b eyeing named second counselor mormon church first presidency gave shoutout press^celine dion perform my heart will go on billboard music awards honor titanic th anniversary^andrew garfield i gay man right without physical act,2,5,3,7,0.2857142857142857,0.42857142857142855,0
15823588,DeathAndTaxes,776,20348,765,53261,0,0,2,5,culture politics channel send tips tips.com,robert pattinson finally responded donald trump bizarre tweets relationship kristen stewart^robert pattinson finally responded donald trump bizarre tweets relationship kristen stewart^youtube star austin jones arrested child pornography charges^donald trump almost played president sharknado^donald trump almost played president sharknado^donald trump almost played president sharknado^geraldo rivera apologizes bette midler alleged groping,2,5,3,7,0.2857142857142857,0.42857142857142855,0
24959025,bakersfieldnow,508,19106,448,77348,1,3,1,2,welcome official twitter page eyewitness news kbak-cbs fox58 bakersfield california,first lady melania trump headlines town hall today address nation opioid epidemic watch p.m. on^join us today live roundtable discussion president trump st address joint session congress.^recall alert tens thousands pounds jimmy dean meat products possibly containing pieces metal have^despite local state laws requiring dog owners carry license dog household^report angelina jolie named bizarre lax terror threat sent police^tom petty dead the rock legend found unconscious rushed hospital sunday night suffering a^is kylie jenner pregnant reports say may addition jenner kardashian family,2,5,3,7,0.2857142857142857,0.42857142857142855,0
21946225,jonbernhardt,644,8924,344,33885,0,5,2,0,co-host patch notes sports/gaming writer free agent jlbernhardt gmail dot com,need transcript order assess conversation lasted longer three minutes need lo^i wonder point trump get mad democratic presidential primary n't elicitly always a^trump going much ghoulish fun democratic presidential primary i would n't shocked fl^i wonder point trump get mad democratic presidential primary n't elicitly always a^trump going much ghoulish fun democratic presidential primary i would n't shocked fl^we 're talking impeachment unless bipartisan moronic even need gop votes way force^instead going james greer 've got captain thomas harper played kevin costner costner gene,2,5,3,7,0.2857142857142857,0.42857142857142855,0
16875261,LeafChronicle,660,8923,214,73551,1,3,1,2,clarksville tn fort campbell ky. largest source information story tips send news.com snapchat leafchronicle,nancy pelosi fights regain house speaker role la auto show keystone xl things know wednesday^no mid oct. paycheck troops government shuts lawmaker says with one week go potentia ...^shooting near chicago hospital leaves multiple victims^shooting chicago hospital leaves multiple victims^key lawmakers seek probe kellyanne conway 'go buy ivanka stuff message^here popular halloween candy every state^oscars the complete winners list,2,5,3,7,0.2857142857142857,0.42857142857142855,0
48413629,SPECNewsSTier,291,3554,126,42584,0,3,2,2,spectrum news offers best -hour local news coverage plus weather sports favorite features,coming up delivers speech convention long island watch online^live vice president joe biden make statement rose garden watch gt^soon deliver remarks ny delegates philadelphia watch live^if name recognition i 'm hoping brad pitt angelina jolie billy joel n't get r^miss press conference update salt miners rescued lansing watch full presser gt^april giraffe pregnant the giraffe mainstay small town animal park new york southern tie^in case missed pregnant here see oliver excitement baby no with,2,5,3,7,0.2857142857142857,0.42857142857142855,0
57735773,AllthingsFOX30,1167,2888,121,37989,0,3,2,2,jax news weather sports community fox programming plus little behind scenes ... get,missing maryland teenager found safe new jersey^chicago mercy hospital shooting what know victims^multiple victims chicago hospital shooting reports say^prince harry meghan markle a relationship timeline^celebrities react death linkin park singer chester bennington^labor day deals sales macy walmart best buy^ving rhames says police held gunpoint home neighbor reported burglary,2,5,3,7,0.2857142857142857,0.42857142857142855,0
34043346,magic1021,236,885,24,12662,1,1,1,4,today,read transcript sen. jeff flake speech comparing pres donald trump josef stalin^read transcript sen. jeff flake speech comparing pres donald trump josef stalin^katie couric breaks silence news matt lauer dismissal 'today^tamar braxton files divorce husband manager vincent herbert^justin theroux breaks social media silence jennifer aniston split^labor day deals sales macy walmart best buy^celine dion donates concert proceeds victims las vegas shooting,2,5,3,7,0.2857142857142857,0.42857142857142855,0
134758540,timesofindia,539,12102417,11337,500505,1,3,2,1,news views analysis conversations india no.1 digital news destination world largest-selling english newspaper a times internet limited product,snapchat shutting service via^philando castile stopped times police was racial profiling^live pm president issue joint statement at^trade war us lists next 200 billion chinese goods face tariffs via^north korea says considering strike guam trump warns 'fire fury via^video brad pitt amp angelina jolie end custody battle via^miles teller arrested allegedly drunk public details ...,3,4,1,7,0.42857142857142855,0.14285714285714285,0
275686563,verge,165,2572926,36799,163076,1,0,2,4,covers life future,the cnn porn scare fake news spreads^the complete list grammy award winners^the complete list grammy award winners^the best tech sales memorial day^the best tech sales memorial day^louis ck accused sexual misconduct five women^the weinstein company plans file bankruptcy,3,4,1,7,0.42857142857142855,0.14285714285714285,0
16560657,BET,2271,2248668,7159,197812,0,0,3,4,official twitter bet networks home hiphopawards theovalonbet sistasonbet soultrainawards,it looks like threw shade disastrous performance^is hooking ex the rumors swirling^former nfl star good morning america co host michael strahan attended nickelodeon kids choice sports awards^another suspect arrested xxxtentacion murder betbreaks^nd suspect arrested xxxtentacion murder case betbreaks^another suspect arrested xxxtentacion murder betbreaks^another suspect arrested xxxtentacion murder betbreaks,3,4,1,7,0.42857142857142855,0.14285714285714285,0
20065936,mental_floss,13323,712522,13694,93465,0,4,3,0,feel smart,the most popular baby names by state^the most popular baby names by state^the most popular baby names state^the most popular baby names by state^mark hamill asks 'star wars fans help get carrie fisher hollywood star^mark hamill asks 'star wars fans help get carrie fisher hollywood star^stranger things eleven was supposed die season one,3,4,1,7,0.42857142857142855,0.14285714285714285,0
20546297,popstarmagazine,4374,402479,1947,40235,0,0,3,4,we got covered things pop culture,cheryl cole is all about singlehood after liam payne split popstar^shannen doherty talks cancer remission charmed reboot popstar^takes break promoting new single most girls squash dating rumors^billboard music awards see the complete list of winners here popstar^billboard music awards see the complete list of winners here popstar^the academy country music awards the highlights plus see the complete list of winners here popstar^oscars the complete list of winners popstar,3,4,1,7,0.42857142857142855,0.14285714285714285,0
18937505,officialcharts,3967,243847,2107,93651,0,0,3,4,the latest music news facts stats uk official chart get charts direct inbox subscribe newsletter,fresh performance amp polaroid set debut the^listen week tbt official charts flashback spotify ft. huge hits the script taylor swift a^official scottish albums chart a star is born cast recording ft. bradley cooper reclaims numbe^announces fourth studio album witness tour dates witnesskp^icymi announces new album man of the woods lead single this friday^icymi announces new album man of the woods lead single this friday^taylor swift confirms new single reputation album announces music video details,3,4,1,7,0.42857142857142855,0.14285714285714285,0
14287830,fusetv,1940,164946,2686,96116,0,0,3,4,bringing honest brand cultural commentary opinions thereadonfuse every friday p starting oct.,pleads guilty lollapalooza disorderly conduct charge^reveals kidney transplant amp friend donor^reveals kidney transplant amp friend donor^see full list mtv movie amp tv awards nominees^announces new album witness drops fall tour dates^lena dunham joins americanhorrorstory season internet not happy their reactions^lena dunham joins americanhorrorstory season internet not happy their reactions,3,4,1,7,0.42857142857142855,0.14285714285714285,0
142957691,Sandra_Sully,7782,128899,1284,155155,0,1,3,3,journalist senior editor short black podcast consulting news editor,in big foreign policy speech year donald trump mocked delegates united nations.^emmy awards the winners list^brad pitt reportedly concerned custody battle will 'damage kids^billy connolly shock new battle^do i need british accent former president barack obama jokes prince harry interview bbc^game of thrones kit harington and rose leslie are officially married^the troubled weinstein company set file bankruptcy talks sell collapsed the film studio bee,3,4,1,7,0.42857142857142855,0.14285714285714285,0
19898168,CNBCi,843,104801,2768,174574,0,3,3,1,with biggest breaking business financial news around world cnbc international help get ahead,criminal inquiry sought hillary clinton use email^watch barack obama speaks las vegas campaign rally nevada democrats^watch white house holds first briefing since trump putin summit^here many americans watched royal wedding prince harry meghan markle^angelina jolie accuses brad pitt paying 'meaningful child support court docs^angelina jolie accuses brad pitt paying 'meaningful child support court docs^britain prince harry asks elder brother william best man wedding,3,4,1,7,0.42857142857142855,0.14285714285714285,0
28585986,calgarysun,215,94913,931,91303,0,0,3,4,breaking news sports entertainment calgary around world come see us facebook,bell olympic gong show rolls city council dark^ben affleck jennifer garner settle divorce case report^do photos prove existence salt water mars more nasa press conference^surprise enrique iglesias anna kournikova welcome twins^meghan trainor engaged kid spy kids. the pop star sat jimmy fallon wednesday unvei^after years kermit frog getting new voice more^taylor swift announces new album 'reputation november,3,4,1,7,0.42857142857142855,0.14285714285714285,0
5513142,ladailynews,1112,47096,1516,180287,0,0,3,4,local news matters we cover san fernando valley beyond los angeles daily news localnewsmatters,mariah carey new year eve performance 'they foiled^jessica simpson gives birth boy^what pentagon papers spielberg the post^neil diamond retires touring diagnosis parkinson disease^brady bunch house closes sale 3.5 million almost twice asking price^conrad hilton arrested hollywood hills allegedly violating restraining order^eminem beyonce weeknd headline coachella valley music arts festival,3,4,1,7,0.42857142857142855,0.14285714285714285,0
25837289,BernardKerik,5763,43798,307,14623,1,3,2,1,the official twitter account bernard b. kerik th police commissioner new york city police department ny times bestselling author,breaking president george h.w died age my deepest sympathies condolences to^outstanding interview derrick maltz former dea special operations commander .^admit manslaughter nyc house blast firefighter died via^the briefing must read political book year ... written someone worked the^hilarious the democrats mainstream media socialist left scared death friendship between^hilarious the democrats mainstream media socialist left scared death friendship between^walmart remove cosmopolitan magazine checkout lines,3,4,1,7,0.42857142857142855,0.14285714285714285,0
1177420700,BIAUS,1240,42568,899,148964,1,2,2,2,business news trends insights,snapchat shutting lens store months focusing ad business^hillary clinton gets booed democratic debate confronted wall street transcripts^hillary clinton gets booed democratic debate confronted wall street transcripts^mark hamill wants star wars fans campaign carrie fisher receive walk fame star early rel^trump long warm relationship oprah helped springboard presidential ambitions^donald trump almost played president 'sharknado reportedly furious mark cuban instead^dj producer avicii warned 'i 'm going die documentary released months found dead,3,4,1,7,0.42857142857142855,0.14285714285714285,0
13492102,pritheworld,2315,36314,1608,57594,2,4,1,0,hosted we ears five times week offering news features interviews music around globe,/abby finkenauer became one youngest women elected us house representatives finkenauer a^ilhan omar first somali american woman elected us house representatives representing minnesot^in interview fox news sean hannity wednesday former new york city mayor rudy giuliani one pres^in interview fox news sean hannity wednesday former new york city mayor rudy giuliani one pres^us tariffs 200 billion worth chinese goods retaliatory tariffs beijing 60 billion worth us pro^us tariffs 200 billion worth chinese goods retaliatory tariffs beijing 60 billion worth us pro^north korea threatens missile strike us guam base trump warns 'fire fury,3,4,1,7,0.42857142857142855,0.14285714285714285,0
888867163,GLtrends,14685,33497,40,74315,0,0,3,4,best website faces tech facet life ranging pc mobile phone tutorials music video info.com,full list winners emmy awards^big brother naija gifty caught begging kim kardashian to comment on her photo^big brother naija gifty caught red handed begging kim kardashian comment her photo^kim kardashian says north west would make better president than donald trump^kim kardashian breaks her silence baby no surrogate reports^bradley cooper irina shayk welcome their first child^ben affleck jennifer garner officially file divorce kill reconciliation rumours,3,4,1,7,0.42857142857142855,0.14285714285714285,0
296442457,aplusapp,183,29749,297,36274,0,1,3,3,at a plus believe power positive thinking storytelling founded see goingfrombroke /17 tv,meet new relationship eert^why chose share photos mammogram social media^n't someone said seasoned man replace matt lauer^reveals kidney transplant thanks beautiful friend gave^watch put seth meyers award show hosting boot camp^watch award show pro put hosting boot camp^dedicates concert donates proceeds victims las vegas shooting,3,4,1,7,0.42857142857142855,0.14285714285714285,0
32473029,1037KISSFM,6380,27697,322,43508,0,0,3,4,hit music station w/ a fb/ig:1037kissfm snap/tiktok kissmilwaukee stream,what rihanna drake hooking again morningshowkiss^rumors swirling dating robert pattinson see the photo everyone talking^icymi complete list grammy winners^have mercy uncle jesse eecting first child fianc e caitlin mchugh gt^jennifer lawrence single details split director boyfriend /^richard simmons hospitalized severe indigestion details^announced going return new halloween movie next year,3,4,1,7,0.42857142857142855,0.14285714285714285,0
16833126,b97,1943,11003,241,14899,0,0,3,4,insta b97neworleans snap b97nola,rumors swirling dating robert pattinson see the photo everyone talking^i wonder kim kardashian knows cats n't well carrying around like accessory ...^icymi complete list grammy winners^have mercy uncle jesse eecting first child fianc e caitlin mchugh gt^jennifer lawrence single details split director boyfriend /^richard simmons hospitalized severe indigestion details^announced going return new halloween movie next year,3,4,1,7,0.42857142857142855,0.14285714285714285,0
55246948,Mcoltro,3116,10720,180,12534,1,0,2,4,media executive producer content strategist afi iemmy member,comic con surprises fantastic beats panel comic con smartnews^baftas full winners list^just saw wonderful cast enjoyed every second merylstreep lilyjames^giuliana rancic returning co host e news alongside 'best friend jason kennedy 'ca n't wait via^jurassic world fallen kingdom teaser has chris pratt running his life e news^modern family renewed two seasons abc variety^why friends cast has stayed tight more than years e news,3,4,1,7,0.42857142857142855,0.14285714285714285,0
21689411,KHOP951,1307,6926,192,18377,0,0,3,4,modesto famous all hits on instagram like us fb e-mail questions programming.com,correct i 'm wrong were't rumors dating years ago katyperry robertpattinson^reports saying amp secretly married this week love stockton modesto^we called months ago kourtney kardashian amp scott disick back together good make family work^clarkson perform together first time open amas this sunday /7^have finished season reasonswhy yet here everything know season netlfix bingewatch^get excited reasonswhy renewed season netflix bingewatch^have finished season reasonswhy yet here everything know season netlfix bingewatch,3,4,1,7,0.42857142857142855,0.14285714285714285,0
15603701,chuckbarney,5431,5506,211,23756,0,0,3,4,tv critic former sports scribe uc berkeley parent springsteen disciple go a warriors raiders,why julia roberts jim carrey emma stone big stars tv fall via^why julia roberts jim carrey emma stone big stars tv fall via^why julia roberts jim carrey emma stone big stars tv fall via^james franco denies sexual misconduct allegations stephen colbert controversy grows via^brady bunch house southern california sale nearly 1.9 million via^john dickerson replaces charlie rose 'cbs this morning via^the originals end after season,3,4,1,7,0.42857142857142855,0.14285714285714285,0
43937476,FM100Memphis,897,5374,104,26968,0,0,3,4,we play today best mix artists like taylor swift ed sheeran maroon justin timberlake p nk bruno mars,rumors swirling dating robert pattinson see the photo everyone talking^freaking kate middleton pregnant royalbaby number^icymi complete list grammy winners^have mercy uncle jesse eecting first child fianc e caitlin mchugh gt^jennifer lawrence single details split director boyfriend /^richard simmons hospitalized severe indigestion details^announced going return new halloween movie next year,3,4,1,7,0.42857142857142855,0.14285714285714285,0
31498840,1035WEZL,451,4644,92,30445,0,0,3,4,charleston new country an iheartcountry station listen morning,love picked we 're playing coming home listen amp vote^musicians react mel tillis death^grammy awards see the full winners list^here how help victims las vegas mass shooting^kelsea ballerini marries morgan evans mexico^ryan seacrest named kelly ripa new 'live co host^cma awards the complete list winners amp nominees,3,4,1,7,0.42857142857142855,0.14285714285714285,0
708129681053257728,PEOPLEroyals,32,4188,66,1794,0,0,3,4,all royal news need know editors,a comprehensive timeline prince harry meghan markle relationship^mom who suffered same morning sickness princess kate shares her survival tips it miserable^it official see official royal baby announcement outside buckingham palace^pippa middleton fianc james matthews things know^meghan markle officially leaving suits after season following engagement news says usa network^how princess eugenie wedding dress compares kate middleton meghan markle gowns^royal wedding recap relive prince harry meghan markle big day under minutes,3,4,1,7,0.42857142857142855,0.14285714285714285,0
9820242,Captivate,594,3694,136,46744,0,3,3,1,official twitter account captivate,pres trump reportedly agreed interview special counsel robert mueller team questions^pres trump host french pres macron white house state dinner tonight macron continues three day v^shares facebook soared following ceo mark zuckerberg congressional testimony yesterday he set test^shia labeouf director david ayer partnered wwii drama 'fury reteaming crime thri^'dancing stars judge carrie ann inaba host 'miss america competition along television^p amp g wants women directors half commercials today the company also tea^'call me by your name star armie hammer make broadway debut lead young jean lee 'stra,3,4,1,7,0.42857142857142855,0.14285714285714285,0
4214805732,sdutIdeas,8,3290,136,25546,1,4,2,0,editorials opinion conversation information intelligence insight inspiration directed,read transcript gop sen. jeff flake stunning speech 'i complicit silent'^read transcript gop sen. jeff flake stunning speech 'i complicit silent'^we watched mark zuckerberg testimony house energy amp commerce committee transcribed exchange^there huge issues california challenge gavin newsom day one here four pressing ones e^star wars teasing fans whereabouts sdcc but san diego wearing one of^remember kellyanne conway told everyone go buy ivanka stuff the white house finally responding^today kellyanne conway said go buy ivanka stuff federal employees use public office endorse product,3,4,1,7,0.42857142857142855,0.14285714285714285,0
2871355214,LegendPortland,194,286,11,7613,0,0,3,4,portland classic country,miranda lambert refuses to talk politics 'you ca n't win anyway^musicians react mel tillis death^grammy awards see the full winners list^here how help victims las vegas mass shooting^kelsea ballerini marries morgan evans mexico^cma awards the complete list winners amp nominees^billboard music awards nominations see full list of bbmas nominees,3,4,1,7,0.42857142857142855,0.14285714285714285,0
19636948,CP24,369,1836228,6748,181986,0,2,4,1,official account cp24 toronto gta source breaking news our twitter account live hours day,more one four victims injured kensington market shooting dies hospital source^breaking source confirms cp24 one four people injured shooting kensington market sunday^man arrested rushing touching brad pitt probation crashing grammy awards^meghan duchess sussex wears dress calgary nonie mandela exhibition^meghan duchess sussex wears dress calgary nonie mandela exhibition^mariah carey new year eve performance 'they foiled^colin trevorrow signs direct 'jurassic world due summer,4,3,-1,7,0.5714285714285714,-0.14285714285714285,1
38400130,ChannelNewsAsia,207,928347,5002,430602,1,1,3,2,the official space cna source breaking news asia world we want hear comments news tips welcome,just in george hw bush st president united states died age family spokesman say^watch rosmah mansor wife malaysia former pm najib razak arrives malaysia anti corruption agency headq^channing tatum jenna dewan tatum split nearly years marriage^dakota johnson trained '50 shades shoot 'suspiria dances^channing tatum jenna dewan tatum split nearly years marriage^britain prince harry asks elder brother william best man wedding^ed sheeran engaged girlfriend cherry seaborn,4,3,-1,7,0.5714285714285714,-0.14285714285714285,1
18138157,FashionCanada,837,684084,4884,58713,0,0,4,3,nan,she may daughter cindy crawford kaia gerber created spotlight^she may daughter cindy crawford kaia gerber created spotlight^gone bald back long locks^kate middleton debuts new look everyone freaking^summer phoenix files divorce casey affleck^here album year nominee performing grammys^after year dating jennifer lawrence darren aronofsky split,4,3,-1,7,0.5714285714285714,-0.14285714285714285,1
18921618,nationnews,1050,492979,2472,127970,1,2,3,1,thailand travel news politics eec aec asean,washington democrats celebrated return majority us house representatives wednesday a^workers without papers face action the nation^eyes popping astonishment mouth hanging mutely open seven year old joel approaches four metre high mon^the royal wedding ceremony britain prince harry duke sussex us actress meghan marklein st george^the royal wedding ceremony britain prince harry duke sussex us actress meghan marklein st george^live the royal wedding ceremony britain prince harry duke sussex us actress meghan marklein st ge^london britain prince harry wanted royal family instead decided stay work ...,4,3,-1,7,0.5714285714285714,-0.14285714285714285,1
59825777,pajhwok,340,387070,1211,74666,4,3,0,0,nationwide news agency covering afghanistan staff,delegation us house representatives led met president palace afg toda^ghani paul ryan confer reforms peace by ahmad shah erfanyar october kabul pajhwok president ash^us lawmakers delegation call president ghani by navid ahmad barakzai november kabul pajhwok the u^former us president george bush senior dies by pajhwok december kabul pajhwok former us president ge^afghanistan unhcr pushes sustainable solution afghan refugees repatriation by march kabul p^afghanistan half million afghan idps get winter aid by javed hamim kakar november kabul pajhwo^unhcr ppaf launch new refugees centric livelihood programme by pajhwok march kabul pajhwok the un,4,3,-1,7,0.5714285714285714,-0.14285714285714285,1
2889924959,TrueFactsStated,4566,218653,2375,173750,0,3,4,0,washington area provocateur worked clinton white house i billboards sue,this nd time selected truly subject video i would like t^has republican national committee replaced vice chair michael cohen^he spend time one four homes^roadmusic bruce springsteen w/ bobby king man job live via^sandy roadmusic th of july asbury park sandy bruce springsteen studio version via^i going nj roadmusic bruce springsteen i 'm fire via^nj roadmusic long time southside johnny amp bruce springsteen via,4,3,-1,7,0.5714285714285714,-0.14285714285714285,1
989202752,TheInfoNG,19906,171111,275,35357,0,0,4,3,not celeb gossip news comedy entertainment relationship tips also follow interact you we humans,we self made kim kardashian defends kylie jenner^full list winners emmy awards^angelina jolie goes braless meet archbishop canterbury then happened.. photos^don jazzy drops hilarious comment rihanna page says might pregnant^the weeknd selena gomez split months says it hard months^meghan markle deletes facebook instagram twitter accounts preparation wed prince harry^complete list winners billboard music awards see many awards wizkid,4,3,-1,7,0.5714285714285714,-0.14285714285714285,1
15926431,PioneerPress,10509,170000,2129,141158,1,2,3,1,twin cities news sports politics entertainment business st. paul pioneer press minnesota first newspaper,a fake photo emma gonz lez tearing constitution went viral weekend far right^philando castile stopped times police^philando castile stopped times police was racial profiling^a list worst super bowl halftime shows ever might subjective argue elvis presto^michael strahan sara haines co host new midday hour abc good morning america^michael strahan sara haines co host new midday hour abc good morning america^koko gorilla whose sign language abilities changed view animal intelligence dies,4,3,-1,7,0.5714285714285714,-0.14285714285714285,1
9609622,perthnow,1519,136387,902,123867,0,0,4,3,perth wa popular news website latest local business sport entertainment stories,jennifer aniston happy justin theroux new girlfriend^kendall jenner ben simmon flirty date night^reese witherspoon allegedly furious big little lies co star nicole kidman promoting show enoug^reese witherspoon furious co star nicole kidman failing promote big little lies^miles teller arrested allegedly drunk public^sad news julia louis dreyfus diagnosed breast cancer^why cameron diaz disappeared hollywood waited long get married,4,3,-1,7,0.5714285714285714,-0.14285714285714285,1
716813053,fawfulfan,9626,92522,1291,215581,4,3,0,0,game programmer breaking news reporter boardmember devoted husband proudly spectrum personal account opinions,the way republicans obsess page count regulations weird they judging code federal reg^u.s. code vs code federal regulations^yes code federal regulations not united states code do know difference^a thornier issue whether fully followed code federal regulations issue federal prosecutors^matthew state judges actually elected but even worse since it^last week quoted alexander cockburn noted antisemite used quote proof antisemitism n't issue america^of five congressional districts texas along mexican border four solid blue one swing distr,4,3,-1,7,0.5714285714285714,-0.14285714285714285,1
69506712,YahooIndia,126,68978,806,69292,0,1,4,2,get latest news info world politics sports lifestyle world news technology one place rts endorsements,trump signs executive order 'protection the nation from foreign terrorist entry into the united states^channing tatum jenna dewan split after years marriage^happy father day bollywood celebrities send wishes social media^brad pitt is committed having healthy relationship with angelina jolie^channing tatum jenna dewan split after years marriage^priyanka chopra nick jonas engaged see first pics couple here^billboard music awards complete list winners,4,3,-1,7,0.5714285714285714,-0.14285714285714285,1
16423253,WORLD_mag,2413,30581,1087,42738,0,2,4,1,real matters world offers real stories behind headlines hard-hitting truth-telling uniquely christian worldview reporting,thestew war words when protester disrupted testimony house committee energy commer^the president celebrating labor day afl cio picnic cincinnati^a number entertainment icons including hefting star status huge social media reac^making right residents new orleans plan file suit philanthropic creation^making right residents new orleans plan file suit philanthropic creation^making right residents new orleans plan file suit philanthropic creation^comedian actor jerry lewis dies age thesift,4,3,-1,7,0.5714285714285714,-0.14285714285714285,1
1111829022,IrishTimesCultr,126,28711,415,59044,0,0,4,3,the latest film books stage music design media heritage the,oscars see full list winners th academy awards^dwayne johnson can the rock save hollywood^justin bieber tour cancellation i want sustainable^justin bieber tour cancellation i want sustainable^james franco denies allegations sexual misconduct^looking something watch here week best tv shows via^'red clocks pivots simple conceit would america look like abortion made illegal h,4,3,-1,7,0.5714285714285714,-0.14285714285714285,1
21513468,ZoraSuleman,4200,19034,269,68066,2,0,2,3,voice-over newsreader bbbofc licensed boxing mc,former us president george hw bush died age he served st president united states^george hw bush st president united states died age^the trump administration rescinds rules bathrooms transgender students^shots fired home kanye west tekashi ix9ine filming music video production halted^ed sheeran announced insta engagement girlfriend cherry seaborn the two got engaged new y^game of thrones stars kit harington rose leslie reportedly getting married today the year old actors ar^weinstein company set file bankruptcy sale talks collapse,4,3,-1,7,0.5714285714285714,-0.14285714285714285,1
2962228553,Big955Chicago,478,10226,72,38341,0,0,4,3,new country chicago big an iheartcountry station request line -955-9550,talks moment privately revealed split look^yikes blake shelton caught guard the tonight show starring jimmy fallon appearance could be^miranda lambert refuses to talk politics 'you ca n't win anyway^grammy awards see the full winners list^after years kermit frog getting new voice look^billboard music awards nominations see full list of bbmas nominees^y'all april giraffe pregnant,4,3,-1,7,0.5714285714285714,-0.14285714285714285,1
295693924,fpjindia,448,8122,399,163876,0,2,4,1,the voice mumbai the free press journal one oldest english daily newspapers mumbai heritage years,love bauaa zero meet real life dwarfs bollywood^newsalert rajasthan congress delegation meet rajasthan governor kalyan singh jaipur pm today^royalwedding how princeharry met meghanmarkle a timeline relationship meghanandharry^angelinajolie i enjoy single bradpitt^i really excited priyankachopra meghanmarkle pregnancy^royalwedding how princeharry met meghanmarkle a timeline relationship meghanandharry^lindsaylohan bitten snake hike thailand,4,3,-1,7,0.5714285714285714,-0.14285714285714285,1
28381055,emilylongeretta,838,7254,115,39173,0,1,4,2,i write tv movies i talk tv movies watchwithus podcast opinions mine i live tweet,after hour delay still got hour due turbulence one carousel jfk f^i still waiting fogelman reveal time capsule put amp look at^first sagawards nominations laura dern nicole kidman jessica lange susan sarandon reese witherspoon biglittlelies feud^no bad blood here nina dobrev says she teamsomereed in cute pic with ian somerhalder amp nikki reed^thank this ryan cabrera descript notably star beautiful piece television known the ashlee simpson show^mtv movie amp tv awards combine actor amp actress into category full list of nominees^who play year old princess diana feud,4,3,-1,7,0.5714285714285714,-0.14285714285714285,1
265902729,BBCSport,315,8031542,20834,434154,0,2,5,0,official account also,shirts flags bunting face paint ... however 're decorating worldcup want see whateve^british number one johanna konta set great test former world number four dominika cibulkova t^a south american flavour david beckham elained thinking behind new club crest^david beckham prosecuted speeding charge district judge ruled full story^david beckham prosecuted speeding charge district judge ruled^david beckham due fight allegation speeding bentley technicality^david beckham due fight allegation speeding bentley technicality,5,2,-3,7,0.7142857142857143,-0.42857142857142855,1
29930178,SuperSportTV,584,2505868,3535,308538,1,2,4,0,join world champions latest sports news updates,nigeria ahmed musa second goal worldcup iceland nominated one goals th^despite first european nation eliminated worldcup pol aiming end campaign h^with nine clean sheets already season one goal conceded last four matches liverpool defen^only four days go start confedcup who think come top russia^franco mostert sam whitelock colossal sides come top t^the crusaders unbeaten the lions already lost tour who come top christchu^they arguably top two sides superrugby who come top crusaders host,5,2,-3,7,0.7142857142857143,-0.42857142857142855,1
3099486241,bombaytimes,249,664134,211,53503,0,0,5,2,get daily dose hottest bollywood gossip glamour fashion lifestyle follow us,never misses opportunity eress love^danielcraig rachelweisz welcome baby girl^has justin theroux already moved post divorce jennifer aniston^is jennifer aniston justin theroux divorce even valid^selenagomez seeks mental health treatment emotional breakdown^'whiplash fame teller arrested san diego allegedly drunk public^us comedian jerry lewis dies age may soul rest peace ...,5,2,-3,7,0.7142857142857143,-0.42857142857142855,1
16213404,QandA,922,362663,2132,36796,0,2,5,0,qanda chance ask questions challenge power share views we tweet people opinions inspire questions eress views,a book excerpt interview angela nagle author kill all normies qanda^john roskam thinks participate debate background part context amp^if get tv tonight qanda also simulcast live radio :35pm aest then stick arou^if get tv tonight qanda also simulcast live radio :35pm aest then stick arou^if get tv tonight qanda also simulcast live radio :35pm aest then stick arou^if get tv tonight qanda also simulcast live radio :45pm aest then stick arou^if get tv tonight qanda also simulcast live radio :35pm aest then stick arou,5,2,-3,7,0.7142857142857143,-0.42857142857142855,1
22677427,smerconish,1930,187528,1998,21568,0,2,5,0,siriusxm potus channel am-12 et daily encore pm-12 et cnn saturdays et youtube channel,buzz kill warning ... .just read entire minutes transcript kinda non plussed feel like no^the hill jordan fabian ceding question briefing it about showing press corps unity via^w/ votes see larrydavid monologue good example humor irony not offensive insensi^vote larrydavid monologue offensive insensitive amp unfunny or good example humor amp irony poll^larry david monologue offensive insensitive amp unfunny or good example humor amp irony vote poll^late nighers larrydavid mono offensive insensitive amp unfunny or good example humor amp irony vote^larrydavid monologue offensive insensitive amp unfunny or good example humor amp irony vote poll,5,2,-3,7,0.7142857142857143,-0.42857142857142855,1
14584903,reuterspictures,451,159418,6205,27300,0,1,5,1,news photography world largest news agency follow us,supporters president donald trump attend campaign rally las vegas photos day^meghan duchess sussex named best dressed woman people magazine photos duchess st^britain princess charlotte brother prince louis photo taken catherine duchess cambridge on^catherine duchess cambridge meghan markle friend jessica mulroney hold bridesmaids hands arrive^britain princess charlotte brother prince louis photo taken catherine duchess cambridge on^catherine duchess cambridge meghan markle friend jessica mulroney hold bridesmaids hands arrive^district columbia kara mccullough crowned miss usa second consecutive year nation capital wins,5,2,-3,7,0.7142857142857143,-0.42857142857142855,1
13039372,akstanwyck,1745,69965,2211,102197,0,0,5,2,editor large indiewire founder entertainment industry blog thompson hollywood co-host screen talk podcast author `` the 11 billion year '',baftas winners list via^venice film festival must see movies this year festival from bloody vince vaughn jeff goldblum a^lucas hedges gay teen nicole kidman religious mother moving small agitpro^woody allen casts elle fanning timoth e chalamet selena gomez for new amazon feature via^emma stone talks the favourite fall festival hit the telluride tributee holds first british^producers guild awards the complete winners list via^twin peaks teaser offers first new footage upcoming revival watch via,5,2,-3,7,0.7142857142857143,-0.42857142857142855,1
20640996,MTVAUSTRALIA,951,64785,449,24845,0,0,5,2,the official twitter page mtv australia,kim kardashian defends kylie jenner amidst elf made billionaire criticism gt gt gt^mileycyrus amp liamhemsworth reportedly called wedding 're coping ... gt gt gt^brody jenner got married but caitlyn kendall amp kylie mia wedding ... ouch^the internet reckons kim kardashian amp kylie jenner war makeup lines gt gt gt^amp back together gt gt^rob amp big star christopher 'big black boykin dead gt gt gt^nick jonas priyanka chopra reportedly engaged gt gt gt,5,2,-3,7,0.7142857142857143,-0.42857142857142855,1
28587570,winnipegsun,487,57643,539,128356,0,0,5,2,for best news sports entertainment check,leslie jones tells critics stop offended comedians old jokes^roseanne barr begs jerry seinfeld career comeback help^drake calls claim insulted muslim woman concert 'fake media story^the spice girls reunion cancelled^jennifer lawrence swears sex terrified getting sti^steve martin martin short 'colonoscopy parties tom hanks^taylor swift announces new album 'reputation november video,5,2,-3,7,0.7142857142857143,-0.42857142857142855,1
15219854,OhMyGOFF,18312,57232,1434,88030,0,1,5,1,now hosting ... at4pm fox5lion weekdays pm ohmygoffshow fridays youtube facebook apple podcasts,john mccain in words^prince harry meghan markle wed may^happy halloween royalwedding harryandmeghan meghanmarkle princeharry halloween^ha kanye west opening breakfast restaurant called omelette finish^breaking royal baby news harryandmeghan baby royal insiders believe duchessmeghan^happy halloween royalwedding harryandmeghan meghanmarkle princeharry halloween^wow congrats.. hope well i feel like jessica simpson.. been pregnant forever ha i 'm great though.. but ready,5,2,-3,7,0.7142857142857143,-0.42857142857142855,1
15923797,KITV4,15321,36125,1169,167246,1,0,4,2,the official twitter home kitv4 island news breaking news weather hawaii abc affiliate news tips news.com fb/ig kitv4,urgent melania trump undergoes kidney surgery walter reed medical center^comedian leslie jones advice victims cyberbullying^the latest 'three billboards wins best drama film globe associated press january :10 :00^is kim kardashian pursuing music career^regis philbin fast facts^sentenced former rep. anthony weiner sentenced monday months prison sexting minor^aly raisman sues us olympic committee usa gymnastics,5,2,-3,7,0.7142857142857143,-0.42857142857142855,1
47916714,IBTimesUK,1071,32115,1224,195494,0,0,5,2,international business times uk keeping world connected know next facebook,gwen stefani fears tour might lead split blake shelton^twitter furiously tears ivanka trump 'why i disagree dad us weekly magazine cover^amal george clooney welcome twins^katie holmes jamie foxx dating says friend claudia jordan^frightening new ai tool used make fake celebrity porn videos 'wonder woman star gal gadot^april giraffe gives birth millions people watch live stream video^billboard music awards nominations announced adele tops list full list adele rihanna lmfao sweeps ...,5,2,-3,7,0.7142857142857143,-0.42857142857142855,1
15469402,womanandhome,1203,30031,425,39372,0,0,5,2,the biggest selling monthly women lifestyle title newsstand it attitude age follow us instagram,boden release affordable look like duchess cambridge gucci tweed dress^the secret trick duchess cambridge uses stay secure high heels^the surprising reason duchess cambridge rarely wears hair^why duchess cambridge may attend princess eugenie wedding^the duchess revealed playful prince george running anmer hall^everything know far pippa middleton wedding^things binge watch netflix christmas holidays,5,2,-3,7,0.7142857142857143,-0.42857142857142855,1
7612242,KPLR11,430,29694,765,45751,0,0,5,2,the official twitter page kplr11 st. louis mo news sports weather entertainment follow reporters updates,prince harry meghan markle wed may^elle faces backlash false kim kardashian kanye west breakup tweet^elle faces backlash false kim kardashian kanye west breakup tweet^elle faces backlash false kim kardashian kanye west breakup tweet^elle faces backlash false kim kardashian kanye west breakup tweet^ellen degeneres cries receiving best birthday gift portia de rossi^fiona baby hippo dad henry dies,5,2,-3,7,0.7142857142857143,-0.42857142857142855,1
470299753,TheDailyPioneer,108,18971,283,53810,3,2,2,0,twitter account india leading independent right-thinking newspaper,pramilajayapal congresswoman pramila jayapal first indian american woman elected us house r^indiaabroad a legislation introduced us house representatives week advance defence ties i^georgebush former us president george w. bush helped steer america end cold war die^uspresidentialelection democratic nominee hillary clinton wednesday night final presidential debate ...^keralahighcourt the kerala high court monday granted bail father johnson v. mathew one four priest^justinhailey model hailey baldwin shot reports claiming pop star justin bieber alread^entertainment priyanka chopra excited friend meghan markle pregnancy amp hopes duchess suss,5,2,-3,7,0.7142857142857143,-0.42857142857142855,1
2658067537,957TheJet,498,794,12,12390,0,0,5,2,seattle best variety more,ed sheeran did not 'break friendship code with taylor swift^beyonce birth twins still hospital 'minor issue^are mariah carey amp joe jonas feuding^grammy awards see the full winners list^celebrities thank barack obama on last day as president^here how help victims las vegas mass shooting^alex rodriguez year old daughter sings for jennifer lopez photos,5,2,-3,7,0.7142857142857143,-0.42857142857142855,1
38679388,gmail,112,5941953,18314,129656,6,1,0,0,news tips tricks gmail team need help fly help center forum,thanks info could also submit gt settings gt send feedback appreciate^hi sabrina we 'll definitely pass feedback along team however return classic gma^thanks reporting our product team looking could submit feedback^thanks feedback sabhaa our product team greatly values feature suggestions could also^hi chris currently n't possible our product team greatly values feature suggestions could you^hi vincent currently n't possible our product team greatly values feature suggestions could you^thanks reporting our product team looking could submit feedback,6,1,-5,7,0.8571428571428571,-0.7142857142857143,1
16887175,DailyMirror,5757,1110221,6214,534059,0,0,6,1,the official daily mirror mirror online twitter account real news real time breaking news showbiz news,meghan markle words duchess thinks love work happiness^meghan markle words duchess thinks love work happiness^meghan markle looks happy relaxed boards flight fiji harry royaltour^meghan markle nephew 'plans make strain cannabis mark royal wedding^meghan markle nephew 'plans make strain cannabis mark royal wedding^finally kim kardashian admits selfie obsession ridiculous but stopping anytime soon^'cuffing season upon us everything need know,6,1,-5,7,0.8571428571428571,-0.7142857142857143,1
36098990,HarveyLevinTMZ,873,639126,8203,20653,0,0,6,1,i lawyer,khloe kardashian i want nothing to do with lamar odom but ... join conversation tmzlive^kanye west concerts on hold indefinitely share thoughts^drake introduced taylor swift his mom but ... do think hooking^beyonce birth twins still in the hospital with 'minor issue what thoughts^iggy azalea blasts nick young ... after accidental dinner reunion what think words^kanye west no 'american idol for me if show come back would like kanye host^xxxtentacion th suspect in murder case arrested ... mug shot released what think,6,1,-5,7,0.8571428571428571,-0.7142857142857143,1
41067945,CosmoIndia,861,563112,371,51330,0,0,6,1,the biggest selling magazine in world follow us need-to-know celebrity news fashion beauty relationships ...,things selenagomez get body^things get body^a definitive timeline miley cyrus liam hemsworth relationship^angelina jolie finally breaks her silence divorce^angelina jolie finally breaks her silence divorce^selena gomez reveals she had kidney transplant over summer^it official priyanka chopra nick jonas engaged,6,1,-5,7,0.8571428571428571,-0.7142857142857143,1
15907183,cmclymer,4074,241362,2650,140726,3,1,3,0,comms opinions writer queer army vet texan hoya she/her rep inquiries cmclymer.com,nancy pelosi th speaker u.s. house representatives person history slap shit^the required minimum age member u.s. house representatives otherwise i 'd calling the^wishing speedy full recovery melania trump melania trump undergoes kidney surgery walter reed m^you really consider running office tho in seriousness^i 'm kinda lowkey pissed n't legally blonde yet hey please make happen mak^congratulations happy couple announcement i pleased accept offer godmother t^channing tatum jenna dewan tatum announce separation fixed she name got,6,1,-5,7,0.8571428571428571,-0.7142857142857143,1
52750832,ELLESouthAfrica,1210,138651,407,37277,0,0,6,1,sexy stylish spirited,kanye west sent r14 million cheque promoting yeezy knockoff brand.^kim kardashian reportedly embarrassed kanye white house visit^justin bieber reportedly selena gomez despite marrying hailey baldwin^jennifer lopez tells story new boyfriend alex rodriguez met started dating^icymi margot robbie nicole kidman charlize theron going star film inspired metoo^khlo kardashian says watching kuwtk cheating episode made pissed^need outfit inspiration check best street style film festival,6,1,-5,7,0.8571428571428571,-0.7142857142857143,1
23775585,VirginRadioTO,2964,46200,520,124758,0,0,6,1,we toronto hit music station listen live check virgin mornings adam wylde tj jax weekday mornings :30am,does adding make want watch new season tuckerinthemorning^aww congrats happy couple tuckerinthemorning royalbaby princeharry meghanmarkle^drake sets record straight fake media story hits web regarding muslim woman show london^kanyewest able go back home finallyconcerts hold indefinitely recovers tuckerinthemorning^managed keep baby bump spotlight months^allegedly emotional breakdown she opens depression next iheartradionights^amy schumer marries chef chris fischer surprise wedding after few months dating,6,1,-5,7,0.8571428571428571,-0.7142857142857143,1
19013879,asiaonecom,148,34065,605,177309,0,0,6,1,your daily good stuff,justin bieber 'upset selena gomez hospitalisation^channing tatum jenna dewan split years marriage^justin bieber 'upset selena gomez hospitalisation^channing tatum jenna dewan split years marriage^angelina jolie divorce brad pitt 'i n't enjoy single^singer selena gomez reveals kidney transplant^enrique iglesias anna kournikova welcome twins,6,1,-5,7,0.8571428571428571,-0.7142857142857143,1
21142500,Genosworld,1460,30625,927,133870,0,0,6,1,i popular i dying grateful,geno world john mayer hospitalized for an emergency appendectomy according to his s ...^john mayer dumped jennifer aniston th time they may back together i 'm typing^are jennifer aniston john mayer really back together^mandy moore reveals this is us code word for how jack died today^video demi moore says miley cyrus great ca n't wait play mom lol^geno world julie bowen has strict no penis pulling rule her home^first look ryan murphy american horror story,6,1,-5,7,0.8571428571428571,-0.7142857142857143,1
81877564,stellarmagazine,3924,30351,267,38387,0,0,6,1,ireland hottest glossy cunningham house francis street d8 info.ie find us instagram facebook stellarmagazine,plan b says begging little sister carry third baby.^plan b says begging little sister carry third baby.^plan b says begging little sister carry third baby.^plan b says begging little sister carry third baby.^plan b says begging little sister carry third baby.^plan b says begging little sister carry third baby.^all royal fashion rules meghan markle follow duchess,6,1,-5,7,0.8571428571428571,-0.7142857142857143,1
725599416904622080,ph_billboard,325,29497,338,8382,0,0,6,1,your ultimate go-to world popular international local charts music news videos analysis events instagram ph,kanye west kim kardashian share family christmas card^grammy awards see full winners list updating grammys^la la land songwriters emma stone cool quirky singing style new broadway show^la la land songwriters emma stone cool quirky singing style new broadway show^reveals love yourself originally written new album divide^reveals love yourself originally written new album divide^cancels remaining dates purpose world tour,6,1,-5,7,0.8571428571428571,-0.7142857142857143,1
58675420,HitTrending,2214,22527,260,27868,0,0,6,1,bringing top trending gossip around world follow us instagram find us,exciting baby news for jennifer aniston she going best mum^kim kardashian shows off bald patches after over use of hair extensions^i play rumors like hit back drug rumours^amp have cancelled their dreamy honeymoon^says hair destroyed^jennifer aniston secret revenge plot planned angelina golden globes find^named first ever honorary citizen manchester,6,1,-5,7,0.8571428571428571,-0.7142857142857143,1
117356282,GDNonline,103,15277,321,112523,0,1,6,0,leading english daily newspaper published kingdom bahrain,i rape children. this statement bahraini father five stand trial raping^liam payne feels 'fragile post split cheryl hollywood read^george amal clooney welcome birth twins hollywood georgeclooney^emma stone 'ca n't imagine life without ryan gosling hollywood emmastone read^daniel craig rachel weisz welcome baby girl hollywood celebs read^daniel craig rachel weisz welcome baby girl hollywood celebs read^brad pitt angelina jolie gear full blown custody battle hollywood bradpitt angelinajolie read mo,6,1,-5,7,0.8571428571428571,-0.7142857142857143,1
125767959,CSISKoreaChair,1060,15186,522,26420,6,1,0,0,korea chair independent platform advance major policy issues common importance korean american people rts endorsements,today president trump giving state union address st time th us congress^on /30 tue trump giving state union address st time th us congress in^on /30 tue trump giving state union address st time th us congress in^on /30 tue trump giving state union address st time th us congress in^on /30 tue trump giving state union address st time th us congress in^on /30 tue trump giving state union address st time th us congress in^transcript national security adviser john bolton face nation july,6,1,-5,7,0.8571428571428571,-0.7142857142857143,1
20064236,USGPO,806,10364,409,4562,6,1,0,0,official news u.s. government publishing office,otd joseph hayne rainey south carolina sworn st african american serve u.s. h^the code federal regulations cfr index finding aids gpo govinfo^gpo megan minta delivers volumes code federal regulations jim hemphill their^bensadventures continue gpo bindery watches employees produce code federal regulations cfr .^what cfr read code federal regulations amp browse gpo collection^gpo new adhesive digital binding line action ... producing code federal regulations more efficient pro^gpo fondly remembers personal correspondence us the president sent personal thank gp,6,1,-5,7,0.8571428571428571,-0.7142857142857143,1
3001388675,CapitalWIRNews,2349,2287,47,19483,0,1,6,0,we moved you still find latest news wirral,a man birkenhead appeared court charged drugs offences police raids across north west^it ... jennifer aniston justin theroux split two half years marriage saying th^it ... jennifer aniston justin theroux split two half years marriage saying th^it ... jennifer aniston justin theroux split two half years marriage saying th^it looks like justin bieber hailey baldwin already got married her uncle told reporters la just^it ... jennifer aniston justin theroux split two half years marriage saying th^david beckham n't going prosecuted speeding fine got london lawyer fought allega,6,1,-5,7,0.8571428571428571,-0.7142857142857143,1
612473,BBCNews,101,10209703,41573,395741,1,2,0,3,news features analysis for world news follow breaking news follow latest sport news our instagram bbcnews,the butler racism amp obama watch us talk show queen amp actress winfrey conversation^she hard working dedicated doctor statement read behalf dr jane barton oversaw practic^un high commission refugees warns situation libya border tunisia reaching 'crisis point afp^ed sheeran engaged long time girlfriend cherry seaborn^royal wedding meghan markle father walk aisle^future mrs. jonas my heart my love confirm engaged,1,5,4,6,0.16666666666666666,0.6666666666666666,0
24291371,MobilePunch,2573,2586497,2636,395266,0,3,1,2,this official twitter handle the punch newspapers widely read newspaper nigeria,head lagos office un high commission refugees mrs. josephine smith wednesday said ...^head lagos office un high commission refugees mrs. josephine smith wednesday said ...^apc convention oyegun gives emotional farewell speech^david beckham face trial speeding offence^royal wedding prince harry asks brother prince william best man^royal wedding meghan markle dad may attend ceremony,1,5,4,6,0.16666666666666666,0.6666666666666666,0
2908170952,DiamondandSilk,47,1247669,3213,11398,1,5,0,0,president donald j trump most loyal supporters host d s chit chat live vloggers fox nation host public figures speakers,now understand urgency trying hide kickbacks ... iranian official drops bombshell obama sec^discuss thoughts racism america with^full interview talking spike lee disparaging comments th^full interview special thank you ronna mcdaniel^interview discussing meeting president whil^too much sugar making lot people sick throwback video remember d amp get fe,1,5,4,6,0.16666666666666666,0.6666666666666666,0
112236047,clickclickclick,103,1155324,21828,25338,0,1,1,4,culture obsessed digital trends connected lives web weirdness way live,papa john founder former ceo john schnatter resigned chairman board^kim kardashian donald trump talked prison reform rails^tessa thompson says attracted men women happy pride^tessa thompson says attracted men women happy pride^nick jonas priyanka chopra reportedly engaged fans crying^april giraffe pregnant 're already tired,1,5,4,6,0.16666666666666666,0.6666666666666666,0
1630896181,vicenews,870,954725,11534,109608,0,5,1,0,vice news tonight coming soon call us 88.317.8423 sign vice news daily brief,"the presidential election never ends hillary clinton wrote book so james comey now add to^my administration started crisis ended one. watch extended interview president george w^after tuesday primaries alaska wyoming ,669 women nominations major parties state^the white house holding press briefing day trump said meant say exact opposite sa^white house press secretary sarah huckabee sanders said press briefing credibility probably highe^deepfake videos like gal gadot porn getting convincing dangerous",1,5,4,6,0.16666666666666666,0.6666666666666666,0
69271273,daily_trust,699,877062,973,449550,0,2,1,3,our vision to world class media company earns public trust our mission to disseminate credible information good stakeholders,troops kill scores boko haram trying attack market yobe state^pdp chieftain supporters defect apc nasarawa^mel b investigation witness intimidation divorce drama continues^bruno mars leads american music award nominees^mel b investigation witness intimidation divorce drama continues^jennifer lopez debuts stunning cover art release date new single ni t ni yo,1,5,4,6,0.16666666666666666,0.6666666666666666,0
18018355,AprilDRyan,5002,569295,4009,52102,0,5,1,0,author mother white house correspondent washington bureau chief- american urban radio networks cnn political analyst,transcript interview wait minutes interview game still^congrats title advisor surrogate communications democratic national convention committee^in support consistent daily briefings whitehouse it th briefing month today th jul^today whdpb daily press briefing contentious following rescind in^today daily press briefing mikepompeo updated northkoreasummit qualified^trump rescinds rules bathrooms transgender students,1,5,4,6,0.16666666666666666,0.6666666666666666,0
50279781,FinancialXpress,43,561371,1861,321888,1,5,0,0,the financialeress a complete up-to-date source business news finance news stockmarket news economy financial news online,arunamiller fray nd indian american woman enter us house representatives^srikrishna panel report no disclosure data harm individual outweighs public interest^srikrishna panel report no disclosure data harm individual outweighs public interest^biggest trade war economic history us tariffs chinese goods worth 34 billion takes effect today^biggest trade war economic history us tariffs chinese goods worth 34 billion takes effect today^china us currently locked ongoing trade war country introduced tariffs goods trade,1,5,4,6,0.16666666666666666,0.6666666666666666,0
43425975,NY1,108,448308,4284,108329,1,3,0,2,the -hour news network dedicated nyc ny1 also facebook ny1news instagram ny1,the casket george h.w bush led steps cathedral funeral take place washington.^hillary clinton slated deliver keynote speech democratic convention today ny1politics^live ny1 delivers speech convention long island watch online^coming up delivers speech convention long island watch online^tiger woods arrested morning florida dui charge^the weinstein company sold eected file bankruptcy morningson1,1,5,4,6,0.16666666666666666,0.6666666666666666,0
38147187,SonyPIX,2084,351089,196,46728,0,0,1,5,biggest hollywood blockbusters latest movie premieres your ultimate destination of amazement facebook,alright people would date or ditch beauties camerondiaz evamendes^notty favorite diva jennifer lawrence director darren aronofsky allegedly split earlier today year lo^ready player one third difficult movie create said steven spielberg man says hims^steven spielberg maker jurassic park jaws many blockbusters whole new world hi^only daytogo friends part steven spielberg awesome new virtual world ready play^today last chance win firstdayfirstshow tickets watch steven spielberg amazing ready player one,1,5,4,6,0.16666666666666666,0.6666666666666666,0
20973388,LBC,1772,350644,2304,140304,0,1,1,4,leading britain conversation call,this one killer line end debate gender neutral school uniforms^gwyneth paltrow angelina jolie others say harvey weinstein harassed how common abuse power and^prince charles walk meghan markle aisle royal wedding tomorrow^it reported meghan markle father longer walk aisle saturday royal wedding^meghan markle father change heart wants attend royal wedding still uncert^prince harry wanted royal family does maajid like monarchy,1,5,4,6,0.16666666666666666,0.6666666666666666,0
4081106480,realDailyWire,3947,330066,2061,99637,0,4,1,1,official twitter feed the daily wire,whoopi goldberg spit on jeanine pirro screamed 'get the f**k out of this building pirro claims^liveblogging trump address to a joint session congress^watch hillary clinton rides to the rescue of sen. bob menendez crashes literally^cnn requests emergency briefing as white house vows to revoke jim acosta wh press pass again^dennis quaid says he 'really nervous about playing ronald reagan in new film^quincy jones claims he once dated ivanka trump,1,5,4,6,0.16666666666666666,0.6666666666666666,0
7998482,usatodayDC,772,211918,1419,43457,0,5,1,0,all latest politics election news usa today washington bureau politics team,graham wide ranging interview fox news included speculation ancestry^transcript former president obama speech blasting president trump^woman invited onstage las vegas campaign rally 'i 'm hispanic i vote mr trump via^new nh ads richardson mccain giuliani three new ads went today new hampshire former..^transcript former president obama speech blasting president trump^ethics chief kellyanne conway likely broke rules 'go buy ivanka stuff remarks via,1,5,4,6,0.16666666666666666,0.6666666666666666,0
6817432,fox4kc,629,208586,1378,151663,1,0,0,5,news weather interesting stories kansas city fox4 news working you,melania trump undergoes kidney surgery walter reed medical center^legendary rockstar tom petty dead^fiona baby hippo dad henry dies^fiona baby hippo dad henry dies^fiona baby hippo dad henry dies^april giraffe pregnant,1,5,4,6,0.16666666666666666,0.6666666666666666,0
24143255,KSLcom,413,178660,1553,115862,0,5,1,0,utah source news sports weather classifieds awarded best news-oriented website. send news tips news.com,"centers disease control prevention officials said received reports pediatric flu deaths sin^utah elementary schools designated national blue ribbon schools us department education^the new restrictions follow recommendations centers disease control prevention^trump asking congress pay border wall says mexico reimburse cost^a utah company announced recalling ,000 pounds chicken misbranding allergens u.s. d^mariah carey new year eve performance 'they foiled",1,5,4,6,0.16666666666666666,0.6666666666666666,0
23489273,LEX18News,676,154122,804,139427,1,5,0,0,count on lex news news weather central kentucky join facebook family,breaking federal prosecutors charge nyc subway bomb suspect say wrote facebook trump failed protect nation^gov bevin louisville yesterday playing chess members west louisville chess club in video h^the suspected cut melon products sold stores including costco trader joe walmart walgreens whole f^more children diagnosed acute flaccid myelitis polio like paralyzing illness according numb^the statement provided dollar amounts much china might boost purchases us products lawrence kudlo^more children diagnosed acute flaccid myelitis polio like paralyzing illness according numb,1,5,4,6,0.16666666666666666,0.6666666666666666,0
16873455,TalbertSwan,5203,131918,1307,57389,1,5,0,0,pastor l prelate l activist l author l talk show host l chaplain l president l fb/ig/sc l truthisnothate,the gop tough crime they believe rapists pedophiles serial sexual predators hard time ... .^exclusive here video footage owner jerry jones making statement treats play^this pathological lying racist piece immoral orange swill nerve say president obama supposedly made^your eminence wuerl is statement office regarding unfortunate incident one of^who hamburger tell i share twitter feed go sh^the warped thinking deranged lunatic detested corners globe i think donald trump foe,1,5,4,6,0.16666666666666666,0.6666666666666666,0
23447418,WOWT6News,1243,121219,892,82984,1,3,0,2,your home news follow us latest breaking omaha news weather sports watchwowt live,recall alert target recalls water absorbing toys due serious ingestion hazard more^always wash hands handling live poultry that reminder us centers disease control a^always wash hands handling live poultry that reminder us centers disease control a^a u.s. department agriculture agency contacting farmers gather year end production storage figure^kermit frog getting new voice actor years story^sarah rose summers miss nebraska crowned miss usa monday night rose papillion nebraska top,1,5,4,6,0.16666666666666666,0.6666666666666666,0
16538186,newscentermaine,3732,114622,1064,169716,0,1,1,4,headlines breaking news nbc affiliate news center maine portland bangor maine start tweet newscentermaine say hi,clinton lead trump shrinks points new nbc news/wsj poll^reports brad pitt accused child abuse investigation photo^walmart remove 'cosmopolitan magazine checkout lines amid me too movement via^scott baio wife renee reveals microvascular brain disease diagnosis^scott baio wife renee reveals microvascular brain disease diagnosis^scott baio wife renee reveals microvascular brain disease diagnosis,1,5,4,6,0.16666666666666666,0.6666666666666666,0
15937533,pressenterprise,2993,102391,829,111686,0,1,1,4,riverside county california news sports entertainment,orlando mass shooting hillary clinton donald trump take different approaches attack^what pentagon papers spielberg the post^neil diamond retires touring diagnosis parkinson disease^oscars announce jimmy kimmel returning academy awards host date^brady bunch house closes sale 3.5 million almost twice asking price^eminem beyonce weeknd headline coachella valley music arts festival,1,5,4,6,0.16666666666666666,0.6666666666666666,0
16299275,vicecanada,341,98989,1622,89769,0,0,1,5,original reporting everything matters follow us apple news,deepfake videos like gal gadot porn getting convincing dangerous^nelly reportedly arrested suspicion rape^everything need know 'twin peaks returns^everything need know twin peaks returns^everything need know 'twin peaks returns^lcd soundsystem gavin russom comes transgender,1,5,4,6,0.16666666666666666,0.6666666666666666,0
16477702,syracusedotcom,580,89875,840,171575,0,3,1,2,we bring best local statewide news sports,democratic debate trade insults accusations cuomo nixes presidential talk^democratic debate trade insults accusations cuomo nixes presidential talk^where name rank see popular baby names new york state^american idol rise kim kardashian every coldplay album what happened since buffalo made playoffs^ashley judd sues harvey weinstein defamation sexual harassment^oprah winfrey confirms wo n't run president 'i n't dna,1,5,4,6,0.16666666666666666,0.6666666666666666,0
16990802,SPECNewsROC,452,76617,705,97437,0,4,1,1,spectrum news offers best -hour local news coverage rochester plus weather sports favorite features,trading barbs campaign trail gop candidate governor mark molinaro new york become nation most^coming up delivers speech convention long island watch online^live vice president joe biden make statement rose garden watch gt^soon deliver remarks ny delegates philadelphia watch live^miss press conference update salt miners rescued lansing watch here gt via^icymi police say golf great tiger woods arrested dui charge florida,1,5,4,6,0.16666666666666666,0.6666666666666666,0
19737700,JoeTalkShow,797,74035,436,57438,0,4,1,1,syndicated talk show host i live mlk dream follow -- i see tweets resist resistance fbr profanity mute frustrate,patient protection affordable care act neither blm i soros funded if really cared why^goes interview like filters ears ignored co^next bword debacle you not want miss interview.^hour underway we 'll start giving iran access us banking saying would denied.^n't care your comments uneducated your lack knowing wo^sorry hear julia louis dreyfus diagnosed breast cancer.. sure universal healthcare..,1,5,4,6,0.16666666666666666,0.6666666666666666,0
498459134,McAllisterDen,1804,73079,760,33200,0,4,1,1,author what men want say women but can preorder author new york times bestseller spygate,teddy roosevelt required journalists n't like submit questions writing jfk routinely ousted unfriendl^teddy roosevelt required journalists n't like submit questions writing jfk r^teddy roosevelt required journalists n't like submit questions writing jfk routinely ousted unfriendl^teddy roosevelt required journalists n't like submit questions writing jfk r^nasty bigoted backlash over jenner ted cruz support^america ferrera reveals she was sexually assaulted years old e news,1,5,4,6,0.16666666666666666,0.6666666666666666,0
20562924,KSLA,592,69142,563,93219,0,2,1,3,ksla news national murrow award news tip call 318 -6713 email ksla.com,cbs releases transcript stormydaniels minutes interview^social security administration releases popular baby names state^ben affleck wo n't run senate the actor posted message facebook monday quitting day job^walmart remove 'cosmopolitan checkout lines^meghan markle dad wo n't attend royal wedding^pregnant april giraffe calf due march,1,5,4,6,0.16666666666666666,0.6666666666666666,0
15357193,WCBD,3626,67575,860,184716,1,4,0,1,count wcbd news latest news weather sports breaking news south carolina lowcountry,just in federal prosecutors charge nyc subway bomb suspect say wrote facebook trump failed protect nation^republicans set five candidates fight michael bennet d colorado seat us senate^the centers disease control prevention said death california n't immediate detai^update president trump makes first address joint session congress^the centers disease control prevention said death california n't immediate detai^just in kensington palace says prince charles walk meghan markle aisle royal wedding,1,5,4,6,0.16666666666666666,0.6666666666666666,0
18650417,1011_News,461,65331,598,69281,0,2,1,3,official twitter account koln-tv /11 news we cover happening live lnk also follow download now app,hard work pays rousseau elementary check celebration today named natio^a u.s. department agriculture agency contacting farmers gather year end production storage figure^here husker story may heard ... ol tanner farmer says huge illinois fan growing got^breaking cbs sports reporting tiger woods arrested dui charge florida early morning^miss nebraska sarah rose summers crowned miss usa first nebraska according miss neb^breaking today show anchor matt lauer fired nbc news complaint inappropriate sexual behavi,1,5,4,6,0.16666666666666666,0.6666666666666666,0
42486455,TheStarPhoenix,1538,64020,600,112131,0,0,1,5,saskatoon best online source breaking news,khloe kardashian tristan thompson cheating scandal plays kuwtk^icymi prince harry brings girlfriend meghan markle pippa middleton wedding reception^relive meghan markle prince harry big day the best royal wedding photos^icymicars the complete list nominees winners happen^oscars the complete list nominees winners happen^pregnant april giraffe calf due march,1,5,4,6,0.16666666666666666,0.6666666666666666,0
20728526,KEZI9,714,62873,633,66183,0,5,1,0,the official kezi news twitter page serving western oregon /7 nonstop news coverage live local late breaking,alert the us centers disease control prevention warned us consumers tuesday eat romaine lettuce^abc this week george stephanopoulos rescheduled sunday april pm due nba scheduling^alert the us centers disease control prevention warned us consumers tuesday eat romaine lettuce^alert with thanksgiving around corner us department agriculture food safety inspection ser^alert jbs tolleson inc. recalling million pounds raw beef products may tainted with^meghan mother doria ragland happy lovely news looks forward welcoming first,1,5,4,6,0.16666666666666666,0.6666666666666666,0
15150755,ksfynews,632,56578,521,70514,0,3,1,2,breaking news weather sports sioux falls aberdeen pierre local areas south dakota minnesota iowa tip line -9999 youask.com,according centers disease control prevention one hospital patients eerience treatment relat^president trump scheduled deliver sotu address joint session congress p.m. watch live^according centers disease control prevention one hospital patients eerience treatment relat^nami sioux falls announced line th annual dancing sioux falls stars including familiar^police say golf great tiger woods arrested dui charge florida ksfy^prepare another round livestream anticipation april giraffe pregnant ksfy,1,5,4,6,0.16666666666666666,0.6666666666666666,0
12272322,PoliticsReid,997,52763,1956,41297,1,4,0,1,correspondent author epidemic ebola global scramble prevent next killer outbreak,"by count assistance ru least women us house representatives nex^league conservation voters pumped 3m va dem campaigns^league conservation voters says plans spend 80m midterms^bonus fact state dept background notes bermuda population hamilton ,461. vacation^santorum super pac red white blue fund running 190k ad sc grps greenville charleston columbia^the brady bunch house sale los angeles can 1.88 million",1,5,4,6,0.16666666666666666,0.6666666666666666,0
15691595,coloradoan,1981,51206,1138,140153,0,5,1,0,your northern colorado news entertainment authority,breaking ex csu ad jack graham considering run michael bennet u.s. senate seat^endorsement coloradoan editorial board backs michael bennet u.s. senate copolitics^update democrat michael bennet wins election u.s. senate^tim neville joined field challengers michael bennet u.s. senate seat^senate pick leads denver schools michael bennet gov bill ritter surprise choice u.s. senate st..^a list memorable super bowl halftime shows including one michael jackson sb50,1,5,4,6,0.16666666666666666,0.6666666666666666,0
49720839,wics_abc20,5962,35010,472,67369,0,3,1,2,wics abc affiliate springfield illinois we source local news weather sports,now cases states investigated centers disease control prevention cdc^now cases states investigated centers disease control prevention cdc^former first lady michelle obama speak united state women summit los angeles saturday delivering^report angelina jolie named bizarre lax terror threat sent police^breaking tom petty found unconscious rushed hospital suffering full cardiac arrest^new in entertainment news richard simmons hospitalized severe indigestion,1,5,4,6,0.16666666666666666,0.6666666666666666,0
3243500510,teamtrace,2759,34386,721,25117,0,5,1,0,a nonprofit newsroom dedicated shining light america gun violence crisis sign newsletter,and firm rosendale hired place campaign ads appears identical apparent shell company set t^earlier week reported consulting firm nra paid produce ads support rosend^kaine vpdebate philando castile stopped times cop shot police abuse gun violence.^the fbi uniform crime reports provide glimpse extent armed hate crimes america but ma^a year old boy one four people found shot death murder suicide queens new york last night^president trump reportedly disclose scotus nominee monday for senators political stakes high,1,5,4,6,0.16666666666666666,0.6666666666666666,0
51241418,taradublinrocks,11377,32436,711,250686,0,5,1,0,writer/voice actor awaiting big break nj pdx blockedbytrump since /15 created leningradlindsey a popular anti-trump twitter force -la magazine,mike cernovich fucking asshole traitor significantly contributed cyberharassment campai^presidentaustin meet president obamaandkids thanksobama rt sundayfunday^if years ago amp tried meet putin alone americans room woul^if tried meet alone putin years ago called lynching even n^white house bars gina haspel from briefing senate on khashoggi murder via nobrow^rt selena gomez calls relationship justin bieber crazy intense,1,5,4,6,0.16666666666666666,0.6666666666666666,0
146504742,CBSNewsEnt,132,30573,396,25159,0,1,1,4,your trusted source entertainment news from cbs news team,sean hannity set interview roseanne barr fox news hannity thursday^leslie jones says targeting comedians inappropriate comments dumb^here kevin spacey character next season house cards frank underwood written o^jesse camp best known vj mtv late reported missing sister.^blac chyna granted temporary restraining order rob kardashian^tom daley dustin lance black married last spring announced wednesday eecting fir,1,5,4,6,0.16666666666666666,0.6666666666666666,0
112047591,JimmyVielkind,1007,26684,831,60063,0,5,1,0,wsj reporter covering new york politics government papa rvs husband kn upstate american views jimmy dot vielkind wsj dot com,campaign cut video juxtaposing statement abortion rights highlight reel dumb^from the ny league conservation voters gop sits affiliated board ha^oh fun rival candidates nygov league conservation vote^ok the convention kicking buffalo party chair giving opening speech.^there lots lots shout outs organized labor speech throughout convention unions are^cuomo normally name recognition relevant connection endeavor but abt na,1,5,4,6,0.16666666666666666,0.6666666666666666,0
402792142,WatchCTVNews,311,22439,358,104706,0,2,1,3,watch ctv news best news live events ctv news video network mobile,live now u.s. president donald trump speaks national republican congressional committee dinner^live now donald trump speaks las vegas campaign rally^from first blind date historic upcoming nuptials take look timeline prince harry meghan^talks announcement ryan seacrest kelly ripa new 'live co host^legendary comedian don rickles dies age^breaking former fox news ceo roger ailes dead report,1,5,4,6,0.16666666666666666,0.6666666666666666,0
324643494,Hot1015,9284,21314,256,151509,0,0,1,5,tampa bay new hit music,her face priceless so good watch britney spears get terrified by her kids^avicii family implies he died from apparent suicide more^meghan markle maid honor royal wedding^ariana grande mac miller break up here gt^fox announced network next live musical hit show rent^ariana grande reveals tracklist 'sweetener amp defends naming song fianc pete davidson more,1,5,4,6,0.16666666666666666,0.6666666666666666,0
23545095,ChadLivengood,6559,20227,807,80642,0,5,1,0,senior editor covering public affairs detroit alum c -420-6831 clivengood.com,"the republican national committee today put fake memo democrat plan fix t^take opposite tacks mass shooting orlando nightclub via politics^state economic development board picks state ad firm promote puremichigan campaign via^detroiters change auto insurance reform campaign thanks lansing billboards around detroit ha^a media buyer ad tracking document i 've seen shows detroit international bridge co. paid 47,800 nine spots o^on october weekend access hollywood tape surfaced bragging billy bush abou",1,5,4,6,0.16666666666666666,0.6666666666666666,0
195631270,micahuetricht,999,19743,432,36604,1,5,0,0,managing editor host author strike america forthcoming book bernie member midwestern name gmail,happy birthday salvador allende new yorkers elect socialist us house representatives as^nobody asked vote goes nelson lichtenstein 'state union amp kim moody 'an injury all be^meagan day bernie sanders foreign policy speech yesterday laying internationalist vision oppose rig^the best electoral hope right raise class consciousness millions people thro^watch great speech carlos rosa chicago city council member member closing the^philando castile had been stopped times by police,1,5,4,6,0.16666666666666666,0.6666666666666666,0
174145542,PamelaFalk,14261,17495,539,66851,0,5,1,0,cbs news tv radio unitednations goldprize elizabethneuffer award columbialaw alum president un correspondents assoc hillrat intlaff com tweetsmyown,president elect trump speaks divided country transcript^sunday^bolton says removing iran from syria trumps deposing assad^us plans dismantling nkorea nukes may face resistance^new us tariffs 50 billion goods imported china response chinese trade practices t^north korea says considering strike guam trump warns 'fire fury,1,5,4,6,0.16666666666666666,0.6666666666666666,0
17799686,esmemurphy,2324,16539,502,9607,1,5,0,0,reporter/anchor wcco-tv wcco-am radio host proud hockey mom,congresswoman elect ilhan omar entire unedited interview talks goals b^tune :30 remembering senator john mccain live interviews major gubernatorial candidates^sunday pm anchor interviews friendship amp legacy^issues press release another story past radio comments aug su^tune :30 remembering senator john mccain live interviews major gubernatorial candidates^sunday pm anchor interviews friendship amp legacy,1,5,4,6,0.16666666666666666,0.6666666666666666,0
49666825,FOX42KPTM,531,15199,347,32139,0,1,1,4,keep fox kptm online news weather well fox sports entertainment programming,watch live president trump attends national republican congressional committee dinner^angelina jolie split brad pitt 'i n't enjoy single^mario batali includes cinnamon roll recipe apology sexual misconduct^matt damon apologizes comments sexual misconduct^reports kylie jenner pregnant^april giraffe pregnant,1,5,4,6,0.16666666666666666,0.6666666666666666,0
18461401,EdwardLawrence,1479,13384,426,60365,1,5,0,0,correspondent emmy award winning journalist space force recruit x marathoner work twitter,in criminal complaint akayed ullah says criticized president trump facebook post accoun^us amp mexico reach agreement caravan mexican ambassador us says mexico asked un high commission refugees^wynn resorts announces steve wynn resigned ceo chairman board directors statement reads it w^at turkey pardoning important business going white house earlier turkey catwalk one of^white house brings one turkeys press briefing room turkey pardon whitehouse^there ton japanese media press briefing room no clue saying whitehouse,1,5,4,6,0.16666666666666666,0.6666666666666666,0
36739057,ivdailybulletin,241,13217,346,101941,0,0,1,5,local news matters we cover inland valley localnewsmatters,what pentagon papers spielberg the post^here help victims las vegas mass shooting^here help las vegas mass shooting victims^neil diamond retires touring diagnosis parkinson disease^brady bunch house closes sale 3.5 million almost twice asking price^eminem beyonce weeknd headline coachella valley music arts festival,1,5,4,6,0.16666666666666666,0.6666666666666666,0
15704971,sarahdwire,1351,10010,438,26363,1,5,0,0,i cover congress alum standing committee rra board `` skepticism patriotism '' -- scott pelley rt endorse sarah.wire.com,our basic request honor house representatives give us chance vote floor^ca delivers weekly republican address national security video^federal election commission cites five california candidates filing report^stresses senate intel dispute findings us intelligence community russian i^really enjoying live reaction world cup white house briefing room wait briefing start^los angeles times restaurant critic jonathan gold dies i never met j gold r,1,5,4,6,0.16666666666666666,0.6666666666666666,0
8162322,NikkiSchwab,7218,9802,380,34030,1,5,0,0,washington reporter formerly whispers rts high fives tips nschwab.com,finds three year old wilson north carolina he walking downtown chatting voters^sightings hearing tried truly hankering week h^while gave first big foreign policy speech today predecessor spotted e^being child president unpleasant president george w. bush tells new interview^the heads united states olympic committee usa gymnastics usa swimming started testimony befo^white house sends transcript deputy press secretary gaggle took qs the,1,5,4,6,0.16666666666666666,0.6666666666666666,0
14576879,1007sandiego,2035,8456,226,19679,0,2,1,3,san diego home am-10am roth am-3pm pm-7pm pm-12am a tegna station,as get holiday baking season centers disease control prevention wants remind e^as get holiday baking season centers disease control prevention wants remind e^john mayer hospitalized emergency appendectomy gt gt gt^frances bean cobain comes forward share story addiction recovery^here popular halloween candy every state gt gt gt^luke skywalker returns millennium falcon new 'star wars the last jedi trailer watch gt gt gt,1,5,4,6,0.16666666666666666,0.6666666666666666,0
19927280,WETM18News,305,8240,195,47033,0,4,1,1,your local news leader twin tiers watch us weekdays wetm noon pm :30pm pm pm wetm-2 pm weekends wetm pm pm,the centers disease control prevention said tuesday october th cases invest^temperatures nearing triple digits weekend fourth july weekend kicks the centers di^the centers disease control prevention said tuesday october th cases invest^of four categories one likely blow fuse the winners announced sunday^caitlyn jenner latest celebrity float run political office age president donald trump.^april giraffe pregnant peta issues statement pregnancy,1,5,4,6,0.16666666666666666,0.6666666666666666,0
27743424,1011wjrr,490,8147,159,21517,0,0,1,5,orlando rock station,fans react u2 cancels st. louis concert amid police protests^here how help victims las vegas mass shooting^here how help victims las vegas mass shooting^neil diamond retires from touring after parkinson disease diagnosis^hugh hefner cause death has been revealed^billboard music awards nominations see full list of bbmas nominees,1,5,4,6,0.16666666666666666,0.6666666666666666,0
444660111,peggy991,5097,7638,89,36233,0,0,1,5,playing winnipeg favourites day home samantha stevens show,icymi here complete winners list teen choice awards^leah remini calls jada pinkett smith practicing scientology still should calling people^icymi here complete winners list teen choice awards^if 've following jim carrey wrongful death lawsuit dismissed^mindy kaling confirmed oprah fact pregnant first child^attention chip lovers lay is giving us new flavors ... but which would you actually try people choice awar,1,5,4,6,0.16666666666666666,0.6666666666666666,0
437807525,AlexSamuelsx5,1151,6930,228,19206,1,4,0,1,political reporter covering intersection race politics ping pong champion talk asamuels.org,audience q lack leadership texas calls sid miller jesus shot paxton legal woes^wrapped convention speech no mention tdp18^kicks convention speech nod melania trump contentious jacket asking crowd i care do tdp18^the family separations talk continues dominate during convention speech says con^breaking white house vice president joe biden make statement rose garden^i miss black friday actually started friday you ca n't even finish thanksgiving without sales starting,1,5,4,6,0.16666666666666666,0.6666666666666666,0
53547251,BillHumphreyMA,664,6080,207,146883,0,5,1,0,candidate newton ward city council host wvud fmr ma sierra club political chair millennial dem eco housing activist zoology enthusiast,cory booker n't hesitate attack president obama election campaign running true amp effective ads romney^booker tried get effective campaign ads romney pulled mean donors^quick fact check confirms good anti romney ads priorities usa superpac messina obama campaign^and never forget cory booker complained loudly obama campaign amp superpacs running attack ads bain amp romney^unlike cory booker campaign senator sanders making tv appearances *back up* obama ads aga^far i encountered good one i need look specific word i usually use wiktion,1,5,4,6,0.16666666666666666,0.6666666666666666,0
49463843,CharlesBenson4,1037,5677,216,7565,1,5,0,0,you looking live veteran news reporter political junkie love run swim bike ironman wi half ironman mi,we talk w/ amp bloggers claimpresident trump told paul ryan you fired^from democrats presumptive presidential nominee orlando mass shooting^the rest statement orlando mass shooting^from ap speaker paul ryan says invite russia president vladimir putin address congress putin com^watch sunday morning catch interview^my conversation state republican efforts limit executive powers new governor he interv,1,5,4,6,0.16666666666666666,0.6666666666666666,0
196783947,aartipole,2463,5649,151,17249,0,4,1,1,host pronounced ar-thee watch sat -11:30pm et sun -9 pm et former washington correspondent reporter/vj toronto vcr wpg terrace,following election doug ford ontario provincial election debate province minimum wage^conservative commentator ann coulter called children crying border separated parents child^philando castile stopped times police was racial profiling^got 250 you can go sean spicer book party^boston 'free speech rally pitted 'fight white supremacy march^breaking mark salling one stars glee died age salling lawyer confirmed state,1,5,4,6,0.16666666666666666,0.6666666666666666,0
394101339,GaryGrumbach,4251,5617,176,16467,1,3,0,2,campaign embed always curious always eating rice cakes grad follow travels garyontheground,according federal complaint unsealed morning accused nyc bomber akayed ullah posted facebook trump^:30 left game transcript^getcha sweet tea hushpuppies ready republican national committee members vote today confirm charlotte^pres trump used phrase central casting speech workers cincinnati here time^fox news reporting former chairman ceo roger ailes dead^hearing april giraffe pregnant excited another edition watching aprilthegiraffe cam,1,5,4,6,0.16666666666666666,0.6666666666666666,0
34543494,pcnewsherald,102,3073,114,24907,0,0,1,5,this twitter account port clinton news-herald port clinton ohio we news source ottawa county,trump assertion left wing protesters violent white supremacists charlottesville sets firestorm^the best memorial day sales home appliances^the best memorial day sales home appliances^summer phoenix files divorce husband casey affleck^summer phoenix files divorce husband casey affleck^oscars the complete winners list,1,5,4,6,0.16666666666666666,0.6666666666666666,0
3242480310,WFXRnews,462,1486,68,20817,0,5,1,0,good day virginia wfxr news first news tips news.com,the strain e. coli causing current outbreak romaine lettuce found reservoir farm sa^the head world health organization said monday fight deadly ebola outbreak congo despite w^the strain e. coli causing current outbreak romaine lettuce found reservoir farm sa^the head world health organization said monday fight deadly ebola outbreak congo despite w^record imports eanded u.s. trade deficit fourth straight month september politically sensi^the american idol audition bus arrived richmond contestants auditioning producers get,1,5,4,6,0.16666666666666666,0.6666666666666666,0
95023423,UberFacts,1,13998682,18485,188926,0,4,2,0,the unimportant things never need know,"in american society civil engineers estimated ,000 high hazard dams ,000 deficient dams u.s^in american society civil engineers estimated ,000 high hazard dams ,000 deficient dams u.s^according centers disease control prevention us abortion rate currently time low t^according centers disease control prevention us abortion rate currently time low t^in lisa kudrow co authored scientific paper relation handedness cluster migraine headaches^when creating john doe notebooks film se7en prop designers researched handwriting various insane people",2,4,2,6,0.3333333333333333,0.3333333333333333,0
39743812,EconomicTimes,43,3327338,7655,411559,1,4,1,0,india no business daily brings latest news updates a times internet product,"us house representatives defeated immigrationbill supported presidenttrump proposed merit ba^mehul choksi fugitive jeweller centre rs ,000 crore pnbscam issued statement today saying he^will anybody really know trump said interview aired fox news sunday. all right anybody really^will anybody really know trump said interview aired fox news sunday. all right anybody really^china pledged tariffs void progress made recent trade talks beijing washington^here frequently asked questions peer peer p2p lending interesting investmen",2,4,2,6,0.3333333333333333,0.3333333333333333,0
1994321,FRANCE24,448,3221437,10521,329288,0,3,2,1,international news /7 languages fr en es ar,cherry picking china looks replace us farm goods trade war^record us imports drive goods trade deficit china high august^us lists chinese goods face tariffs latest trade war salvo^chadwick boseman 'black panther needed african accent^brad pitt start le mans hour race^legendary us comedian don rickles dies age,2,4,2,6,0.3333333333333333,0.3333333333333333,0
21701757,GQMagazine,793,1314645,8930,114453,0,0,2,4,look sharp live smart,never changing look problematic unless happen justin theroux^never changing look problematic unless happen justin theroux^natalie portman raps snl star wars prequels eating tide pods^these best tv shows^brendan fraser says hfpa denied claims sexual harassment^what binge weekend all netflix ca n't watch fam holiday season,2,4,2,6,0.3333333333333333,0.3333333333333333,0
394216985,nerdist,3555,457118,5091,101115,0,0,2,4,the official twitter,nicole kidman kicks serious ass trident new aquaman trailer^mattdamon reveals long jason bourne hiding 'll bourne5^watch rock freddie mercury queen biopic bohemianrhapsody first trailer^starwarsix enlisted dominicmonaghan join cast here everything know next episode fa^here everything know far starwars episodeix^greggrunberg returning starwars episode ix everything else know far,2,4,2,6,0.3333333333333333,0.3333333333333333,0
15652540,KTVU,1259,449519,3360,212596,1,1,1,3,complete bay area news coverage thanks following us if tweet us may use digital platforms tv,"family private investigator there evidence seth rich contact wikileaks prior death^the white house holds press briefing president donald trump denied russia still targeting united sta^tmz kylie jenner pregnant travis scott baby^harry potter river cruise set sail summer cost whopping 36,000^harry potter river cruise set sail summer cost whopping 36,000^actor vince vaughn arrested suspicion dui resisting arrest manhattan beach checkpoint",2,4,2,6,0.3333333333333333,0.3333333333333333,0
9567972,CNNnewsroom,555,411365,6665,26580,2,4,0,0,latest news information updates anchors reporters producers cnn newsroom a.m. p.m et weekends cnn,breaking melania trump undergoes kidney surgery walter reed medical center eected remain hospitaliz^we need wake america these fellow citizens ... 're treating like complete crap we must^this form american diplomacy seen modern era cnn political director^sen. chuck schumer us senators american people eect affirmative statement support the^former prosecutor solomon wisenberg likens rudy giuliani legal strategy murder suicide he metaphorically^ceos worried policy they worried trade war this enormous implications markets and,2,4,2,6,0.3333333333333333,0.3333333333333333,0
17308428,BN9,372,375490,1748,100175,1,4,1,0,breaking news first tampa bay continuous updates in-depth coverage provide news weather now,akayed ullah posted statement facebook account monday morning attack stating trump you^the centers disease control prevention cleared florida grown romaine lettuce multistate e. coli^clinton sanders campaigns agree add new hampshire debate ap the democratic presidential campaigns ...^the centers disease control prevention cleared florida grown romaine lettuce multistate e. coli^check refrigerators the u.s. department agriculture food safety inspection service eanded re^says time hollywood embrace shake hands president.,2,4,2,6,0.3333333333333333,0.3333333333333333,0
18713552,NRDC,3676,327022,7794,88101,2,4,0,0,natural resources defense council the earth best defense,the house representatives taken yet another swipe endangered species act voting strip gray^the house representatives taken yet another swipe endangered species act voting strip gray^milano according american society civil engineers bridges least years old^this historic win generate economic environmental benefits years come walton shepherd^the trump administration hellbent eanding drilling throughout waters shameless money grab flie^the us department agriculture withdrew obama era rule required space farm animals order for,2,4,2,6,0.3333333333333333,0.3333333333333333,0
7424642,japantimes,45,322171,10216,194067,1,2,1,2,breaking news features japan nation widely read english-language newspaper,u.s. house representatives accuses myanmar rohingya 'genocide demands reporters freed^rudy giuliani says trump could soon decide interview robert mueller^rudy giuliani rules trump interview robert mueller unless russia probe info revealed^celeb kylie jenner steals twitter spotlight super bowl announce birth girl^meghan markle dad wo n't attend royal wedding due health issues^the weinstein company looks file bankruptcy putting sexual abuse redress doubt,2,4,2,6,0.3333333333333333,0.3333333333333333,0
459872442,RadioFreeTom,1464,262213,3978,288633,0,4,2,0,professor author russia war nukes `` the death eertise '' noted curmudgeon anti-populist ex-gop cat guy views solely,we terrible citizens called patriotism likewise citizens keep together social^the patient protection affordable care act^well went quoted length adding timely useful i think politics may noted^except one i 'm sure four hand^he could taken metro georgetown kevin costner^and 're i assume reading court transcripts pentagon papers i think i tune,2,4,2,6,0.3333333333333333,0.3333333333333333,0
14940354,nycjim,2328,203242,6515,115585,1,4,1,0,full-time student news long-time follower grateful dead editor-in-chief cheddar ex-nyt mashable listen thunder shout,ted nugent serve co chair amp treasurer rep. sid miller campaign agriculture commissioner texas^hillary the stakes election clear donald trump temperamentally unfit president^elizabeth warren makes foreign policy speech sounds much like presidential candidate^bernie2020 laying groundwork launch presidential campaign bigger^read rt the caucus arizona republican debate live blog^nyt public editor harsh words larry david piece boston bombing insensitive unfunny,2,4,2,6,0.3333333333333333,0.3333333333333333,0
821193,slashfilm,1352,192256,5473,123703,0,0,2,4,owner/editor vlogger ama magician member board gamer disneyland fanatic frenchie/pom owner,robert pattinson almost punched director robert eggers over grueling filming conditions 'the lighthouse'^brad pitt latest threaten retirement says he quit acting three years^harvey weinstein arrested nypd charged with rape sex abuse^margot kidder star 'superman dead age^chilling 'house cards season teaser reveals fate kevin spacey frank underwood^colin trevorrow will return direct 'jurassic world,2,4,2,6,0.3333333333333333,0.3333333333333333,0
192547775,PressTV,65,189373,3310,212594,2,3,0,1,press tv first iranian international news network broadcasting english round-the-clock basis,the us house representatives passes piece legislation iran imposing additional sanctions country^dnc says way republicans would able preserve majority us house representatives^u.s. president donald trump giving statement sidelines g7 summit^iran russia turkey meet envoy syria next week un statement read^meet japanese 'michaeljordan basketball sports^koko gorilla mastered sign language dies koko considered pioneer inter species communicatio,2,4,2,6,0.3333333333333333,0.3333333333333333,0
162069651,TeleFashion,1502,145738,1371,46223,0,0,2,4,fashion news style advice beauty tips shopping picks,there something princess mary meet royal inspiring duchess cambridge et al^hollywood film awards see angelina jolie margot robbie wearing^ahead tonight ceremony look back best golden globes dresses time ...^golden globes best beauty selfies^golden globes best beauty looks pre awards show selfies^'i take clothes anymore empty cause says adriana lima victoria secret longest serving,2,4,2,6,0.3333333333333333,0.3333333333333333,0
1051201818,THEBEAT979FM,2821,123376,344,323257,0,0,2,4,the beat fm the heart beat of ibadan tune home office car online email info.com,kim kardashian denies hooking up with drake^so kourtney kardashian pregnant baby no sure babydaddy ...^fourth suspect arrested in xxxtentacion murder case^justin timberlake announces new album man of the woods^kim kardashian share first photo of chicago west^oscars the complete list of winners,2,4,2,6,0.3333333333333333,0.3333333333333333,0
489475164,ColMorrisDavis,1035,121342,1870,83593,1,4,1,0,former fed admin law judge gtmo chief prosecutor/colonel ret sr natsec specialist th congress opinions nyt wsj lat fox news msnbc cnn,is mount superior call standards ethical conduct set title c^abn as coal production continues decline that data availa^abn as coal production continues decline that data availa^is mount superior call standards ethical conduct set title c^abn as coal production continues decline that data availa^nice job pete ... beating around billy bush,2,4,2,6,0.3333333333333333,0.3333333333333333,0
14022672,KristinDSantos,752,120135,2935,23027,0,0,2,4,e news tv eert human jungle gym two small humans all inner beauty,it official advisor thevoice are teamblake^just looked apparently years ago whaaaa i interviewed kelly clarkson spot^we calculated divorce rate every real housewives show results will blow your mind^ryan murphy elains feud ending ...^want the cw fall premiere dates ok cool go^nbc first look check out j.j. abrams revolution ryan murphy the new normal more,2,4,2,6,0.3333333333333333,0.3333333333333333,0
21845346,wsfa12news,419,116935,828,170203,0,0,2,4,the official twitter account wsfa news montgomery alabama note content shared via tweets may republished air online,actor chris pratt files divorce wife anna faris^david cassidy fighting memory loss wants 'enjoy life^walmart remove 'cosmopolitan checkout lines^meghan markle dad wo n't attend royal wedding^actor chris pratt files divorce wife anna faris^april giraffe pregnant,2,4,2,6,0.3333333333333333,0.3333333333333333,0
62454048,comingsoonnet,441,95732,2965,72437,0,0,2,4,latest movie tv news reviews game updates digital hd blu-ray announcements,margot robbie amp matthias schoenaerts signed for justin kurzel ruin^untitled woodyallen film casts ellefanning^comedy legend jerry lewis dies age^outlander renewed seasons season premiere november outlander outlanderseason4^amy berg the case against adnan syed documentary series coming^netflix lands ryan murphy new series the politician starring ben platt possibly barbra streisand gwynet,2,4,2,6,0.3333333333333333,0.3333333333333333,0
42700240,RFERL,1038,82367,2782,69946,1,4,1,0,radio free europe/radio liberty provides first-hand coverage russia ukraine e. europe balkans caucasus afpak me,u.s. house representatives condemns nordstream2 says boost russian control europe energy suppli^the united states likely surpassed russia saudi arabia become world largest producer crude oi^the united states likely surpassed russia saudi arabia become world largest producer crude oi^this lie statement the offer must made lawmakers offer must made the^the united states likely surpassed russia saudi arabia become world largest producer crude oi^trump warns 'fire fury north korea threatens missile strike guam,2,4,2,6,0.3333333333333333,0.3333333333333333,0
15365401,WWLP22News,700,81548,635,184556,0,1,2,3,since first broadcast news trusted local news source viewers throughout western massachusetts,the war poverty years later years ago january president lyndon b. johnson declared ...^chris pratt files divorce anna faris^david cassidy fighting memory loss wants enjoy life^dance moms star abby lee miller sentenced year prison^meghan markle half sister fires back prince harry family comments^chris pratt files divorce anna faris,2,4,2,6,0.3333333333333333,0.3333333333333333,0
259506084,9NewsAdel,1286,76575,500,188043,0,1,2,3,adelaide news nightly 0pm community guidelines,just in australian cricketer usman khawaja made brief statement arrest brother part o^funny man billy connolly battle parkinson disease taken turn worse robbing memor^in service lasting hours performers including faith hill ariana grande jennifer hudson stevie wonder pa^watch it official after months speculation prince harry engaged american actress meghan markle news^new details released wedding year meghan markle prince harry revealing is^new details released wedding year meghan markle prince harry revealing is,2,4,2,6,0.3333333333333333,0.3333333333333333,0
20630658,wpdeabc15,586,68868,529,117975,1,0,1,4,news weather sports grand strand pee dee,four days events arranged honor life legacy president george h.w bush he died friday a^report ben affleck jennifer garner settle divorce^kermit frog getting new voice years^just in former fox news ceo roger ailes dead^oscars the complete list nominations winners^april giraffe pregnant do think second pregnancy garner much attention first,2,4,2,6,0.3333333333333333,0.3333333333333333,0
5508672,nwi,2506,60753,541,136159,0,4,2,0,the times northwest indiana brings news information entertainment residents nwindiana,what popular baby names state year born^icymi families share memories two victims deadly shooting chicago mercy hospital^important stories need know yesterday families share memories two victims deadly sh^update families share memories two victims deadly shooting chicago mercy hospital^mlb predictions who come top^today birthdays sept. beyonce knowles,2,4,2,6,0.3333333333333333,0.3333333333333333,0
16456004,nbc15_madison,3552,55346,1090,100728,1,2,1,2,the official account wmtv nbc15 madison wi tipline -274-1500 email news.com instagram madison facebook,new york ap federal prosecutors charge nyc subway bomb suspect say wrote facebook trump failed protect nation^washington ap white house vice president joe biden make statement rose garden nbc15^philadelphia ap democratic national committee offers `sincere apology sanders amp supporters `inexcusable remarks emails nbc15^channing tatum wife jenna dewan tatum announce split years marriage nbc15^ryan seacrest kelly ripa new co host 'live^olivia newton john postpones tour dates due breast cancer battle,2,4,2,6,0.3333333333333333,0.3333333333333333,0
14526877,TUSK81,1680,45274,1191,80999,1,3,1,1,staff writer formerly bylines univision pri wapo immigrant rights lgbt+ rights cancer survivor catlady views,the imminent democratic takeover house representatives renewing hope undocumented immigrants who^brett kavanaugh first supreme court nominee water history nbc news/wall street journal poll^*me co moderating democratic presidential debate* just yes response please is stevie nicks gay^included nikki janelle enriquez one four women murdered border patrol agent september^the new celebrity apprentice better ratings^meryl streep joins big little lies season,2,4,2,6,0.3333333333333333,0.3333333333333333,0
133929829,liamstack,7301,43167,1545,129320,0,3,2,1,new york times reporter khawaga-at-large liam.stack.com,by end george h.w bush term h.i.v infection leading cause death men united states^trump fox amp friends will sit interview mueller investigation i 'll whatever i get^by end george h.w bush term h.i.v infection leading cause death men united states^president donald trump first lady melania keep separate bedrooms via^how i learned tolerate blake lively a+ headline morris^woody allen the whole harvey weinstein thing sad everybody involved,2,4,2,6,0.3333333333333333,0.3333333333333333,0
22974378,end1065,1657,37073,353,71382,0,0,2,4,home wake up call gavin katie rayne every morning :30am listen app an entercom station,rumors swirling dating robert pattinson see the photo everyone talking^icymi complete list grammy winners^have mercy uncle jesse eecting first child fianc e caitlin mchugh gt^jennifer lawrence single details split director boyfriend /^richard simmons hospitalized severe indigestion details^announced going return new halloween movie next year,2,4,2,6,0.3333333333333333,0.3333333333333333,0
87491355,HeatVisionBlog,661,28635,986,18209,0,0,2,4,comic books sci-fi the hollywood reporter,mark hamill asks 'star wars fans lobby carrie fisher star^the promise carrie fisher final 'star wars appearance^'walking dead promotes trio series regular season^blake lively injured set 'the rhythm section^blake lively injured set spy thriller the rhythm section production halted^colin trevorrow direct 'jurassic world,2,4,2,6,0.3333333333333333,0.3333333333333333,0
19523339,AlgoaFM,283,23792,177,11766,0,0,2,4,adult contemporary radio station broadcasting garden route wild coast south africa,channing tatum wife jenna dewan tatum announce split^full list winners critics choice awards^candice swanepoel says proud post baby figure clap back critics^david foster katharine mcphee engaged^icymi the complete list winners from billboard music awards^complete list winners from billboard music awards,2,4,2,6,0.3333333333333333,0.3333333333333333,0
40145940,RickSmithShow,3065,23353,478,69890,2,4,0,0,patriotic american bringing theresistance radio daily pm-11pm your tv sat pm podcast,suneel gupta founder healthcare startup congressional candidate michigan th district^our first guest today michigan state senator ian conyers candidate us house representatives^i n't seen devos minutes interview i 've read transcript i think completely incapable bei^talking jim hoffa general president international brotherhood teamsters^up next michael b. filler director public services division international brotherhood^our next guest gary din jr. vice president international brotherhood teamsters local alaska.,2,4,2,6,0.3333333333333333,0.3333333333333333,0
2785808313,popbuzz,630,16054,314,35018,1,0,1,4,we put the pop in pop cultureft memes a load of fresh news vids of your faves part,have heard rumour snapchat shutting well n't panic yet ...^millie bobby brown performing version girlslikeyou instagram she also starred music vid^the votes ... best tv shows need watch^american horror story season anyone here everything know far ...^harry potter star matthew lewis marries longtime girlfriend angela jones^everything know season far,2,4,2,6,0.3333333333333333,0.3333333333333333,0
21656055,TheWeekUK,1492,13262,474,55352,0,0,2,4,all need know everything matters print online mobile apps,baftas lalaland leads winners list whilst caseyaffleck violadavis amp devpatel also pick awards^davidbeckham blackmail plot emails 'doctored 'inaccurate remains 'proud ex footballer^love island sophie gradon found dead know sophiegradon^do i need british accent barack obama bromance prince harry display interview for^do i need british accent barack obama bromance prince harry shines interview^royal wedding prince william chooses prince harry best man following harry night gay soho club,2,4,2,6,0.3333333333333333,0.3333333333333333,0
127646305,SPECNewsHV,290,12635,280,51252,0,3,2,1,spectrum news offers best -hour local news coverage plus weather sports favorite features,coming up delivers speech convention long island watch online^live vice president joe biden make statement rose garden watch gt^soon deliver remarks ny delegates philadelphia watch live^if name recognition i 'm hoping brad pitt angelina jolie billy joel n't get r^miss press conference update salt miners rescued lansing watch here gt via^in case missed aprilthegiraffe pregnant here see oliver excitement baby no with,2,4,2,6,0.3333333333333333,0.3333333333333333,0
34728647,991WMYX,1452,11940,141,12246,0,0,2,4,milwaukee best mix music stream follow,rumors swirling dating robert pattinson see the photo everyone talking^icymi complete list grammy winners^have mercy uncle jesse eecting first child fianc e caitlin mchugh gt^jennifer lawrence single details split director boyfriend /^richard simmons hospitalized severe indigestion details^announced going return new halloween movie next year,2,4,2,6,0.3333333333333333,0.3333333333333333,0
21889575,alice1059,9089,10978,258,33688,0,0,2,4,alice kalc-fm denver co entercom communications corp. station today biggest music stars,rumors swirling dating robert pattinson see the photo everyone talking^icymi complete list grammy winners^have mercy uncle jesse eecting first child fianc e caitlin mchugh gt^jennifer lawrence single details split director boyfriend /^richard simmons hospitalized severe indigestion details^announced going return new halloween movie next year,2,4,2,6,0.3333333333333333,0.3333333333333333,0
22543975,B937AlltheHits,4152,9973,138,33950,0,0,2,4,home and call/text -800-386-0937,rumors swirling dating robert pattinson see the photo everyone talking^icymi complete list grammy winners^have mercy uncle jesse eecting first child fianc e caitlin mchugh gt^jennifer lawrence single details split director boyfriend /^richard simmons hospitalized severe indigestion details^announced going return new halloween movie next year,2,4,2,6,0.3333333333333333,0.3333333333333333,0
18276982,Hot103Jamz,2030,9858,116,59023,0,0,2,4,kansas city hip hop r b connect,hoda kotb al roker amp craig melvin open megyn kelly today hour first show since cancellation^in new rambling message kanye west blames social media mind control calls himself best living recording ar^how janet jackson got body back post baby^billboard music awards check complete list winners^blac chyna criticized letting dream kardashian wear pink hair extensions^billboard music awards check complete list winners,2,4,2,6,0.3333333333333333,0.3333333333333333,0
88844256,Mix947Austin,7622,8536,165,16681,0,0,2,4,home today best mix booker alex sara morning,rumors swirling dating robert pattinson see the photo everyone talking^icymi complete list grammy winners^have mercy uncle jesse eecting first child fianc e caitlin mchugh gt^jennifer lawrence single details split director boyfriend /^richard simmons hospitalized severe indigestion details^announced going return new halloween movie next year,2,4,2,6,0.3333333333333333,0.3333333333333333,0
802620552,Mix1051Madison,2356,7633,57,11824,0,0,2,4,mix plays minutes today hits every hour listen anytime anywhere app,rumors swirling dating robert pattinson see the photo everyone talking^icymi complete list grammy winners^have mercy uncle jesse eecting first child fianc e caitlin mchugh gt^jennifer lawrence single details split director boyfriend /^richard simmons hospitalized severe indigestion details^announced going return new halloween movie next year,2,4,2,6,0.3333333333333333,0.3333333333333333,0
27880541,mystar1025,833,6821,105,22128,0,0,2,4,star buffalo at work radio station rob lucas morning,rumors swirling dating robert pattinson see the photo everyone talking^icymi complete list grammy winners^have mercy uncle jesse eecting first child fianc e caitlin mchugh gt^jennifer lawrence single details split director boyfriend /^richard simmons hospitalized severe indigestion details^announced going return new halloween movie next year,2,4,2,6,0.3333333333333333,0.3333333333333333,0
26018285,949ThePoint,299,5608,71,13684,0,0,2,4,download app listen us anywhere thepoint entercom station,rumors swirling dating robert pattinson see the photo everyone talking^icymi complete list grammy winners^have mercy uncle jesse eecting first child fianc e caitlin mchugh gt^jennifer lawrence single details split director boyfriend /^richard simmons hospitalized severe indigestion details^announced going return new halloween movie next year,2,4,2,6,0.3333333333333333,0.3333333333333333,0
718598166,DeadlineNellie,676,4500,166,15018,0,0,2,4,i deadline tv editor send hot tips nellie.com,take two procedural from castle creator starring eddie cibrian amp rachel bilson gets straight to series abc order^steve harvey to end daytime talk show launch new one with img amp nbcu^cw fall premiere dates network to roll out lineup october originals held back^once upon a time renewed for season by abc^the originals to end after season on the cw^big little lies meryl streep joins season cast of hbo series,2,4,2,6,0.3333333333333333,0.3333333333333333,0
105247925,1051thebuzz,471,1776,60,4666,0,0,2,4,the buzz today best mix,rumors swirling dating robert pattinson see the photo everyone talking^icymi complete list grammy winners^have mercy uncle jesse eecting first child fianc e caitlin mchugh gt^jennifer lawrence single details split director boyfriend /^richard simmons hospitalized severe indigestion details^announced going return new halloween movie next year,2,4,2,6,0.3333333333333333,0.3333333333333333,0
198760892,RyanJacobs105,963,1052,63,14676,0,0,2,4,on air radio personality on b105/wube fm cincinnati host midnight show,maddie poppe wins season american idol winner ai americanidol season16^ozzy osbourne sharon osbourne split after years marriage ozzyosbourne sharonosbourne sad breakup^ryan seacrest kelly ripa new co host 'live ryanseacrest kellylive kellyandryanlive^kevin hart wife eniko parrish announce they 're eecting their first child together kevinhart congrats baby^jesus christ superstar set nbc next live musical nbc live musical jesuschristsuperstar easter^fuller house renewed for season by netflix fullerhouse season4 netflix,2,4,2,6,0.3333333333333333,0.3333333333333333,0
99458922,DunyaNews,68,1841563,1318,329495,0,2,4,0,official twitter feed dunya news follow us latest news updates,pmimrankhan taking u turn even statement u turn wait imrankhan taking much time^imran dubs charter democracy 'corruption charter^trump warns north korea 'fire fury^channing tatum wife jenna dewan tatum announce split^amal george clooney welcome boy girl twins^david beckham face trial speeding offence,4,2,-2,6,0.6666666666666666,-0.3333333333333333,1
20962674,TimeOutNewYork,1161,983602,7531,60400,0,0,4,2,the best events dining art culture film music nyc // pick free copy every wednesday // follow us instagram,icymi here complete list winners tony awards^new a complete list winners tony awards tonyawards^icymi hoda kotb officially replaced matt lauer^hoda kotb officially replaced matt lauer today^icymi armie hammer make broadway debut straight white men^armie hammer make broadway debut straight white men,4,2,-2,6,0.6666666666666666,-0.3333333333333333,1
2231905548,DailySabah,7,482769,1617,120353,4,1,0,1,turkey top english newspaper providing latest local global headlines istanbul arabic german russian,legislation proposed chairman house representatives armed services committee asks us block the^us house representatives kills hard right immigration bill embraced trump amid escalating battle zero t^latest us house representatives narrowly passes bipartisan budget measure ending government shutdown^latest us house representatives cannon office building evacuated reason cited congress sess^canada announces slap tariffs us goods retaliation washington measures erts its^prince charles walk meghan markle aisle royal wedding father drops due ill health,4,2,-2,6,0.6666666666666666,-0.3333333333333333,1
769214965,yabaleftonline,28,410638,644,47153,0,0,4,2,entertainment comedy viral news music gists contact yabaleftonline.com,we self made kim kardashian defends kylie jenner^we self made kim kardashian defends kylie jenner^the weeknd upset selena gomez justin bieber recent hangout^kanye told date sex tape kim kardashian reveals^royal rules meghan markle follow duchess^tyga reacts reports kylie jenner pregnant travis scott,4,2,-2,6,0.6666666666666666,-0.3333333333333333,1
56510427,motherboard,106,225420,5789,75941,0,2,4,0,tech tip us securely,someone posted weed viagra spam us department agriculture site^someone posted weed viagra spam us department agriculture site^someone used algorithm paste face wonder woman star gal gadot onto porn video implication^someone used algorithm paste face wonder woman star gal gadot onto porn video implication^someone used algorithm paste face 'wonder woman star gal gadot onto porn video implication^someone used algorithm paste face wonder woman star gal gadot onto porn video implication,4,2,-2,6,0.6666666666666666,-0.3333333333333333,1
12804312,KPCC,2194,117540,2266,103182,0,0,4,2,independent news conversation community friendly local public radio station home news,trump defends confederate statues series tweets calling beautiful statues monuments.^what night thanks joining us academy awards see full list winners^golden globes see full list winners^nbc picks hoda kotb replace matt lauer 'today show^after years television famous amphibian kermit frog getting new voice^judge declares mistrial bill cosby sexual assault case,4,2,-2,6,0.6666666666666666,-0.3333333333333333,1
284967242,Radio2000ZA,8913,86979,203,112004,1,2,3,0,the home all-time favourites our music your memories ... fm nationwide channel satellite audio bouquet whatsapp,george herbert walker bush st president united states father former president george w.^us republican presidential hopeful donald trump challenged democratic rival drug test next debate^former us president barack obama meet president cyril ramaphosa johannesburg wanderers stadium ahead^hollywood actor brad pitt set face lawsuit homes built foundation area new orleans.^it chooseday which song taking us lunch afternoon theinnercircle adele hello sam smith s^one big song planethaaibo stay too good goodbyes .,4,2,-2,6,0.6666666666666666,-0.3333333333333333,1
5959342,charlesarthur,1319,74775,4287,206752,1,2,3,0,journalist speaker moderator the guardian technology editor -14 publ may 18 cyber wars hacking prev digital wars apple v google v microsoft,at sid miller commissioner agriculture texas. worries us become muslim presently^accurately reported record major interview audio transcript^because global economy us highest living standards world measured value of^playing spot future star bit part go series so far ju^proud i recognised modern family julie bowen claire dunphy old old 1998 episode er s5 e1 app^ooh watch modern family julie bowen s5,4,2,-2,6,0.6666666666666666,-0.3333333333333333,1
8862532,amNewYork,945,64045,1850,72366,1,0,3,2,all things nyc news commuting entertainment things eat be alert news tip news.com,trump failed protect nation port authority elosion suspect akayed ullah wrote facebook m^jenna bush hager apologizes hidden fences flub golden globes says watched movies^kanye west suffering paranoia remain hospitalized indefinitely reports say^i enjoy single it something i wanted angelina jolie says split brad pitt^jimmy kimmel oscars host returning nd year row^rapper kidd creole charged fatal stabbing homeless man midtown east police source says,4,2,-2,6,0.6666666666666666,-0.3333333333333333,1
19666861,KevinMcCarthyTV,999,54928,634,63907,0,0,4,2,film lover found true romance taco bell in-n-out chucks terminator metal dog oscar gooddaydc sports junkies co-host,loved sitting dakota johnson we geeked little intrvu suspiria dakota said are^this looks incredible spoke dakota johnson back february said primary colors t^just saw fifty shades freed paris writing dakota johnson jamie dornan rita ora here fifty s^just saw fifty shades freed paris writing dakota johnson jamie dornan rita ora here fifty s^watch ready player one interviews steven spielberg tye sheridan olivia cooke^if u pick one definitive best steven spielberg film you choose one we going liv,4,2,-2,6,0.6666666666666666,-0.3333333333333333,1
218565801,Global_Montreal,1023,50763,612,153443,1,2,3,0,global news from breakfast bedtime got montreal covered team twitter like us facebook,texas official sid miller uses c word hillary clinton twitter^philando castile stopped times police was racial profiling^watch live hillary clinton addresses supporters campaign rally las vegas^here complete list nominees golden globes who rooting^hot heels win superfantastico music competition montreal singer donna marrone joins global s^jenner n't reveal final surgery last page,4,2,-2,6,0.6666666666666666,-0.3333333333333333,1
2329058035,lbcbreaking,60,41868,590,26532,2,2,2,0,the latest breaking news alerts lbc for in-depth analysis today stories follow listen,us prosecutors charged new york bomb suspect akayed ullah saying wrote facebook trump failed protect nation^george hw bush st president united states died age spokesman said^hillary clinton bernie sanders square later first democratic presidential debate since new hampshire primary loss^the white house says donald trump received briefing director cia investigation th^david beckham face trial alleged speeding offence west london january year^david beckham prosecuted speeding charge celebrity lawyer nick freeman dubbed mr loophol,4,2,-2,6,0.6666666666666666,-0.3333333333333333,1
73987740,ReelTalker,3631,17909,630,383950,0,0,4,2,film/tv journo hire reeltalkonline.com,leonardo dicaprio star produce paramount adaptation the black hand via^universe rt is kristen stewart replacing angelina jolie^'m going limb say bullock snubbed natalie portman brad pitt get sag nods^the women hollywood speak out^honestly roseanne like antithesis willandgrace i think interesting revival shows a^a michael jackson musical is coming to broadway in bossip via thank please,4,2,-2,6,0.6666666666666666,-0.3333333333333333,1
21339204,MSNvideo,1977,17403,262,22188,0,1,4,1,the best news movies tv music comedy sports lifestyle viral video,john mccain in words^meghan markle brought happy tears kids anti zika serenade^clooney twins turn how fatherhood changed george clooney^katy perry advice 'american idol hopefuls post taylor swift feud exclusive^katy perry advice 'american idol hopefuls post taylor swift feud exclusive^prince harry asks william best man,4,2,-2,6,0.6666666666666666,-0.3333333333333333,1
97459853,FarrahFazal,9997,9026,418,184066,3,2,1,0,storyteller correspondent investigative war `` signal '' immigration race politics terrorism mxborder ferguson farrahfazal.com rts endorsements,melania trump undergoes kidney surgery walter reed medical center^a fake photo emma gonz lez went viral far right parkland teens villains^rt congresswoman eddie bernice johnson texas recognized hazar imam us house representatives efforts in^the economist president economic vision words transcript donald trump interview via^kirstjen nielsen wins trump praise testy white house briefing cnnpolitics^gwyneth paltrow angelina jolie others say weinstein harassed them via,4,2,-2,6,0.6666666666666666,-0.3333333333333333,1
19604028,euanrellie,3305,5952,158,101923,1,1,3,1,aesthete show-off,pence michelle obama is vulgar first lady ever^philando castile had been stopped times by police^trump rescinds rules bathrooms transgender students^morning joe hosts trump bring national enquirer into their feud^georgina chapman life after harvey weinstein via^ving rhames says police held him gunpoint his own home via,4,2,-2,6,0.6666666666666666,-0.3333333333333333,1
43855487,bsindia,379,1803437,2770,251162,4,1,1,0,latest updates news live coverage economy companies markets politics technology india leading business daily,aruna miller maybe second indian american woman enter us house representatives maryland^aruna miller maybe second indian american woman enter us house representatives maryland^says nafta end soon congress months approve new deal the us landscape shift si^says nafta end soon congress months approve new deal the us landscape shift si^in round trade war us plans tariffs 200 bn chinese goods tradetalks tradewars^trump warns 'fire fury north korea threatens strike guam,5,1,-4,6,0.8333333333333334,-0.6666666666666666,1
33549858,VH1,15386,1294669,6390,89335,0,0,5,1,where pop culture comes party mon lhhh cartelcrew wed basketballwives blackinkcrew blackinkcompton,kim kardashian defends y/o kylie jenner decision get lip fillers gt^a complete timeline miley cyrus liam hemsworth relationship daysoflove^iconic reveal posts first photo twins sir rumi carter^vote jennifer aniston vs. jennifer lopez rom com showdown^is alleged sex tape real people really bored^here thackery binx hocuspocus looks like gt,5,1,-4,6,0.8333333333333334,-0.6666666666666666,1
115628224,Omojuwa,3441,722940,1420,543881,0,1,5,0,author order copy amazon eloring behaviour change faculty brain sciences,repeatedly posting videos pastors shame christianity without balancing pastors and^hollywood actor george clooney and lawyer wife amal welcome twins^kendall jenner pregnant see her rocking baby bump^angelina jolie breaks silence on her divorce with brad pitt^kendall jenner pregnant see her rocking baby bump^grammy awards see full winners list,5,1,-4,6,0.8333333333333334,-0.6666666666666666,1
67594122,FeminaIndia,225,578005,577,108325,0,0,5,1,femina leading women magazine brand country its success built connect indian woman every area life,the duchess cambridge believes overall wellness^get ready welcome two gorgeous people world george amal clooney eecting twins^cuteness overload cousins play date^catherine duchess cambridge looks elegant royalwedding^catherine duchess cambridge looks elegant royalwedding^game thrones stars rose leslie kit harington officially married and several cast members attended w,5,1,-4,6,0.8333333333333334,-0.6666666666666666,1
3646911,empiremagazine,645,577282,7325,59280,0,0,5,1,the world biggest best movie magazine home white nugent,josh o'connor marion bailey joining thecrown prince charles queen mother^josh o'connor marion bailey new prince charles queen mother thecrown^margot robbie matthias schoenaerts starring new thriller ruin^elle fanning timoth e chalamet selena gomez woody allen next film^woody allen adding elle fanning timoth e chalamet selena gomez unknown next film^blake lively injured set spy thriller the rhythm section,5,1,-4,6,0.8333333333333334,-0.6666666666666666,1
15954704,ReutersIndia,76,529316,6367,146138,0,0,5,1,the latest india around world,north korea says considering strike guam trump warns 'fire fury^dakota johnson trained '50 shades shoot suspiria dances venezia75^fifty shades freed sees jamie dornan dakota johnson return christian grey anastasia steele conc^a look back scenes wedding prince harry meghan markle royalwedding^fifty shades freed sees jamie dornan dakota johnson return christian grey anastasia steele conc^prince harry asks elder brother william best man wedding,5,1,-4,6,0.8333333333333334,-0.6666666666666666,1
17590516,danwootton,4614,338932,1309,62212,0,0,5,1,the sun executive editor entertainment presenter itv lorraine talkradio host subscribe podcast the dan wootton interview insta,exclusive the queen warned prince harry meghan markle behaviour attitude royal wedding follow^exclusive cheryl liam payne pals reveal truth behind split speaks new music^exclusive meghan markle moving pet dogs uk another sign wants live prince harry^america greatest ever female broadcaster boundary pushing first solo woman host one t^exclusive the queen warned prince harry meghan markle behaviour attitude royal wedding follow^breaking simon cowell rushed hospital accident london home my full exclusive story her,5,1,-4,6,0.8333333333333334,-0.6666666666666666,1
432557320,TimesofIsrael,592,266806,3782,189535,0,0,5,1,the one-stop news site israel region jewish world for breakingnews check,kim kardashian face israeli sunglasses brand alongside bar refaeli^did lindsay lohan convert islam^did lindsay lohan convert islam^twitter community mourns lea michele^twitter community mourns lea michele via prayforlea^legendary jewish comedian don rickles dies,5,1,-4,6,0.8333333333333334,-0.6666666666666666,1
19988587,aperturefnd,1371,238982,2890,18372,0,1,5,0,aperture connects photo community audiences inspiring work sharpest ideas other in print person online,philip montgomery photographs span u.s. depicting state union trenchant precision his work^the fall issue aperture magazine los angeles elores one america photographed cities lon^like metropolis la dynamic changing evolving contested learn story behind cover fall^aperture magazine fall issue los angeles elores one america photographed cities long been^aperture magazine fall issue los angeles elores one america photographed cities long been^aperture magazine fall issue los angeles elores one america photographed cities long been,5,1,-4,6,0.8333333333333334,-0.6666666666666666,1
16929559,nytimesmusic,40,171726,4771,44417,0,1,5,0,music reviews news pop music staff get weekly newsletter,after concert finished republican national committee took possession concert footage pl^what kanye west said slavery mental health obama new interviews^once passion project part timers new intensity rehearsals kingdom choir it started soon^in mid ashlee simpson platinum albums mtv reality show hear first two popcasts about^listen second part ashlee simpson podcast includes depth analysis reality show a^in mid ashlee simpson platinum albums mtv reality show the popcast team celebrates disse,5,1,-4,6,0.8333333333333334,-0.6666666666666666,1
34940839,Y100MIAMI,824,49703,819,60146,0,0,5,1,miami hit music station y100 home,y100 celebrating baby bumps we seen princess kate baby bump want see ...^chris brown slammed judge skipping court hearing related karrueche tran retraining order^okay swifties final verdict ... gorgeous nah^awww gives birth baby boy congrats^'american idol return kanye west^beyonc made surprise appearance present colin kaepernick sports illustrated muhammad ali legacy awar,5,1,-4,6,0.8333333333333334,-0.6666666666666666,1
14578312,thewayoftheid,1699,38305,768,285498,0,1,5,0,reporter englewood/auburn gresham/chatham deadbeat dad dorothy parker enthusiast eva,th ward forum apostolic church god chicago il^i need build time machine hop bish travel destroy ryan seacrest career grammys^people people the real enemy ryan seacrest destroy him^that i go back time destroy ryan seacrest unleashes broads unto world^now i go back time destroy ryan seacrest steps e pitch mtg^maria i lowkey afraid the apocalypse might nigh,5,1,-4,6,0.8333333333333334,-0.6666666666666666,1
24544452,MarlowNYC,753,36662,1030,86194,0,0,5,1,senior entertainment editor the daily beast alum likes whiskey,tiffany haddish girls trip ralph fiennes a bigger splash charlize theron mad max fury road^tom cruise strange hold katie holmes scientology minders dating ban^tom cruise strange hold katie holmes scientology minders dating ban^tom cruise strange hold katie holmes scientology minders dating ban^robert pattinson obsession it bizarre curiosity^justin bieber reportedly hits paparazzo truck outside church l.a,5,1,-4,6,0.8333333333333334,-0.6666666666666666,1
4214201473,RingerPodcasts,124,32479,336,6388,0,1,5,0,podcasts lots staff,examine rudy giuliani enlightening interview sean hannity peter king^kylie jenner baby named stormi armie hammer took tracksuit tour would jam sessio^on jam session discuss angelina jolie vanity fair cover story^on jam session discuss angelina jolie vanity fair cover story^on jam session. discuss jennifer aniston justin theroux divorce amy schum^on jamsession look timeline ariana grande pete davidson relati,5,1,-4,6,0.8333333333333334,-0.6666666666666666,1
569128022,EntCity,672,28344,93,7687,0,0,5,1,canada first source entertainment news breakfast television breaking news live updates follow us instagram,style eert drops toronto show latest trends stylish workout gear wi^takes pics wedding dress despite rumours engagement liam hemsworth officially called^style eert drops toronto show latest trends stylish workout gear wi^style eert drops toronto show latest trends stylish workout gear wi^style eert drops toronto show latest trends stylish workout gear wi^first look penelopecruz donatellaversace ryanmurphy newest the assassination gianni versa,5,1,-4,6,0.8333333333333334,-0.6666666666666666,1
2575205850,JimLaPorta,6952,18894,379,29124,0,1,5,0,staff writer covering military advisor veteran dm contact info,watching right talking u.s. troops combat president commen^valentin fogelman you definitely pass alo^valentin fogelman agent orange joke va took wa^fogelman thank kind words family service^with going vietnam i wrote analysis authentic depiction veterans gen^valentin fogelman i sorry hear uncle,5,1,-4,6,0.8333333333333334,-0.6666666666666666,1
216616419,Zeibiz,199,18016,21,12336,0,0,5,1,get latest news pop-culture music movies tv shows celebrity gossip,american idol results season winner revealed live finale tonight americanidol idolfinale idolwinner^american idol results tonight maddie poppe wins american idol season americanidol idolfinale idolwinner^american idol results tonight season finale top revealed americanidol idolfinale idoltop3^jessica simpson gives birth baby boy ace knute^kim kardashian kanye west hold hands scott disick restaurant opening zeibiz^taylor swift releases 'look what you made me do music video vmas lwymmdvideo,5,1,-4,6,0.8333333333333334,-0.6666666666666666,1
748954390489403393,VogueArabia,2,16514,124,4130,0,0,5,1,vogue arabia official twitter online,meghan duchess sussex went royals rarely gone sartorially speaking^amal george clooney welcome twins^meghan duchess sussex went royals rarely gone sartorially speaking^the royal vowed return next time catherine duchess cambridge^the royal vowed return next time catherine duchess cambridge^kim kardashian west shares first photo baby chicago,5,1,-4,6,0.8333333333333334,-0.6666666666666666,1
216495966,sergenyt,1405,15518,412,46775,1,1,4,0,new york times investigative journo new yorker raised manhattan globetrotter philosopher music omnivore dog lover i adore bogie humphrey,japanese whaling crew eaten alive by killer whales dead^abc investigation memory lapse trump seeks distance from 'advisor with past ties mafia abc news via abc^trump rescinds rules bathrooms transgender students via^how i learned tolerate blake lively via^morning joe hosts trump bring national enquirer into their feud via^gwyneth paltrow angelina jolie others say weinstein harassed them,5,1,-4,6,0.8333333333333334,-0.6666666666666666,1
25129972,YahooStyleCA,1604,7395,183,22827,0,0,5,1,lifestyle news videos photos editors yahoo canada listen all-royals podcast make it reign available itunes google play,did notice eerie style detail kate middleton hospital dress^happy th birthday we took style evolution years^kim kardashian thanks sisters saying looks 'anorexic people upset^prince harry reportedly shouted meghan markle royal wedding^utterly tasteless people freaking victoria david beckham kids shooting water guns british v^there empty seat princess diana royal wedding people ca n't take,5,1,-4,6,0.8333333333333334,-0.6666666666666666,1
893545663417520128,Price4WNC,1269,5311,57,1140,5,1,0,0,of by for people invest people healthcare public education jobs environment infrastructure strive justice peace price4wnc,i would like eress sincere gratitude voters western nc supported campaign have^unaffiliated voters vote democratic primary may th pick democratic ballot vote phillip^phillip g. price democratic candidate us house representatives north carolina th district i ne^my name phillip price i candidate us house representatives nc11 i the^it official first file us house representatives nc11 phillip g. price may primar^... they create jobs protect environment critical economic driver western north caroli,5,1,-4,6,0.8333333333333334,-0.6666666666666666,1
14970333,monstersandcrit,607,3568,107,196280,0,0,5,1,the home tv entertainment news,robert pattinson baby struggleswww.monstersandcritics.comrobert pattinson found easy play part ...^m c celeb news kate hudson dumped a rod `because still feelings madonna` kate hudson dumped baseball st ...^katie holmes dating holmes spotted mystery man apartmen ...^m c celeb news jennifer aniston john revenge jennifer aniston getting re..^did set new fashion trend pink dress yeezys date night nyc kanye^looking forward americanhorrorstory season here everything know far ahsapocalypse ahsfx,5,1,-4,6,0.8333333333333334,-0.6666666666666666,1
50286017,XL_MoHaMeD,295,3274,27,36997,0,0,5,1,. daydreamer nightthinker,kim kardashian defends sister kylie jenner forbes cover after backlash 'she is self made^jennifer aniston brad pitt baby together^'he heartbroken claims miley cyrus fianc liam hemsworth called wedding '^jennifer lopez confirms relationship new boyfriend drake cutest way new year^everything we know kendall jenner rumored new beau ben simmons^meghan markle kate middleton step out their first ever solo outing together wimbledon,5,1,-4,6,0.8333333333333334,-0.6666666666666666,1
822215673812119553,WhiteHouse,15,19116796,11410,11880,1,4,0,0,welcome follow latest president administration tweets may archived,tune trump first weekly address nation facebook live^president speech united nations general assembly yesterday brought sharp relief th^president trump first lady attended hurricane briefing today fema hq discussed i^watch live gives live briefing hurricane preparedness coordination^watch live president trump delivers remarks national electrical contractors association convention phi,1,4,3,5,0.2,0.6,0
1344951,WIRED,368,10398030,91582,107781,1,4,0,0,wired tomorrow realized,snapchat shutting video hub snap channel^the centers disease control prevention said cases stds risen four straight years t^the centers disease control prevention said cases stds risen four straight years t^the centers disease control prevention said cases stds risen four straight years t^the centers disease control prevention said cases stds risen four straight years t,1,4,3,5,0.2,0.6,0
20751449,the_hindu,198,5533156,5839,276553,1,4,0,0,news feeds india national newspaper,trump failed protect nation reportedly wrote facebook^the sources pointed state union address u.s. president must give congress session^us senator berniesanders laying groundwork launch bigger presidential campaign first^the sources pointed state union address u.s. president must give congress session^the sources pointed state union address u.s. president must give congress session,1,4,3,5,0.2,0.6,0
115141256,KTNKenya,165,1910787,1512,471549,1,4,0,0,bringing breaking news stories across country,former us president george h.w bush died age his state funeral attended trumps obamas an^police mombasa county holding man suspected killing two children within sprawling mishomoroni a^members national assembly blocked director criminal investigations ethics anti corru^members national assembly blocked dci eacc investigating lawmakers linked bribery c^fire tragedy gikomba nairobi people lost lives early morning fire among dead four,1,4,3,5,0.2,0.6,0
16735210,mailandguardian,416,1021765,2732,132936,1,3,0,1,news comment analysis africa best read retweet endorsement follow team m g twitter,nancy pelosi highest ranking woman history us politics elected wednesday lead congress^donald trump wednesday called media stop endless hostility false attacks comments add^in one week last month four schools burnt mpumalanga provincial department education has^from outside looking one surmise four individuals make comedy juggernaut^ivanka trump announced tuesday closing eponymous fashion brand following firestorm critic,1,4,3,5,0.2,0.6,0
23395456,spencerpratt,2792,928610,4737,58894,0,0,1,4,pratt daddy dot com,lindsay lohan mocked busy philipps over drunk mykonos video via^giuliana rancic returning co host e news alongside 'best friend jason kennedy 'ca n't wait via^spencer pratt drops bombshell about ryan gosling throws shade caitlyn jenner other celebs e news^spencer pratt heidi montag talk future play dates with the hills kids^gwyneth paltrow denies amber rose claim that she beyonce becky good hair via,1,4,3,5,0.2,0.6,0
21303464,alykhansatchu,18035,562143,806,337072,1,4,0,0,banker interest rate macro geopolitical africa kind thing,u.s signals new approach horn africa ally on april us house representati^full transcript interview president starts kenya^interview renaissance capital chief economist charlie robertson^interview renaissance capital chief economist charlie robertson^interview renaissance capital chief economist charlie robertson,1,4,3,5,0.2,0.6,0
8197942,SBSNews,1007,327527,3609,139025,1,1,0,3,sbs news bringing global national news matters watch sbs 0pm nightly 0pm mon-fri,breaking former us president george hw bush helped steer america end cold war died a^tells students 'forever first lady empowering speech^comedian jerry lewis dies age^brady bunch house sale 2.6 million^meghan markle dad may attend royal wedding reports say,1,4,3,5,0.2,0.6,0
17546958,weeklystandard,12892,325378,4544,59355,1,4,0,0,a magazine news opinion subscribe,"fact check does 'nasa study ... pay you 100,000 stay bed sixty days^william kristol discusses rudy giuliani bombshell interview sean hannity wednesday night.^obama latest ad targets black voters president obama campaign released latest radio ad first ...^uncommon knowledge george w. bush peter robinson interviews former president george w. bush week ...^missouri ad rick santorum 'proven conservative a pro rick santorum super pac red white blue fund run ...",1,4,3,5,0.2,0.6,0
143415291,BBCBreakfast,183,299242,2178,52309,1,4,0,0,the uk favourite morning news programme every day bbc one,a man highest character best dad son daughter could ask george w bush pays tribute h^letting agent fees every renter worst nightmare but actually justified here hear sides^letting agent fees every renter worst nightmare but actually justified here hear sides^letting agent fees every renter worst nightmare but actually justified here hear sides^letting agent fees every renter worst nightmare but actually justified here hear sides,1,4,3,5,0.2,0.6,0
3387373071,TheTylt,4580,255888,550,57122,0,1,1,3,the place cast vote make opinions count hashitout,"in interview sean hannity rudy giuliani said president trump reimburse michael cohen 130,000^who favorite pioneering '90s country pop icon^the internet thrilled prince harry engaged meghan markle but celebrating monarchy tweet^the internet thrilled prince harry engaged meghan markle but celebrating monarchy tweet^the internet thrilled prince harry engaged meghan markle but britain still monarchy aga",1,4,3,5,0.2,0.6,0
16031897,CBR,837,253944,5184,140513,0,0,1,4,the internet first stop nerd culture news commentary community,sean penn blasts off for mars trailer for hulu the first^guardians galaxy stars chris pratt amp zoe saldana break silence james gunn firing^the cw reveals the arrowverse fall premiere dates^joel kinnaman regrets letting will smith give him 'skwad tattoo^colin trevorrow will return direct jurassic world,1,4,3,5,0.2,0.6,0
89887215,Yamiche,6267,248611,3798,28559,0,4,1,0,white house correspondent contributor formerly email yamiche.org,excited joining panel morning along robinson and^sarah sanders got heart rudy giuliani interviews she said president trump pleased h^i always find amazing hosts usually initiate ending interview president^kevin hassett chairman council economic advisers answering question says eects t^kanye west as black people need take responsibility *pause* black people always responsible,1,4,3,5,0.2,0.6,0
186755547,lawfareblog,170,207162,2947,23339,1,4,0,0,straight-shooting information analysis intersection national security law policy published cooperation brookings institution,like sessions whitaker may obligated recuse mueller investigation the relevant justice dep^like sessions whitaker may obligated recuse mueller investigation the relevant justice dep^document zuckerberg prepared testimony house energy commerce committee latest matthew kahn^icymi mark zuckerberg prepared testimony house energy commerce committee available at^the house energy commerce committee hearing mark zuckerberg scheduled begin minutes you re,1,4,3,5,0.2,0.6,0
39279821,brianklaas,998,200695,3089,22268,1,4,0,0,political scientist washington post columnist author how rig election the despot apprentice host podcast dphil oxford,for us please spend week like would knew donald trump would w^a pretty clear statement president lawyer belief rule law subverted c^the egregiously disqualifying scandal outlined simple statement facts disputed pr^trump lies saying us trade deficit canada the u.s. goods services trade surplus wi^from us trade rep u.s. goods services trade canada totaled estimated 673.9 billion e,1,4,3,5,0.2,0.6,0
2530363285,tv3_ghana,156,196646,94,85867,1,4,0,0,official twitter account get latest news programs events nb retweets endorsement,president donald trump hailed big victory us mid term elections democrats seized house repr^this means admission wrongdoing issues video kwesi nyantakyi said statement sen^the content video heart rending nauseating the ministry fathom crime mother^host nation russia looking bounce back loss uruguay face champions sp^i find statement ndc president investigated ridiculous kwesi nyantakyi already c,1,4,3,5,0.2,0.6,0
121597316,sfchronicle,235,180886,3253,114361,0,4,1,0,we deliver bay area best journalism every day,romaine lettuce safe eat form united states according centers disease control a^sen. bernie sanders stop berkeley saturday billed rally oakland rep. barbara lee independ^romaine lettuce safe eat form united states according centers disease control a^li miao lovett one district four supervisor candidates san francisco november election announced wedn^your friday baybriefing the campfire butte county devastating paradise the mccovey memorial draws f,1,4,3,5,0.2,0.6,0
33920830,FLAREfashion,1959,130324,1644,77838,0,0,1,4,taking things women care seriously,emmastone missed show read full list golden globes winners^meet new cast reasons why season gt^meet new cast reasons why season gt^update accused sexual assault third woman^nick jonas priyanka chopra reportedly engaged two months dating,1,4,3,5,0.2,0.6,0
15850297,fox7austin,669,124882,1776,170423,1,0,0,4,get austin edge /7 fox news air online facebook click like us,family private investigator there evidence seth rich contact wikileaks prior death^harry potter river cruise set sail summer cost serious cash^actor vince vaughn arrested suspicion dui resisting arrest manhattan beach checkpoint^tmz 'rob amp big star christopher 'big black boykin dead^richard simmons hospitalized severe indigestion,1,4,3,5,0.2,0.6,0
17787008,13abc,492,114852,824,101054,1,4,0,0,your source breaking news toledo northwest ohio southeast michigan news tip news.com -534-3858 thisishome,update the two people found dead inside submerged vehicle identified ohio state highwa^watch last debate two main candidates ohio governor online tonight p.m. embedded video th^breaking news vice president joe biden make statement rose garden^the u.s. department agriculture recalls salads made chicken company based houston^one four people community risk enough food if 're shopping weekend and,1,4,3,5,0.2,0.6,0
52052011,govtrack,870,92706,1718,23656,1,4,0,0,research track bills votes congress opengov not government account,george washington issued first veto us april bill apportioning representatives h^h.r to amend internal revenue code patient protection affordable c^h.r to amend internal revenue code patient protection affordable c^coming up h.r department homeland security appropriations act^coming up h.r department homeland security appropriations act,1,4,3,5,0.2,0.6,0
2415053456,CNNTonight,386,89508,858,18396,0,4,1,0,brings two live hours day biggest stories weekdays pm,cnn gloria borger says white house response indictments russian nationals part spec^rudy giuliani says president donald trump legal team responded special counsel robert mueller poss^rudy giuliani said president trump new lawyers held lengthy prep session president pote^breaking republican sen. cindy hyde smith win mississippi us senate runoff election cnn projects co^my road womanhood different jenner discusses final surgery,1,4,3,5,0.2,0.6,0
37104970,WR_Record,519,82754,847,125296,0,0,1,4,bringing news waterloo region surrounding area retweets endorsements opinions,they foiled mariah carey calls sabotage disastrous new year eve^koko gorilla famous using sign language dies sleep^ryan seacrest kelly ripa new co host live^ryan seacrest kelly ripa new co host live^tonya harding admits prior knowledge nancy kerrigan attack abc special,1,4,3,5,0.2,0.6,0
15828025,adndotcom,5941,78374,1505,59377,0,4,1,0,alaska largest news site newspaper newstips.com -257-4301,criminal inquiry sought hillary clinton use email via^blames obama slow economic growth republican weekly address^alaska gov walker state legislature convene juneau testy special session^updated primary results point changes alaska state legislature^inside melania trump complicated white house life separate schedule different priorities,1,4,3,5,0.2,0.6,0
20984506,johnjayandrich,376,68840,424,51359,0,0,1,4,follow show ahern,angelina jolie brad pitt getting married but quite think gbg^here how help victims las vegas mass shooting^beyonc made surprise appearance present colin kaepernick sports illustrated muhammad ali legacy awar^jamie lynn spears pregnant second child the singer actress shared news sweet ig post^jenner apparently shocked amp disappointed reports daughter kylie jenner reportedly pregnant,1,4,3,5,0.2,0.6,0
16829374,movieweb,568,61382,1116,75700,0,0,1,4,breaking movie news since days dial-up est the latest,jim carrey reveals truth behind robin williams feud jimcarrey^the walking dead season promotes lauren cohan series regular amc thewalkingdead^vince vaughn arrested suspicion dui resisting arrest^colin trevorrow returns direct jurassic world jurassicworld3^oscars winners complete list oscars oscar2018,1,4,3,5,0.2,0.6,0
38021361,baseballcrank,1331,58230,1900,202138,1,4,0,0,contributing columnist reaganite lawyer mets fan catholic opinions ex- ex-baseball blogger not cardinals broadcaster,i dream day release pocket code federal regulations^romney ran negative ads vs newt week run vs trump whole campaign^romney campaign mgr knows things deploying negative ad blitzes win gop primaries^hilarity ensues rt fun paul krugman latest column deconstructed actual scientist rsrh^if trump really scary 'd browbeat justices face state union address ruling,1,4,3,5,0.2,0.6,0
22522919,KLFY,410,51152,401,73754,0,3,1,1,acadiana local news leader news tips news.com 337 -4844 send us dm,for first time centers disease control prevention cdc confirming case acute flac^a multi state outbreak salmonella infections linked pre cut melon centers disease control a^for first time centers disease control prevention cdc confirming case acute flac^in years teaching english composition sc public schools yvonne mason seen blunders many times b^pregnant april giraffe calf due march,1,4,3,5,0.2,0.6,0
39319668,seculardotorg,1932,49587,933,22475,0,4,1,0,the national lobby atheists humanists agnostics freethinkers secular americans retweets endorsements,contrary attorney general sessions orwellian double speak task force protect free exercise^the religious right pushes theocratic agenda framing religious freedom watch elai^the us department agriculture censoring staff amp scientists using term climatechange^leaked emails reveal us department agriculture censoring scientists using term climatechange^the morning read trump rescinds rules bathrooms transgender students,1,4,3,5,0.2,0.6,0
16458383,NorthBayNews,281,46558,726,73637,0,1,1,3,sonoma county news powered staff the press democrat santa rosa ca winner pulitzer prize breaking news reporting,utilities regulators meet santa rosa friday^royal baby way meghan markle prince harry^koko gorilla knew sign language dies^'brady bunch house sale nearly 1.9 million^'brady bunch house sale nearly 1.9 million,1,4,3,5,0.2,0.6,0
816652616625168388,RepAndyBiggsAZ,1432,40296,631,6314,1,4,0,0,representing arizona fighting fifth,we never able bring little ones back us honor precious memories fighting e^now i 'm discuss fallout last week igreport our^now catch interview colleagues we 'll ta^the fbi ran investigation predetermined outcome looks like then transferred many those^at top next hour i 'll joining talk yesterday in,1,4,3,5,0.2,0.6,0
46520074,WestJournalism,216,38218,739,56907,0,4,1,0,news america heartland,in interview fox news nunes claimed email constitutes 'the first clear evidence fbi commi^'nebraska gop sen. ben sasse slammed climate alarmists sunday interview fox news suggesting t^a government watchdog filing complaints federal election commission the complaints also name kamal^'nebraska gop sen. ben sasse slammed climate alarmists sunday interview fox news suggesting t^after months of separation angelina jolie breaks her silence on brad pitt divorce,1,4,3,5,0.2,0.6,0
8935172,ydrcom,2775,37990,544,170128,0,4,1,0,york daily record york sunday news york pa. york county no news source special offer,shooting near chicago hospital leaves multiple victims^york county police chiefs eect uniform crime reports soon reflect cyber crimes^york county police chiefs eect uniform crime reports soon reflect cyber crimes^take look york county uniform crime reports^reports brad pitt accused child abuse investigation,1,4,3,5,0.2,0.6,0
309325348,NewshubNZ,2080,37090,501,134828,0,0,1,4,nan,let conscious free returns twitter tell mind control^james franco denies sexual misconduct allegations supports women making^meghan markle dad longer attend royal wedding^legendary us comedian don rickles dies aged^'do i need british accent barack obama jokes prince harry bbc interview,1,4,3,5,0.2,0.6,0
18587841,ThisIsRnB,722,34838,389,38800,0,0,1,4,your source r b music soul train award winner updated daily for inquiries submissions e-mail submit.com supportrnb,r amp b legends amp stars celebrate international women day^news announces the man of the woods tour talks album sound^justin timberlake announces the man of the woods tour talks album sound^watch officially announces new album man woods scenic trailer^justin timberlake announces new album man woods,1,4,3,5,0.2,0.6,0
132029493,greg_doucette,1015,30054,621,164119,0,4,1,0,ex-computer scientist criminal defense attorney host dog lover nevertrump conservative proud alum nccu lawschool ncstate,the us department education financial aid model takes account i n't know current ar^the st circuit quoted opinion glik length noted even though traffic stops different^see also use fbi uniform crime reports proof crime opposed arrests^omg i would die i caught record i transcript saying blah blah blah mortified^the entire apparatus executive branch would fall line behind successor sworn whether tr,1,4,3,5,0.2,0.6,0
239857777,Indira_L,4945,28348,897,48379,1,2,0,2,executive editor reported nations+dc bloomberg intl columnist radio guest-host,does apply code federal regulations defines terrorism unlawful use force+violenc^ex chair republican national committee michael cohen saying trump knew russian offer dirt hrc^incredible catch looks like first lady guide best internet practices kids ...^peddled racist ageist sexist stereotypes writing priyanka chopra amp nick jonas meghan markle^peddled racist ageist sexist stereotypes writing priyanka chopra amp nick jonas meghan markle,1,4,3,5,0.2,0.6,0
15447075,Snoodit,611,24014,713,64674,0,0,1,4,west coast tv editor co-host tvstop5 podcast listen my views mine,exclusive thecrown casts its prince charles queen mother season^'fear walking dead promotes colman domingo series regular season^handy premiere dates grid updated abc cbs nbc the cw fall premiere dates^'once upon time renewed season abc ouat^no day but today rent set fox next live musical,1,4,3,5,0.2,0.6,0
15659909,cate_long,1892,22510,1013,212120,1,4,0,0,i lead research service puerto rico bondholders former contributor reuters,us house representatives committee officially convened hearing july examine manage^us energy information administration adds puerto rico data u.s. power plant inventory^in first week october republican national committee saw increase donations raising^puerto rico resident commissioner jenniffer gonz lez col n present puerto rico admission act^note member puerto rico oboard makes correction public statement president of,1,4,3,5,0.2,0.6,0
160547588,PhilipinDC,1874,20229,658,18807,0,4,1,0,international affiliate reporter gms reporting six languages around world white house correspondent,trump campaign touting joint campaign appearance fox news host meanwhile tou^it funny see fake news fake news says trump live morning it^did i say interview trump it chat homage tribute trump^greetings house representatives members congress filing chamber macron upcoming^they spend little time together said one longtime friend president inside melania trump co,1,4,3,5,0.2,0.6,0
208585249,wabenews,1065,17269,514,34699,0,3,1,1,tweets award-winning news team wabe fm atlanta npr station also follow,the centers disease control prevention traced ongoing e. coli outbreak romaine lettuce grown t^the centers disease control prevention traced ongoing e. coli outbreak romaine lettuce grown t^press secretary sarah sanders last walked lectern white house press briefing room oct. after^tyler mitchell year old atlanta making history first african american photographer shoot t^bourdain death comes days fashion designer kate spade found dead apparent suicide age,1,4,3,5,0.2,0.6,0
14864435,hburgamerican,158,17189,291,104592,1,0,0,4,hattiesburg pine belt news information sports features,nancy pelosi fights regain house speaker role la auto show keystone xl things know wednesday^tonya harding admits prior knowledge nancy kerrigan attack abc special^summer phoenix files divorce husband casey affleck^here popular halloween candy every state^april giraffe pregnant due next year,1,4,3,5,0.2,0.6,0
19447451,webn,2562,16940,212,37322,0,0,1,4,webn cincinnati rock station home the show listen anywhere iheartradio,fans react u2 cancels st. louis concert amid police protests^here how help victims las vegas mass shooting^neil diamond retires from touring after parkinson disease diagnosis^'superman star margot kidder dead at read the story^hugh hefner cause death has been revealed,1,4,3,5,0.2,0.6,0
23318036,chrisjollyhale,14936,16159,169,22703,0,4,1,0,tennessean time opinion contributor fox news democratic contributor former congressional candidate nonprofit executive obama white house campaign alum,i worked obama white house the transcript speech gave last night one b^in january i invited white house along faith leaders meet president trump advance h^david transcript interview get sense p^i worked obama white house the transcript speech gave last night one b^rick think win time person year,1,4,3,5,0.2,0.6,0
905416143313219584,NBCNewsTHINK,978,15768,279,5523,0,4,1,0,think nbc news home fresh opinion sharp analysis powerful essays,did see amp say^did see mika amp joe chris chris rachel lawrence say msnbc in case missed 've pi^did see mika amp joe chris chris rachel lawrence say msnbc week icymi 've picked^did see mika amp joe chris chris rachel lawrence say msnbc in case missed 've pi^bradley cooper said lady gaga makeup n't 'authentic writes women deserve taken seriousl,1,4,3,5,0.2,0.6,0
24983393,yvonnewingett,8568,15523,597,58318,0,4,1,0,working mom national political reporter network the gaggle pod host homeroom mom wifey gary rosie daughter,former vice president biden blasts trump immigration policies speech phoenix convention center^sign interview ... .my dear friends i 'm coming back^yellow sheet reported yesterday bennett hired tucson conservative activist christine baseman campa^says wo n't leverage vote scotus nominee trump performance putin later^inside melania trump complicated white house life separate schedule different priorities,1,4,3,5,0.2,0.6,0
107563743,profkeithdevlin,474,15176,736,85888,0,4,1,0,mathematician author radio broadcaster avid cyclist,should let kids watch presidential debate pushed democratic process^she reminds little known black oh gosh black man democrat gave keynote speech^oh ffs active conducting business mobile phone known compromised sen grah^compare press briefing professional state department amateur hour shambles^the secret donald trump rudy giuliani know russia probe,1,4,3,5,0.2,0.6,0
114615070,StarPittsburgh,1283,15052,147,49814,0,0,1,4,official twitter star listen star anytime anywhere download app,luis fonsi gained worldwide notice thanks smash hit despacito justin bieber daddy yankee c^dance moms star abby lee miller sentenced year prison bankruptcy fraud^kelly clarkson 'when i was really skinny i wanted kill myself^taylor swift announces new album 'reputation^taylor swift releases new song 'call it what you want,1,4,3,5,0.2,0.6,0
63756959,Mix1041,3565,14300,288,52413,0,0,1,4,mix boston best variety home,watch new aquaman trailer starring jason momoa nicole kidman^poll who should win all stars finale^announces las vegas residency who going littlemonsters gagavegas^announces las vegas residency who going littlemonsters gagavegas^breaking announces new album reputation dropping november,1,4,3,5,0.2,0.6,0
2979574468,HandelsblattGE,443,14139,698,26677,1,4,0,0,the english-language edition germany leading business financial daily,deutsche bank relations donald trump likely come scrutiny us house representatives^we reached lot people bernie sanders authentic elains strategist communicatio^one things learn trump authentic says hbpathfinder berlin germany.^berlin still hopes reach amicable solution trade dispute america despite eu launch punit^berlin still hopes reach amicable solution trade dispute america despite eu launch punit,1,4,3,5,0.2,0.6,0
3047075100,ForbesEnt,265,13115,226,27375,0,1,1,3,your home news business music media entertainment team,the youtube lgbt community tough time pride month demonetization anti lgbt ads runni^'modern family leads julie bowen sofia vergara two world highest paid tv actresses^the 'brady bunch house sale nearly 1.9 million^the weeknd leads billboard music awards nominations the full list^'black panther tweeted movie time million tweets,1,4,3,5,0.2,0.6,0
15129437,alt1033,3084,11226,229,33059,0,0,1,4,indy alternative fm alt1033 indyrocks listen live via,fans react u2 cancels st. louis concert amid police protests^hugh hefner cause death has been revealed^the narwhal frappuccino is here it tastes like pink starburst^lcd soundsystem gavin russom comes out as transgender^billboard music awards nominations see full list of bbmas nominees,1,4,3,5,0.2,0.6,0
19861687,Navjosh,452,11196,304,132097,0,0,1,4,founder journalist music consultant fee golf teaching professional referee,multiple shots fired at kanye west nicki minaj amp ix9ine video shoot in la^second suspect arrested xxxtentacion murder^second suspect arrested xxxtentacion murder^justin timberlake announces 'man the woods tour^justin timberlake announces release date new album 'man the woods,1,4,3,5,0.2,0.6,0
350597282,bri_sacks,2885,10384,254,10620,0,3,1,1,`` decent reporter killer eyebrows '' guy twitter covering holler brianna.sacks.com,how npr fact checked first presidential debate real time top live transcript^the us department education civil rights office investigating usc handled sexual harassment comp^veterans foreign wars said disappointed members following president trump lead boo and^gwyneth paltrow angelina jolie others say weinstein harassed them^ashley judd sues harvey weinstein sexual harassment defamation,1,4,3,5,0.2,0.6,0
549411147,IdahoOnYourSide,1583,9643,250,35524,0,2,1,2,covering news treasure valley around world,according data centers disease control prevention million americans live ch^the life character john mccain words memorable quotes late senator^mariah carey they foiled^photos 'the brady bunch house sale 1.885 million^celebrity summer fashion trends you can make,1,4,3,5,0.2,0.6,0
1944881082,WillPresti,490,5626,114,19461,0,0,1,4,writer comedian host nbc viacom conan letterman cosmo intouch other stuff here s what i do,brad pitt angelina jolie officially market crushing dreams absolutely rational person^the brady bunch house sale almost 2 million every time unknowing buyers ask eensive the^the brady bunch house sale 1.9 million that lot money house toilet^the brady bunch house sale 1.9 million that lot money house astroturf lawn^stacey dash running congress california it n't bode well resume literally reads clueless actress,1,4,3,5,0.2,0.6,0
525419131,cindysaine,5421,5585,160,36858,1,4,0,0,voa newscenter diplomatic correspondent retweets equal endorsements,democratic plays audio separatedchildren crying floor us house of^says deliver first major foreign policy speech next monday focus iran^great friend remembering interview passion restoring^alcindor white house correspondent pbs comments angry climate political rallies^great friend remembering interview passion restoring,1,4,3,5,0.2,0.6,0
1596548827,gfunderburgNC9,4652,5314,107,39871,0,1,1,3,morning/noon anchor motivational speaker sylacauga al native grad news lover rt endorsements,join roundtable discussion st address joint session congress watch live pm^mariah carey new year eve performance 'they foiled^'clueless actress stacey dash running congress california staceydash^celebrating birthday today along first daughter malia obama^april giraffe pregnant greenville southcarolina aprilthegiraffe,1,4,3,5,0.2,0.6,0
38460940,TheMarionStar,96,5154,115,28841,0,0,1,4,this twitter account the marion star marion ohio we news source marion county,trump assertion left wing protesters violent white supremacists charlottesville sets firestorm^the best memorial day sales home appliances^summer phoenix files divorce husband casey affleck^summer phoenix files divorce husband casey affleck^oscars the complete winners list,1,4,3,5,0.2,0.6,0
43960429,TheBackPage,1228,4413,114,35961,0,4,1,0,host- `` the intersection '' podcast -- seen cable news networks -- watch weekdays live twitch -- doggy dad,this interview tonight tonight great stuff find online watching worth watching^like man disagree beto o rourke democratic presidential candidate he ready for^like man disagree beto o rourke democratic presidential candidate he ready for^can forget pay play personal attorney along communications staffer saying most^list every super bowl halftime show pretty neat go back look nfl,1,4,3,5,0.2,0.6,0
34543098,fremontNM,121,4136,98,33690,0,0,1,4,this twitter account the news-messenger fremont ohio we news source sandusky county,trump assertion left wing protesters violent white supremacists charlottesville sets firestorm^the best memorial day sales home appliances^summer phoenix files divorce husband casey affleck^summer phoenix files divorce husband casey affleck^oscars the complete winners list,1,4,3,5,0.2,0.6,0
15689607,springfieldnews,52,3801,150,79572,0,2,1,2,news updates springfield news-sun,chicago hospital shooting nurse critically wounded police officer among multiple victims shot^chicago mercy hospital shooting the victims identified officer samuel jimenez dr. tamara e. o neal a^katie couric breaks silence news matt lauer dismissal 'today^more former fox news ceo roger ailes dead^actor ving rhames says police held gunpoint home neighbor reported burglary,1,4,3,5,0.2,0.6,0
2579815830,NicRodriguez,534,3790,114,23137,1,1,0,3,senior reporter news mj fan writes without fear favor bylines,first lady melania trump undergoes kidney surgery walter reed medical center^suicide rates u.s. risen nearly since according report centers disease cont^fourth suspect xxxtentacion murder arrested jailed^authorities release timeline details deadly ambush rapper xxxtentacion south florida one suspect ha^tina turner son craig turner dead suicide,1,4,3,5,0.2,0.6,0
133315811,patrickdehahn,1580,3554,279,132753,1,4,0,0,reporting world politics conflict humanitarian issues curating news quartz dms open rts=look he/his remember share moon,bbc news former u.s. president george h.w bush died age son george w. bush announced^forget kiev real fight crimea published days ago finding true^cnn mike pompeo deliver first major foreign policy speech secretary state monday u^cnn rudy giuliani says president donald trump legal team responded special counsel robert mueller a^washington post china buy significantly us goods services without outlining amount bid t,1,4,3,5,0.2,0.6,0
3056802046,AppomattoxNPS,582,3239,107,3866,1,4,0,0,a unit national park service restored village gen. lee surrendered army northern virginia gen. grant beginning end civil war,otd enslaved boatman robert smalls commandeered confederate steamer planter charleston harbor deli^otd president james buchanan sends state union message congress the election one o^otd pres lincoln th state union message reads part voluntarily accept u^otd president james buchanan sends state union message congress the election one o^otd pres lincoln th state union message reads part voluntarily accept u,1,4,3,5,0.2,0.6,0
159216777,BrettMalec,555,2648,77,13303,0,0,1,4,manager e shows e news/e online all liberal opinions,thoughts kanye west name baby no chicago west^snaps kim says north west would make better president than donald trump truth^she kylie jenner gives birth first child with travis scott^the best keeping up with kardashians vacations ranked^people choice awards air november e via,1,4,3,5,0.2,0.6,0
23900462,billkuchman,1138,2312,108,70003,0,3,1,1,now prev culturology newspaper designer cartoonist eect starwars lego snl beer tweets rochester ny native,guessing trump would respond throwing another rally calling state union^i almost hundred percent sure pic norman reedus promotional shot the walkin^guessing trump would respond throwing another rally calling state union^remember crazy risk movie seemed back i mean chris evans wwii era someday i like^john krasinski found emily blunt birthday captain america my agent called said,1,4,3,5,0.2,0.6,0
61655431,eelarson,809,2198,125,12335,0,4,1,0,bloomberg news legal reporter new york since from portland uofo retweets endorsements views,president trump said multiple times today i know matt whitaker. but phone inter^uhhh it two million short obama first state union address^president obama first post election media interview bloomberg television fiscal cliff^china n't take money u.s. trade surplus it giving us goods exchange that piggy bank^trump administration rescinds rules bathrooms transgender students via,1,4,3,5,0.2,0.6,0
4970411,AJEnglish,233,5504202,52511,236487,2,3,0,0,hear human story join discussion for news follow,linda sarsour arrested office speaker us house representatives paul ryan advocating imm^somali american congresswoman llhan omar looking challenge year old rule bars religious headwear i^abraham serfaty established new concept one hundred percent jewish hundred percent anti zionis^the thing left palestinians fight one state espousing democracy secularism^'biggest trade war history us tariffs 34bn worth chinese imports take effect china imposes counterme,2,3,1,5,0.4,0.2,0
6433472,CBCNews,1097,2757122,14690,222999,1,1,1,2,canadian breaking news analysis cbcnews.ca tv radio,update akayed ullah suspected nyc subway bomber posted note u.s. president facebook trump fa^full transcript peter mansbridge interview u.s. president barack obama obamawa^trump warns north korea 'fire fury^justin bieber cancels remaining dates purpose world tour^prince william prince harry best man upcoming royal wedding,2,3,1,5,0.4,0.2,0
17086831,Todaysparent,3639,2620164,3353,83975,0,0,2,3,the days long years short. canada parenting brand editor-in-chief social media,baby west revealed kanyewest struggling find perfect name third^icymi baby west revealed kanyewest struggling find perfect name h^no time go facial no prob here multimask home like pro gt^no time go facial no prob here multimask home like pro gt^got bit time tonight here multimask home like pro gt,2,3,1,5,0.4,0.2,0
70394965,citizentvkenya,222,2208493,1568,483926,0,3,2,0,kenya premier tv station breaking news entertainment your favorite local tv shows follow us,boni khalwale the dp ask troops back he ask president throw good statement^mutula kilonzo junior when scandal see cabinet secretary questioning statement made^former us president barack obama arrived kenya his convoy headed state house nairobi wi^carole middleton mother catherine duchess cambridge arrives st george chapel windsor castle th^carole middleton mother catherine duchess cambridge arrives st george chapel windsor castle th,2,3,1,5,0.4,0.2,0
15933910,Fashionista_com,852,2192296,12906,115453,0,0,2,3,culture celebrity commerce careers digital fashion beauty lens send tips tips fashionista com,considering massive audience reach brands clearly believe partnering kim kardashian worth risk^though 're pretty bummed meghan markle queen elizabeth n't plan coordinating outfits 're excited see^in terms drying hair post shower 're probably wrong^pippa middleton wears london based contemporary label meghan markle prince harry wedding^slams body shamers calling skinny nyfw,2,3,1,5,0.4,0.2,0
22127823,SAMAATV,100,1651566,1439,221632,0,2,2,1,breaking news pakistan across globe politics sports entertainment economy for english stories head,the tool follows twitter recently launched political campaign ads policy similar move facebook inc whic^a total people fallen ill states said us centers disease control prevention^georgeclooney amal clooney welcome birth twins publicist details^singer jessica simpson gives birth boy samaa tv via^australian open serena williams withdraws tournament,2,3,1,5,0.4,0.2,0
15319698,HipHopDX,2508,617243,4542,188902,0,0,2,3,internet source hip hop news interviews music reviews,kanye west amp nick cannon squash e beef kim kardashian^kanye west amp nick cannon squash e beef kim kardashian^performance to open billboard music awards^performance to open billboard music awards^performance to open billboard music awards,2,3,1,5,0.4,0.2,0
22993014,9NewsAUS,204,526979,2259,276396,0,2,2,1,australia no.1 follow,update a police officer dead gunman went terrifying shooting rampage chicago hospital which^the trial man accused killing wife milperra home opened today year old warren rog^in service lasting hours performers including faith hill ariana grande jennifer hudson stevie wonder pa^in service lasting hours performers including faith hill ariana grande jennifer hudson stevie wonder pa^it official after months speculation prince harry engaged american actress meghan markle.,2,3,1,5,0.4,0.2,0
149516743,geonews_english,10,482085,1236,147854,0,0,2,3,geo pakistan no tv channel providing latest local international sports business entertainment news round clock official page,chadwick boseman 'black panther needed african accent^amal george clooney welcome boy girl twins^ed sheeran engaged girlfriend cherry seaborn^game thrones kit harington rose leslie married^talk show host seth meyers host golden globes,2,3,1,5,0.4,0.2,0
33276161,JohnFugelsang,18965,435523,7046,65709,1,3,1,0,i comedian actor broadcaster recovering cynic sirius/xm m-f instagram,the felon 've colluding manafort forfeited 46million plea deal investigation co^nike invites colin kaepernick justdoit campaign amp the new yorker invites steve bannon festival welco^do n't stop coddling the super rich cos taxing millionaires hurts economy also try forget '50s '90s happened^a comprehensive investigation voter impersonation finds credible incidents one billion ballots cast^thrilled maragert cho joining us athenaeum theatre chicago sat oct,2,3,1,5,0.4,0.2,0
14765253,nzherald,3645,297076,2781,128032,0,1,2,2,news views via editorial team follow accounts,afghanistan pakistan praise obama strategy kabul 45 afghan pakistan praised new strategy president ..^parky 'daft old fart billy connolly hits back illness claims^billy connolly hits back michael parkinson claims health 'i 'd recognise diving suit^hugh hefner cause death revealed^does photo prove amelia earhart survived final flight,2,3,1,5,0.4,0.2,0
16543775,detroitnews,2541,285165,3165,238949,0,3,2,0,detroit best source news information you reach the detroit news online detroitnews dot com,supports bill would mandate senate candidates begin electronically filing campaign financ^watch former president speaks labor day picnic^the u.s. department agriculture says farmers eected harvest largest soybean crop record must^dakota johnson jamie dornan finally shades free leave series behind go d^in photos royal wedding prince harry meghan markle,2,3,1,5,0.4,0.2,0
10025982,azfamily,269,253114,1804,149534,1,2,1,1,the power two delivering breaking news weather sports traffic phoenix arizona story idea tip call newsroom -207-3443,melania trump undergoes kidney surgery walter reed medical center^cbs news posts entire transcript stormy daniels '60 minutes interview^sen. john mccain sat morning watch interview^kimkardashianwest welcomes third child^mattdamon apologizes comments sexual misconduct,2,3,1,5,0.4,0.2,0
16467567,reason,340,239354,6849,71548,0,3,2,0,reason monthly magazine website free minds free markets. visit,the u.s. fertility rate fallen year low 6 children per women according centers di^secretary state mike pompeo first major foreign policy speech everything iran hawks dreamt^in one surveillance video victim tased four times total seconds^a.m links trump rescinds obama rule bathrooms transgender students iraqi forces recapture mosul ...^anna wintour classy banned twerking asma al assad pinup material,2,3,1,5,0.4,0.2,0
1854580777,JOE_co_uk,990,232101,1296,106587,1,0,1,3,uk uk,snapchat officially addresses rumours app shutting^david beckham mls team official name^game thrones star almost got fired ridiculous reason^game thrones star almost got fired ridiculous reason^game thrones star almost got fired ridiculous reason,2,3,1,5,0.4,0.2,0
63177215,mtlgazette,352,224683,2711,205092,0,1,2,2,follow features news to-the-minute updates developing stories join conversation,former u.s. first lady michelle obama deliver speech montreal^amal george clooney welcome twins ella alexander^disaster cleanup company called c line dion st rose island home^don rickles legendary comedian actor dies^relive meghan markle prince harry big day the best royal wedding photos,2,3,1,5,0.4,0.2,0
393469195,redsteeze,1609,201962,2712,180892,1,3,1,0,harm ongoing matter published the wilderness commentary archive,dems hold minority governorships state legislatures us house representatives us senate white^mitt romney statement doj indictments russian hackers^in clear afternoon rose garden statement president obama said taiwan longer sitting back china bus^as ttys noted facebook literally people media like darcy amp stelter demanded and^ca n't wait president sean penn,2,3,1,5,0.4,0.2,0
44426926,FOX8NOLA,2747,194093,1077,156810,0,0,2,3,wvue fox choice news entertainment social fun we hope love variety we,kim kardashian n't running office considering maybe outlandish thing^channing tatum wife jenna dewan tatum announce split^meghan markle dad wo n't attend royal wedding^colin trevorrow back direct jurassic world^april giraffe pregnant,2,3,1,5,0.4,0.2,0
14148802,sdut,132,180534,3112,106128,1,0,1,3,the san diego union-tribune region leading news source since follow journalists,rt read transcript gop sen. jeff flake stunning speech 'i complicit silent http^why meghan markle makes royal wedding fairy tale women love^after years kermit frog getting new voice^justin timberlake announces 'the man woods tour dates^justin timberlake announces 'the man woods tour dates,2,3,1,5,0.4,0.2,0
139115314,DStvNg,1844,158163,278,229217,0,1,2,2,the official twitter account dstv nigeria customer service self service call us,today pm bloomberg television president obama sits first tv interview since election follow twitter btv^a security guard liam hemsworth childhood pal michael angarano make plans rob armored car watch^a security guard liam hemsworth childhood pal michael angarano make plans rob armored car watch^joe jonas sophie turner sansa gameofthrones are engaged see her ring via^justin timberlake announces new album 'man woods dstvnews,2,3,1,5,0.4,0.2,0
26286109,RacingTV,2177,156609,704,92057,0,3,2,0,the home british irish racing showing live horse racing racecourses across britain ireland,i said n't forget horse got john gosden reflects success stradivarius the^who looking forward presenting percy making seasonal debut he one entries john durkan^i think got distracted girls john gosden tells us thinks reason cracksman defe^she good form since duchess cambridge form looks rock solid pretty pollyanna^she good form since duchess cambridge form looks rock solid looking for,2,3,1,5,0.4,0.2,0
17141539,kgbt,1892,133049,618,79551,2,2,0,1,cbs provides news information rio grande valley follow reporters/anchors,regulators fine texas agriculture commissioner sid miller sloppy accounting via^newly elected texas agriculture commissioner sid miller says granting amnesty cupcakes rgv^centers disease control prevention officials investigating multi state outbreak salmonella linked^watch live president trump speaks campaign rally las vegas^breaking former fox news ceo roger ailes dead,2,3,1,5,0.4,0.2,0
44953313,OddsShark,722,99676,1045,61583,0,2,2,1,the reliable source online sports betting information,after last night presidential debate odds moved clinton favor democratic party republican^croatia one last five matches across competitions spain three four ma^updated odds next actor portray james bond richard madden even tom hiddleston +250 to^celebrity death matchup odds regis philbin bob barker charlie sheen magic john^royal wedding props who prince harry best man odds via bovadalv prince william thomas inski,2,3,1,5,0.4,0.2,0
5558312,JohnBoozman,792,85739,2430,5461,2,3,0,0,united states senator arkansas serving agriculture appropriations epw veterans affairs committees contact -224-4843 servingar arindc,it honor escort french pres onto floor us house representatives ad^i joined colleagues senate amp house representatives urging fda use tools d^appreciated opportunity discuss importance halifax international security forum sen.^appreciated opportunity discuss importance halifax international security forum sen.^appreciated opportunity discuss importance halifax international security forum sen.,2,3,1,5,0.4,0.2,0
93059585,cbs46,2057,85374,1702,216107,0,0,2,3,hey atl we cbs home watch us n :30-7a -6:30p p always instagram facebook cbs46,prince harry meghan markle wed may^channing tatum wife jenna dewan tatum announce split^aly raisman sues us olympic committee usa gymnastics^colin trevorrow back direct jurassic world^reports say kylie jenner pregnant first child,2,3,1,5,0.4,0.2,0
351065668,LatinoVoices,1372,76269,1387,61443,0,1,2,2,all latino time need help huffpost login membership tweet,obama campaign woos hispanic voters tv radio ads^selena gomez reveals kidney transplant^selena gomez reveals kidney transplant best friend donor^i wo n't take clothes anymore empty cause^jennifer lopez returning will amp grace roles,2,3,1,5,0.4,0.2,0
19212855,WPGC,10607,75033,445,75056,0,0,2,3,wpgc station home morning show,another royalbaby way prince harry meghan markle eecting child spring^after giving university miami student 50k tuition hooking local high school money new u^ryan seacrest officially kelly ripa new co host live^john legend playing role jesus nbc next live musical jesus christ superstar^breaking pregnant reports,2,3,1,5,0.4,0.2,0
232461939,Ugaman01,11457,65530,729,78576,0,3,2,0,digital marketing| e-commerce helping you turn twitter money machine twitterphilanthropy,patience katushabe keeza picked workplace on september kampala boulevard unknown people claim^thread national physical activity day launch kololo independence grounds first things first press^this powerful statement gary the truth kindness empathy grossly ignored many people^breaking news kanye west quit social media amid controversy support president trump west sh^breaking news kanye west quit social media amid controversy support president trump west sh,2,3,1,5,0.4,0.2,0
224372609,BI_contributors,388,64701,1445,128002,0,1,2,2,roundup eerts partners news outlets across media landscape,rudy giuliani on running for president anthony weiner and hanging out in new hampshire^people freaking laura dern may snubbed reese witherspoon emmy win^'he diabolical leah remini says scientology poster boy tom cruise good person^ellen page accuses brett ratner 'blatantly homophobic abusive behavior^nbc next live musical 'jesus christ superstar,2,3,1,5,0.4,0.2,0
15723281,TIMEWorld,120,59914,1765,22487,0,0,2,3,breaking international news analysis time correspondents around world,a hong kong woman was tricked into marrying stranger china during job offer scam^no one more excited about meghan markle prince harry than this animal^the reason why meghan markle won have maid honor her royal wedding^prince charles will walk meghan markle down aisle royal wedding^we now know delightful details about meghan markle prince harry wedding cake,2,3,1,5,0.4,0.2,0
13215102,idolator,501,54243,1703,80601,0,0,2,3,covering pop music nonsense surrounding,reunites max martin raunchy new single bon appetit^shows naughty nice sides two different performances^styles announces world tour including north american dates^teams new single what lovers do^a new era promises excitement horizon announces forthcoming residency las vegas,2,3,1,5,0.4,0.2,0
17395207,wdam,729,50617,444,99947,0,2,2,1,we local television station laurel/hattiesburg viewing area,mayor dupree appointed democratic national convention rules committee^republican senator democratic hattiesburg mayor weigh last night presidential debate^kim kardashian n't running office considering maybe outlandish thing^kim kardashian n't running office considering maybe outlandish thing^koko gorilla knew sign language dies gt gt,2,3,1,5,0.4,0.2,0
16161679,natnewswatch,611,49848,1142,163725,2,2,0,1,national newswatch canada comprehensive place political news views join chat using natnw visit website,melania trump undergoes kidney surgery walter reed medical center^people found dead ohio^officer among multiple victims injured shooting near chicago hospital police say abc news via^former u.s. first lady michelle obama deliver speech montreal national newswatch^reports former fox news ceo roger ailes dead,2,3,1,5,0.4,0.2,0
287801216,UgoUganda,14820,48069,136,64999,1,0,1,3,uganda biggest web portal socialmedia management digital communications agency|online advertising|free directory| blogs tel +256 -846846,former us president george h.w bush died age .the st us president amp st sitting vice president be^the complete list of winners the emmy awards emmys^prince charles walk meghan markle aisle.this comes ms markle father pulled attending the^check full nomination list billboard music awards.this year awards hosted american ido^the bet hip hop awards winners the complete list,2,3,1,5,0.4,0.2,0
19415444,PasStarNews,551,43150,664,102947,0,0,2,3,local news matters we cover news pasadena calif. surrounding communities localnewsmatters,jessica simpson gives birth boy singer fashion designer jessica simpson gave birth second chi ...^what pentagon papers spielberg the post^neil diamond retires touring diagnosis parkinson disease^brady bunch house closes sale 3.5 million almost twice asking price^eminem beyonce weeknd headline coachella valley music arts festival,2,3,1,5,0.4,0.2,0
29471630,Power965,18130,40744,392,59850,0,0,2,3,we miami party station a-10a- w/ a-2p- p-7p- p-12a- -9696,can believe return americanidol want tap kanyewest host it rumor wo^can believe return americanidol want tap kanyewest host it rumor ...^april the giraffe finally gives birth flygirldiva power miami party station^did cardi b sister accidentally reveal sex her baby with offset^julia louis dreyfus diagnosed with breast cancer,2,3,1,5,0.4,0.2,0
19312573,SGVTribune,503,37990,486,119426,0,0,2,3,local news matters we cover breaking news local news san gabriel valley localnewsmatters,jessica simpson gives birth boy singer fashion designer jessica simpson gave birth second chi ...^what pentagon papers spielberg the post^neil diamond retires touring diagnosis parkinson disease^brady bunch house closes sale 3.5 million almost twice asking price^eminem beyonce weeknd headline coachella valley music arts festival,2,3,1,5,0.4,0.2,0
16817799,laurenonizzle,12464,36093,1042,103076,1,1,1,2,journalist tv head og internet person i like cats clothes cameras alliteration news editor my tweets mom,the cnn porn scare fake news spreads^everyone looking barack obama twitter feed right like thankyouobama^kim kardashian allowed care prison reform^jason priestley says punched harvey weinstein face golden globes party^'13 reasons why officially renewed season netflix via,2,3,1,5,0.4,0.2,0
25250613,andreasharsono,2782,34319,465,64832,2,3,0,0,human rights watch religious freedom media journalism ethnic religious diversities human rights,coba hubungi erni ilham erniilham735^nyt inside fake news sausage factory this is all about income^in interview broadcast fox news american vp mike pence warned north korea government could end lik^democratic debate trump presidential ego^in rare set interviews three former presidents spoke life legacy president george h.w bush.,2,3,1,5,0.4,0.2,0
218523764,CBSDetroit,5807,32470,755,73603,0,1,2,2,cbs brings local news weather traffic sports best detroit,report bernie sanders presidential campaign instrumental mainstreaming democratic socialism millennia^nbc news names hoda kotb to replace matt lauer it first female team headlin^britain prince harry praised father prince wales walking meghan markle aisle the^meghan markle future father law prince charles walk aisle royal wedding^meghan markle future father law prince charles walk aisle royal wedding,2,3,1,5,0.4,0.2,0
17908139,hot937,811,29727,208,45817,0,0,2,3,connecticut hip hop r b hot entercom station listen live app,baby mama asks child support plus tries get someone else jail a^why macmiller snubbed emmys memorial plus uncle alec says niece g^a third suspect arrested murder xxxtentacion plus words and is^last suspect arrested in xxxtentacion murder catfish max joseph exits after seasons amp more dirt report^visited seattle children hospital sing christmas carols kids omg hearts,2,3,1,5,0.4,0.2,0
2252588455,alexsandra8888,6657,28184,676,192700,0,1,2,2,aleandra wright life coach media personality journalist correspondent brand lifestyle eert mom influencer,retweeted chris adamski adamskitrib a transcript deangelo williams record comments media ...^kevin hart apologizes wife kids 'failed extortion attempt over sexually suggestive video update via^retweeted entertainmenttonight wow selena gomez reveals kidney transplant actress ...^hall fame quarterback troy aikman is engaged capa mooty people^tom petty rushed hospital after suffering full cardiac arrest report people,2,3,1,5,0.4,0.2,0
28166618,wmms,11713,25288,343,27925,0,0,2,3,cleveland rock station home rover morning glory the alan cox show fm home cleveland cavaliers basketball cleveland indians baseball,grammy awards see the full winners list^fans react u2 cancels st. louis concert amid police protests^here how help victims las vegas mass shooting^hugh hefner cause death has been revealed^billboard music awards nominations see full list of bbmas nominees,2,3,1,5,0.4,0.2,0
18719880,620wtmj,1060,21788,653,94570,1,3,1,0,wisconsin radio station,fr pat conroy chaplain us house representatives rescinded resignation letter^could democratic national committee eyeing milwaukee national convention joins wan :34p^the house energy commerce committee released facebook chief mark zuckerberg prepared testimony monday^philadelphia ap democratic national committee offers `sincere apology sanders supporters `inexcusable remarks emails^this hour jeff wagner show did kellyanne conway go far saying people buy ivanka stuff,2,3,1,5,0.4,0.2,0
41621505,CBS4Indy,945,19918,481,162682,0,1,2,2,official account cbs indianapolis,livestream president trump south korean president deliver statement rose garden^new photos britain newest royal prince louis big sister princess charlotte shared pri^new photos britain newest royal prince louis big sister princess charlotte shared pri^breaking former fox news ceo founder roger ailes dead^actor frank vincent best known roles goodfellas casino the sopranos dies age cbs4morning,2,3,1,5,0.4,0.2,0
4267082849,APEastRegion,297,19343,632,11692,1,1,1,2,latest news new england new york new jersey pennsylvania ohio dms open share news tips securely,"breaking federal prosecutors charge nyc subway bomb suspect say wrote facebook trump failed protect nation^presidential campaign paid 14,500 civil penalty settle complaint using australi^nbc news picks hoda kotb replace matt lauer co anchor today show^here story the brady bunch house sale 1.885 million^i am jazz star jazz jennings says great gender confirmation surgery",2,3,1,5,0.4,0.2,0
107117835,FoxNewsLife,225,14937,222,11314,0,1,2,2,the biggest stories food drink travel outdoors style wellness real estate,"ohio restaurant cancels sunday church discount outrage secular organization^kate middleton custom made hospital dress probably costs 3,000 eerts estimate^meghan markle criticized inappropriate shoulder dress queen birthday parade^walmart remove cosmopolitan magazine checkout lines^walmart remove cosmopolitan magazine checkout lines",2,3,1,5,0.4,0.2,0
69557313,digitalspytv,77,13381,283,57240,0,0,2,3,tv news recaps features interviews,has thecrown season found new prince charles^shannen doherty gives verdict charmed reboot^in unsurprising exciting news netflix officially renewed stranger things season^desperate reasons why here everything know far season^ncis star pauley perrette leaving show season years,2,3,1,5,0.4,0.2,0
159147860,GannettAlbany,809,11965,523,83958,0,3,2,0,new york state editor usa today network nets jets mets,some protesters escorted cuomo speech they shouted convention floor chan^get thus speech convention ...^molinaro emails supporters saying give nominating convention speech wednesday switch initiall^cuomo takes shot talk cynthia nin name id primary run if name reco^cuomo holding press conference railing salt deductions pointing nyc suburbs including westchester,2,3,1,5,0.4,0.2,0
19414861,WhittierNews,151,10725,254,84885,0,0,2,3,local news matters we cover whittier calif. surrounding communities localnewsmatters,jessica simpson gives birth boy singer fashion designer jessica simpson gave birth second chi ...^what pentagon papers spielberg the post^neil diamond retires touring diagnosis parkinson disease^brady bunch house closes sale 3.5 million almost twice asking price^eminem beyonce weeknd headline coachella valley music arts festival,2,3,1,5,0.4,0.2,0
1089342374,MTVEnglishNews,217,9675,232,179840,0,1,2,2,your go-to source local regional international news follow arabic news updates,reuters citing foxnews interview saudi foreign minister jubeir says saudis want hold account respo^hongkong woman tricked into marrying stranger china scam marriage^princeharry reveals what nearly 'ruined his wedding gesture to meghanmarkle^edsheeran skips grammys wins best pop solo performance grammys2018 grammyawards^eltonjohn mileycyrus rock grammys with ''tiny dancer '' duet grammys2018,2,3,1,5,0.4,0.2,0
14133037,dfriend,2240,8145,228,22119,0,1,2,2,pop culture reporter the canadian press arts entertainment music/film/tv/streaming/social media contributor david.friend.com,i sitting looping video awe october very own simultaneously defying creation an^stargazers high alert julia roberts bradley cooper ryan gosling coming days they 're among^when comes deep dives two part episode popcast totally worth get^scott hutchison frontman scottish indie rock band frightened rabbit found dead reported missing on^former mtv vj jesse camp reported missing california spin,2,3,1,5,0.4,0.2,0
90702654,1210WPHT,1131,7295,153,57031,1,3,1,0,more live more local the new talk radio wpht home rich zeoli dawn stensland dom giordano,undergoes kidney surgery at walter reed medical center^icymi appeared foxnews sunday afternoon discuss president trump visit g7summit^obama campaign woos hispanics tv radio ads via^talks cnn don lemon double white male/terror threat comments listen here^discusses bff oprah gayle king says winfrey considering running president i,2,3,1,5,0.4,0.2,0
41435071,TexomasHomepage,464,6966,181,39372,0,3,2,0,we home local news weather sports kfdx tema fox spirit tema,the us centers disease control prevention warned us consumers tuesday eat romaine lettuce it^the centers disease control amp prevention offering tips making sure family stay safe and^the us centers disease control prevention warned us consumers tuesday eat romaine lettuce it^katie couric matt lauer today co host several years broke silence saturday sexual misconduct^beyonce headlining set coachella may delayed year disappoint the superstar t,2,3,1,5,0.4,0.2,0
16246654,CW33,2208,5420,278,47774,0,0,2,3,doing good having fun,royal drama meghan markle dad attend wedding prince harry^a missing week old houston baby found massive manhunt seen prince harry meghan m^remembering life career tom petty dead^ellen degeneres cries receiving best birthday gift portia de rossi^ellen degeneres cries receiving best birthday gift portia de rossi,2,3,1,5,0.4,0.2,0
17441094,Michellpollino,3274,5048,43,13081,0,2,2,1,entertainment reporter fox sirius xm la based philly native fly eagles fly also make films tv shows raging moderate opines,sean hannity sets interview with roseanne barr on fox news via^sean hannity sets interview with roseanne barr on fox news via^aquaman trailer jason momoa nicole kidman amp amp cast swim into action in dc pic comic con^aquaman trailer jason momoa nicole kidman amp amp cast swim into action in dc pic comic con via^retweeted axios hamilton musical creator lin manuel miranda sings lullaby dedicated migra,2,3,1,5,0.4,0.2,0
19178981,979WRMF,2227,4122,92,22333,0,0,2,3,the best variety today wake the kvj show weekday mornings am-10am,jennifer aniston confronts selena gomez over justin theroux rumors gomez justin theroux selena aniston^sharon ozzy osbourne split after years marriage sources say they might reconcile via^rachel mcadams welcomes first child rachel rachelmcadams mcadams babyboy baby birth birthbaby jamielinden^chrissy teigen gives birth with john legend baby no chrissyteigen teigen legend baby johnlegend^look save the date card mail nick jonas priyanka chopra engaged,2,3,1,5,0.4,0.2,0
29858306,KIDKnews,129,3970,164,18759,2,2,0,1,tweets kidk channel eyewitness news idaho falls/pocatello kidknews3,the us house representatives passed bill wednesday fund security schools^eight people found dead ohio seven killed execution style police still investigating^the democratic national convention underway without committee chairwoman debbie wasserman schultz^the new restrictions follow recommendations centers disease control prevention^singer demi lovato hospitalized suffering apparent drug overdose,2,3,1,5,0.4,0.2,0
42688735,michaelschwab13,2102,2838,121,31883,0,3,2,0,creative director cba formerly politico usa today houston sports day michaelschwab13.com profile pic courtesy,i opportunity meet sen john mccain i remember interview shared sen schumer feeling^i opportunity meet sen john mccain i remember interview shared sen schumer feeling^i opportunity meet sen john mccain i remember interview shared sen schumer feeling^hey^in diane black spoke border wall katie couric interview first build wal,2,3,1,5,0.4,0.2,0
28696684,CarissaPavlica,1512,2779,133,74459,0,0,2,3,managing editor/critic btja tomatometer-approved critic email carissa.com,hot from team tvf shannen doherty defends charmed reboot give show chance via^hot from team tvf take two trailer rachel bilson eddie cibrian are back via^americanhorrorstory season title new clue revealed via^americanhorrorstory season title revealed via^americanhorrorstory season lena dunham joins cast via,2,3,1,5,0.4,0.2,0
597985484,OriginalFresca,1375,1813,42,7389,0,0,2,3,senior reporter //previously //tips fbacardi.com,baftas complete list winners via^it leonardo dicaprio nina agdal via^miles teller arrested allegedly drunk public via^'road rules star danny dias cause death revealed via^inside world most shocking royal scandals,2,3,1,5,0.4,0.2,0
325868462,tcsmith312,136,1618,106,14890,0,2,2,1,veteran investigative journalist covering statehouse fun called cowboy governor hat boots no horse,donald trump sets conditions defending nato allies against attack via^white house fully restores cnn reporter jim acosta credential creates briefing rules via^obama commutes sentence chelsea manning u.s. soldier convicted leaking classified information^gwyneth paltrow angelina jolie others say weinstein harassed them via^walmart remove 'cosmopolitan magazine checkout lines amid me too movement via,2,3,1,5,0.4,0.2,0
32741587,Marshanadahlia,254,1188,34,7245,0,0,2,3,bravo tv personality former bachelor contestant season final si make-up artist beauty blogger,wishing her royal highness meghan duchess sussex happy th birthday today i wish continued healt^wishing her royal highness meghan duchess sussex happy th birthday today i wish continued healt^so wait prince harry prince william best man meghan markle wo n't maid honor how is^so wait prince harry prince william best man meghan markle wo n't maid honor how is^so wait prince harry prince william best man meghan markle wo n't maid honor how is,2,3,1,5,0.4,0.2,0
252881503,hausofcait,968,838,45,4693,0,2,2,1,reporter previously journalist house plant enthusiast etc email cyilek.com dm signal,each time gotten near making agreement done something wrong set back rudy giu^the president initially happy learn rogue statement issued first lady office ... but he^one best stories date i 've read first lady inside melania trump complicated white house li^georgina chapman life harvey weinstein huma abedin cameo^karlie kloss is engaged joshua kushner,2,3,1,5,0.4,0.2,0
216299334,piersmorgan,1855,6802597,19233,127350,0,2,3,0,one day cock walk next feather duster margot barber,video my full fascinating interview guns/brexit/blair/trump^huge show tonight exclusive interviews ted turner founder cnn president george w. bush airs pm/et^*new omarosa offered sex win celebrity apprentice called 'f***ing f*gg*t invented gay smears amp^after long amp careful thought new year resolution i 've decided remain exactly shy retiring^actually whole point column angelina deliberately made divorce battle public and,3,2,-1,5,0.6,-0.2,1
352145373,WhatTheFFacts,505,6272388,11834,102371,0,0,3,2,all things make say wtf official account what the f*** facts whatthefact,jennifer aniston married justin theroux her past romances include brad pitt vince vaughn amp pics gt gt sp^bizarre true stories about angelina jolie^bizarre true stories about angelina jolie^things we never knew about 'the parent trap^things we never knew about 'the parent trap,3,2,-1,5,0.6,-0.2,1
17602896,IMDb,1089,4463792,21253,31607,0,0,3,2,the folks imdb talking movies tv celebrities,julia roberts one biggest movie stars planet thanks smash hits like pretty woman nottin^we loved seeing richardgere dark side officer dennis peck^julie bowen debby ryan cast elain love characters^icymi 'walking dead promotes series regular season^daytime emmy awards complete list of winners,3,2,-1,5,0.6,-0.2,1
125346858,channelstv,170,3382399,2983,122025,0,2,3,0,channels television one independent television stations currently broadcasting nigeria,pdp sets date for national convention the national working committee peoples democratic party pdp ...^the statement result circulation /2015 actually generated president old school i^kim kardashian talks justice on second white house visit^george clooney and lawyer wife amal welcome twins^david beckham to face trial over speeding offence,3,2,-1,5,0.6,-0.2,1
117087700,CoolFMNigeria,1357,1867010,1491,649791,0,0,3,2,your hit music station join cool community ig coolfmlagos fb coolfmnigeria periscope youtube g+ coolfmnigeria,channing tatum and jenna dewan split after years of marriage^caitlyn jenner denies report may 'detransition back bruce suffering sex change regret^channing tatum and jenna dewan split after years of marriage^'we mutually decided separate usher wife grace miguel announce split two years marriage^meryl streep joins big little lies season,3,2,-1,5,0.6,-0.2,1
14377605,TheDemocrats,1448,1648242,10787,28314,3,2,0,0,the official twitter account democratic national committee led chair join team get latest info democratic news issues,mondaymotivation we 've got days change future nation protect democracy republicans inacti^cacti go vote^wish ceo happy first day committing vote beyond^ask robert gibbs question pm press briefing using hashtag q and look answers^president obama this past versus future and america believes future. actonclimate,3,2,-1,5,0.6,-0.2,1
15220768,DavidCornDC,1660,756389,11063,68839,2,2,1,0,d.c. bureau chief mother jones msnbc analyst author nyt no best-selling book russian roulette,candidate us house representatives gt^the us house representatives n't seem game^white house sends email announcing :00pm briefing press secretary robert gibbs did i miss something whbrief^they push record release transcript^time person year,3,2,-1,5,0.6,-0.2,1
21525579,pattistanger,1278,508954,2503,26028,0,0,3,2,the one millionaire matchmaker appearances bookpatti.com,how nice wake fav gemini girl angelinajolie getting married man bradpitt congrats couple last^praying work soulmates always get back together work n evolve^so i 'm loving new bod she fav fact letting curves fly inspiring luv girl^how kristin cavallari rebranded herself after the hills e news girlcrush^things we learned from ashton kutcher interview with howard stern mila kunis money more luv couple,3,2,-1,5,0.6,-0.2,1
126733638,pmnewsnigeria,203,483308,756,218656,0,2,3,0,first nigerian news nigeria leading evening newspaper,buhari speech apc national convention^sura msmes storm ekdc office protest poor power supply^fyi lamar odom congratulates khloe kardashian on her pregnancy news nigeria^lamar odom congratulates khloe kardashian on her pregnancy news nigeria^lamar odom congratulates khloe kardashian on her pregnancy news nigeria,3,2,-1,5,0.6,-0.2,1
2373735295,MiddleEastEye,295,197778,3881,227837,1,2,2,0,your eye ground independent middle east north africa news,after retaking control us house representatives democratic congressman told washington post h^khashoggi murder transcended questions foreign policy shaped values democracy free speech due^on sunday saudi foreign minister adel al jubeir told fox news kingdom know khashoggi body^celebrate women middle east international women day bikers sport stars^'i decided walk red carpet lift sign remind everyone something important th,3,2,-1,5,0.6,-0.2,1
18228708,GlobalCalgary,752,187427,1276,143318,1,2,2,0,your source breaking news yyc beyond story idea email calgary.ca,texas official sid miller uses c word hillary clinton twitter^philando castile stopped times police was racial profiling^watch live hillary clinton addresses supporters campaign rally las vegas^here complete list nominees golden globes who rooting^jenner n't reveal final surgery last page,3,2,-1,5,0.6,-0.2,1
25071402,tcm,1150,178108,2606,43519,0,2,3,0,the home classic movies let talk letsmovie,in october senator john mccain joined spotlight party politics movies introduce paths of gl^in october senator john mccain joined spotlight party politics movies introduce paths of gl^tonight airing the th afi lifetime achievement award a tribute george clooney pm et followed o b^tonight airing the th afi lifetime achievement award a tribute george clooney pm et followed o b^our celebration afilife achievement award winner georgeclooney continues o brother where art th,3,2,-1,5,0.6,-0.2,1
114409817,sn_soccer,14,158596,4479,43151,3,2,0,0,twitter facebook ios android,j j jleague bellmare vissel^j 4 j1 17 j jleague vissel bellmare^w ck 2 14 j jleague urawareds grampus^23 / w w worldcup russia2018 fra^j1 17 2 j jleague,3,2,-1,5,0.6,-0.2,1
372236876,CinemaGuide,672,156475,337,27633,0,2,3,0,,xxx state union 2005 /10^xxx state union 2005 /10^fury 2014 /10 mbc action^fury 2014 /10 :30 mbc action :30^fury 2014 /10 :30 :30 mbc2,3,2,-1,5,0.6,-0.2,1
24144266,YouMagazine,1141,137937,413,48214,0,0,3,2,this official twitter channel you magazine biggest selling english magazine south africa,reality tv star pal confirms jamie foxx katie holmes dating^watch angie breaks silence devastating divorce 'the kids helping cope^brad pitt angry angelina jolie amid custody battle^royal rules meghan markle must follow duchess^bradley cooper irina shayk welcome first child report,3,2,-1,5,0.6,-0.2,1
15969142,JapanToday,7,103162,2496,131012,3,0,0,2,japantoday leading english news site japan featuring latest news stimulating reader discussions domestic international issues,world top texas official wo n't apologize muslim bombing post texas agriculture commissioner sid miller ...^world top texas official wo n't apologize muslim bombing post texas agriculture commissioner sid miller ...^u.s. house representatives accuses myanmar rohingya genocide^matt damon apologizes comments sexual misconduct japannews^'nypd blue 'la law creator steven bochco dead,3,2,-1,5,0.6,-0.2,1
17461964,marieclaireau,945,93708,1137,23342,0,0,3,2,if matters women marie claire get latest news culture fashion beauty updates australia no fashion magazine,sarah jessica parker hilarious way save sex and the city^the actor playing young prince charles thecrown announced^prettylittleliars star troian bellisario shares heartbreaking tribute friend lost baby months^rachelmcadams reportedly pregnant first child^blac chyna granted temporary restraining order rob kardashian following domestic abuse allegations,3,2,-1,5,0.6,-0.2,1
31147535,globalhalifax,424,62861,635,140407,1,2,2,0,your source traffic weather breaking news halifax beyond follow us instagram,texas official sid miller uses c word hillary clinton twitter^philando castile stopped times police was racial profiling^watch live hillary clinton addresses supporters campaign rally las vegas^here complete list nominees golden globes who rooting^jenner n't reveal final surgery last page,3,2,-1,5,0.6,-0.2,1
150904297,Popdust,6120,58665,653,174899,0,0,3,2,latest music entertainment pop culture visit website,hands little bit terrified chris brown name gon na come nas mouth teamfrank grammys^kimkardashian feeds selfie obsession quickie airplane toilet photo shoot kuwtk^kimkardashian feeds selfie obsession quickie airplane toilet photo shoot kuwtk^julia louis dreyfus awarded mark twain prize american humor past sunday congrats^lady gaga announces two year las vegas residency,3,2,-1,5,0.6,-0.2,1
28376357,divorcecourt,8237,55647,300,35418,0,0,3,2,television longest running court show messy message stay tuned drama serving season long,was baby reason behind josh duhamel fergie split^jamie foxx katie holmes taking next level dating celebrity^kourtney kardashian scott disick are back together again dating reunited^rt we calculated divorce rate every real housewives show results will blow your mind^actors michael fassbender alicia vikander hitched the couple married weekend ibiza congrats.,3,2,-1,5,0.6,-0.2,1
86851878,945thebuzz,7737,52836,292,55391,0,0,3,2,houston texas rock alternative buzzfest listen live iheartradio instagram/facebook,even nicole kidman gets kick ass new five minute trailer aquaman^avril lavigne mildly amused reemergence bizarre conspiracy theory died^is bradgelina back angelina jolie calling brad pitt divorce^former mtv vj jesse camp has been reported missing^billboard music awards nominations see full list of bbmas nominees,3,2,-1,5,0.6,-0.2,1
37340424,FilmFatale_NYC,5258,47966,1405,430944,0,1,3,1,film/tv critic entertainment weekly forbes nytimes ebertvoices the urban daily creator host thespectrumlounge filmfatalenyc.com,... morgan freeman made sexually inappropriate comments cnn reporter caught camera press^rt the twilight curse will robert pattinson kristen stewart ever be taken seriously^wiggy i think chris rock wants cause trouble^i 've always liked brad pitt career fighting boxed looks^ok gt jessica chastain talks join sequel stephen king it via,3,2,-1,5,0.6,-0.2,1
15588104,melsil,5151,46240,1321,82776,0,0,3,2,founder/publisher educates advocates agitates gender equality inclusion artistic director athena film festival,rachel weisz 'my parents refugees brexit feels like death film the guardian^the examined life angelina jolie pitt wsj^so proud part worldwide effort locarno festival sign pledge parity inclusion aug^'how get away with murder star karla souza alleges she was raped director mexico believewomen^meryl streep joins season big little lies,3,2,-1,5,0.6,-0.2,1
61288679,globalwinnipeg,1748,41664,465,99498,1,2,2,0,winnipeg source breaking news,texas official sid miller uses c word hillary clinton twitter^philando castile stopped times police was racial profiling^watch live hillary clinton addresses supporters campaign rally las vegas^here complete list nominees golden globes who rooting^jenner n't reveal final surgery last page,3,2,-1,5,0.6,-0.2,1
610919499,DaShanneStokes,1890,39353,528,55992,0,2,3,0,sociologist author pundit politics culture scholar fighter equality justice you may caught tv radio read work views mine,hey facts you responsible campaign attempted collusion you a^trump asking congress mexico pay border wall^if n't racist use racial slur elizabeth warren lead racist birther witc^if n't bigot use racial slur elizabeth warren lead racist birther witch^the fake news media failing enemy enemy america,3,2,-1,5,0.6,-0.2,1
14589909,NewstalkZB,578,34927,622,242627,0,0,3,2,newstalk zb new zealand premier news information radio station,katy perry makes raunchy auction offer^kate hawkesby michael parkinson right comment billy connolly health^parky 'daft old fart billy connolly hits back illness claims^koko gorilla famous sign language adopting kittens dies^legendary us comedian don rickles dies aged,3,2,-1,5,0.6,-0.2,1
19196807,DVERADIO,582,31717,329,32617,0,0,3,2,the radio home pittsburgh steelers here go,celebrities react trump withdraws steph curry white house invitation^celebrities react nfl players kneel lock arms during national anthem^fans react u2 cancels st. louis concert amid police protests^neil diamond retires from touring after parkinson disease diagnosis^hugh hefner cause death has been revealed,3,2,-1,5,0.6,-0.2,1
41861310,jackiekashian,1902,31470,772,51517,0,2,3,0,see cat came mayflower pods thedorkforest/atc jackieandlaurieshow/maxfun she/her i kick hecklers,i gon na want sparks/cliff notes version minutes thing knobjobconjob i like give all^also yesterday man denver shot five people killing one wounding four no one knows police still looking^it julia roberts movie this whole time^it julia roberts movie this whole time^it julia roberts movie this whole time,3,2,-1,5,0.6,-0.2,1
19209569,RCJournal,140,23901,370,73393,0,2,3,0,the rapid city journal first best source local news west river south dakota,what popular baby names state year born^chicago police multiple victims reported shooting hospital^mlb predictions who come top^nfl predictions who come top draft^today birthdays sept. beyonce knowles,3,2,-1,5,0.6,-0.2,1
301138272,sportsandra,5518,22484,263,54726,0,0,3,2,resident smart ass thefan praying hometown panama city/hurricane michael strong my tweets noles braves laughter,mind blown rosevodkarose monicarulestheworld^mind blown rosevodkarose monicarulestheworld^i 'll julie bowen seriously^reports former fox news ceo roger ailes dead^attn mommies kristen bell has already recorded frozen ''it very good '' via,3,2,-1,5,0.6,-0.2,1
202322417,GlobalOkanagan,8396,20796,348,79593,1,2,2,0,your source weather traffic breaking news okanagan beyond,texas official sid miller uses c word hillary clinton twitter^philando castile stopped times police was racial profiling^watch live hillary clinton addresses supporters campaign rally las vegas^here complete list nominees golden globes who rooting^jenner n't reveal final surgery last page,3,2,-1,5,0.6,-0.2,1
293762731,GlobalLeth,247,16888,220,77320,1,2,2,0,the most-watched newscast lethbridge source southern albertans trusted years join us pm pm pm monday friday,texas official sid miller uses c word hillary clinton twitter^philando castile stopped times police was racial profiling^watch live hillary clinton addresses supporters campaign rally las vegas^here complete list nominees golden globes who rooting^jenner n't reveal final surgery last page,3,2,-1,5,0.6,-0.2,1
1114319616,IrishTimesWorld,14,15829,308,62113,1,0,2,2,news tweets retweets world correspondents contributors around globe,multiple people found dead ohio home say police^angelina jolie brad pitt busy dividing 400m fortune^bono says donald trump could destroy america^actor bill cosby 80 found guilty sexual assault retrial^actress ashley judd sues harvey weinstein defamation sexual harassment,3,2,-1,5,0.6,-0.2,1
24258522,Knowlesitall,2647,13680,259,43146,0,0,3,2,anchor instagram texan trends sports news retweets are not endorsements,channing tatum wife jenna dewan announce split we 'chosen separate couple via^amal george clooney welcome twins ella alexander trending via^jenna dewan tatum channing tatum announce their separation^priyanka chopra nick jonas engaged people reports^meryl streep joins big little lies season via,3,2,-1,5,0.6,-0.2,1
16858755,omekongo,3060,13666,147,20441,0,2,3,0,professor leadership diversity implicitbias eert speaker writing book jay z,we agree trump part do n^there commentary annihilation comments shared marc lamont hi^this responds accountable more american peop^this responds accountable more american people as^this responds accountable more amer,3,2,-1,5,0.6,-0.2,1
87718474,PrimaMag,1464,12833,241,13459,0,0,3,2,inspiration advice today busy creative fun-loving women wellbeing recipes homes fashion beauty crafts parenting,sir michael parkinson talks friend billy connolly parkinson disease 'his wonderful brain dulled^billy connolly hits back michael parkinson claims health^sir michael parkinson talks friend billy connolly parkinson disease 'his wonderful brain dulled^tom daley dustin lance black announce 're eecting first child^reese witherspoon confirms legally blonde actually happening,3,2,-1,5,0.6,-0.2,1
1299926586,Global_NB,138,12469,211,77867,1,2,2,0,official twitter account global new brunswick follow us latest news updates follow us instagram,texas official sid miller uses c word hillary clinton twitter^philando castile stopped times police was racial profiling^watch live hillary clinton addresses supporters campaign rally las vegas^here complete list nominees golden globes who rooting^jenner n't reveal final surgery last page,3,2,-1,5,0.6,-0.2,1
20538284,poststar,717,12430,319,96536,0,2,3,0,news coverage glens falls saratoga lake george region upstate new york,what popular baby names state year born^chicago police multiple victims reported shooting hospital^mlb predictions who come top^nfl predictions who come top draft^today birthdays sept. beyonce knowles,3,2,-1,5,0.6,-0.2,1
44366594,giacomonyt,1360,8844,335,34376,1,2,2,0,nyt ed bd foreign defense i write mother fabulous son long-time dc resident italian-irish immigrant family came connecticut yrs ago,readers beware inside fake news sausage factory this is all about income^clinton campaign claim trump would force schools allow guns classrooms^the u.s. trade deficit widened july three years gap china hit record white^this cruel amp unjust trump administration rescinds rules bathrooms transgender students via^morning joe hosts trump bring national enquirer into their feud,3,2,-1,5,0.6,-0.2,1
25543588,krnb1057,4296,8482,97,30606,1,0,2,2,smooth r b -dallas ft. worth krnb livelifesmooth listen live click here,beyonc amp jay z live performance mandela global citizen festival george hw bush died world aids^it big day meghan duchess sussex help us say happy birthday krnb livelifesmooth royal^it big day meghan duchess sussex help us say happy birthday krnb livelifesmooth royal^happy days star erin moran dead at the age of ... krnb eringone livelifesmooth^and baby makes join us saying congratulations tyrese gibson wife samantha eecting baby gir,3,2,-1,5,0.6,-0.2,1
3314811637,AstroRadioNews,593,3048,22,33361,0,0,3,2,we voices behind news updates haowan msia,gwyneth paltrow reportedly wants ex husband chris martin walk aisle marries brad falchuk^former desperate housewives star teri hatcher slammed rumours broke homeless living van^former desperate housewives star teri hatcher slammed rumours broke homeless living van^miss district columbia year old chemist kara mccullough crowned miss usa photo credit ...^jennifer lawrence director darren aronofsky split dating year,3,2,-1,5,0.6,-0.2,1
752638641478967296,CulturessFS,1406,2619,87,34606,0,0,3,2,where women nerd pop culture come join culturess crew,fergie josh duhamel latest couple split year^from selena gomez kim kardashian celebs 're excited see nyfw^from selena gomez kim kardashian celebs 're excited see nyfw^have free time holidays check shows binge watch netflix^have free time holidays check shows binge watch netflix,3,2,-1,5,0.6,-0.2,1
16347151,NewsdayEnt,1002,2377,49,6949,0,0,3,2,the latest entertainment celebrity news,lindsay lohan parents plan sue sen. john kennedy slanderous comments made congress report says^kanye west suffering extreme paranoia remain hospitalized indefinitely reports say^reveals kidney transplant due struggle lupus^granted temporary restraining order monday former fianc^announces subject broadway musical coming based life songs,3,2,-1,5,0.6,-0.2,1
568302114,38TheSpot,1142,2310,79,7769,0,0,3,2,home sports courts comedy,icymi kristenstewart throws major shade justinbieber ohsnap^we excited introduce new host you start seeing regularly monday^we excited introduce new host you start seeing regularly monday^ryan seacrest kelly ripa new co host 'live^pippa middleton marries hedge fund manager james matthews nearly royal wedding,3,2,-1,5,0.6,-0.2,1
15438913,MailOnline,2333,2405782,13661,282759,0,1,4,0,for latest updates breaking news visit website seriouslypopular,breast pump firm raises eyebrows compares nursing mothers cows wacky new ad campaign^angelina jolie misses aunt funeral supports brad pitt london premiere world war z matchi ...^your guide new order succession british throne royalbaby^carrie cheering underwood celebrates husband mike fisher winning ice hockey goal with^mario lopez admits 'i cheated ali landry days wedding he elained soon,4,1,-3,5,0.8,-0.6,1
18244358,NatGeoChannel,4838,1944104,9383,51089,0,1,4,0,follow us latest happening national geographic channel u.s questions comments welcome,just two hours exclusive interview president george w. bush nearly years /11 pm tonight^catherine duchess cambridge wore one kind dress royalwedding learn secret behind the^catherine duchess cambridge wore one kind dress royalwedding learn secret behind the^nearly /3rds white working class americans say american society worse today s. do^on average women earn cents every dollar earned men why gender wage gap still exist america,4,1,-3,5,0.8,-0.6,1
20225875,i_D,593,1578965,9464,103679,0,0,4,1,the original fashion style bible,star born lady gaga bradley cooper greatest film ever^the women hollywood speak^woody allen movie timoth e chalamet selena gomez dead^r.i.p woody allen movie timoth e chalamet selena gomez^ellen page accuses brett ratner homophobic abusive behavior,4,1,-3,5,0.8,-0.6,1
58529612,RealDLHughley,2248,484862,2138,129974,0,1,4,0,dl hughley show comedian actor radio host author king comedy,watching morning joe mike huckabee i wonder 'll asked defense child molester josh duggar teamdl^kanye west has had 'elosive fights kris jenner amp kim kardashian ca n't 'control him sources people^what kanye west said about slavery obama mental health his new interviews the new york times^kanye west has had 'elosive fights kris jenner amp kim kardashian ca n't 'control him sources people^kanye west has had 'elosive fights kris jenner amp kim kardashian ca n't 'control him sources people,4,1,-3,5,0.8,-0.6,1
23585763,artinfodotcom,7585,409412,6348,58561,0,0,4,1,the art world breaking news reviews q as features art inbox subscribe daily newsletter,julia roberts tv drama homecoming premiere tiff blouin artinfo blouin artinfo^julia roberts tv drama homecoming premiere tiff blouin artinfo blouin artinfo^julia roberts tv drama homecoming premiere tiff blouin artinfo blouin artinfo^julia roberts tv drama homecoming premiere tiff blouin artinfo blouin artinfo^priyanka chopra nick jonas officially engaged blouin artinfo blouin artinfo,4,1,-3,5,0.8,-0.6,1
17711232,ReutersBrasil,24,328258,3281,127350,0,0,4,1,p gina oficial da ag ncia de not cias reuters brasil,george clooney lawyer wife amal welcome twins^channing tatum jenna dewan announce separation^dakota johnson treinou para dan as de suspiria durante grava o de tons^charlie says conta hist ria de charles manson ponto de vista das mulheres que ele usou em crimes^dj avicii electronic dance music star dead,4,1,-3,5,0.8,-0.6,1
231355136,SINDOnews,196,262994,547,784064,0,1,4,0,sumber informasi terpercaya,ethiopian prime minister calls multiparty democracy^amal dan george clooney pasangan harmonis di hollywood^baikan katy perry ingin taylor swift tampil di american idol^selena gomez jadi juri american idol^baikan katy perry ingin taylor swift tampil di american idol,4,1,-3,5,0.8,-0.6,1
19679993,FullSail,5514,251975,1375,203632,3,1,1,0,full sail university serves educational leader pursuing careers entertainment industry,the accsc listed u.s. department education nationally recognized accrediting agency^the accsc listed u.s. department education nationally recognized accrediting agency^the accsc listed u.s. department education nationally recognized accrediting agency^the accsc listed u.s. department education nationally recognized accrediting agency^free moving screening the future coming from producers stranger things see kinmovie starring,4,1,-3,5,0.8,-0.6,1
19983221,PA,227,128100,2684,77720,1,0,3,1,breaking news developing stories features uk national news sport agency,breaking george hw bush st president united states died age spokesman says^a new report shows duchess cambridge biggest impact shopping habits^princess charlotte turns two years old tomorrow photographed mother anmer hall norfolk april^breaking david beckham prosecuted speeding charge celebrity lawyer nick freeman dubbed^prince philip attends captain general parade buckingham palace final public engagement retirem,4,1,-3,5,0.8,-0.6,1
91046596,USEmbSL,379,117045,360,8633,4,1,0,0,official twitter account u.s. embassy sri lanka maldives follow updates ambassador retweets endorsement,prime minister unp engaged w delegation house representatives armed services committee headed by^during meeting president us house representatives armed services committee delegation^us house representatives armed services committee delegation met w opposition leader r. sampanthan learned a^honorable speaker senior defense foreign policy leaders government srilanka welcom^right on record q amp a sri lankan media transcript forthcoming,4,1,-3,5,0.8,-0.6,1
1140280051,TheDebrief,1942,49635,300,76470,0,0,4,1,news style things to do sex your life online,er ... 're asking questions robert pattinson new wife^selena gomez selling la pad numerous calls fears intruder^selena gomez selling house several calls fears intruder^people reporting might pregnant even business^problematic stacey dash running congress california,4,1,-3,5,0.8,-0.6,1
21812094,Cosmoaustralia,3879,43574,576,15407,0,0,4,1,official account cosmopolitan australia biggest-selling young women lifestyle mag country become part community,things selena gomez get body^here proof selena gomez total natural beauty^matthew mcconaughey reckons time started embrace donald trump^everyone freaking kate middleton latest outfit^revenge co stars emily vancamp josh bowman got engaged ring stunning,4,1,-3,5,0.8,-0.6,1
14602924,inforum,829,38734,445,132511,2,0,2,1,news fargo-moorhead around region sign email newsletters,watch live us north dakota house representatives debate^a fake photo emma gonz lez went viral far right parkland teens villains^kylie jenner mystery pregnancy might confusing kardashian situation ever^kylie jenner mystery pregnancy might confusing kardashian situation ever^julia louis dreyfus diagnosed breast cancer,4,1,-3,5,0.8,-0.6,1
25394970,hlnshowbiz,48,33492,591,16395,0,0,4,1,entertainment news hln,brand new controversial comments john mayer jennifer aniston did really say should get back together^john mayer not over jen should john mayer jennifer aniston get back together^has robert pattinson canceled appearances new film cosmopolis kristen stewart cont^carlos diaz show today talking feuds jacksonfans oprah kanye vs. george bush hln mins^sbt confirms teenmom amber portwood pregant in statement sbt the rumors absolutely false i 'm pregnant ...,4,1,-3,5,0.8,-0.6,1
47722134,LisaDaftari,889,33424,696,40599,1,0,3,1,foreign policy nat l sec/mideast eert tv/radio commentator iranian -lingual founder/editor tedx speaker inquiries-lisa.news,latest federal complaint portauthority bomber akayed ullah states posted facebook account yeste^thanks tuning radio sign daily foreign policy cheat sheet gt^coming news radio ktsa the jack riccardi show :05amet/8:05pt talking top headlines m^coming radio ktsa jack riccardi :20amet/8:20pt latest london terror car at^roger ailes former chairman ceo fox news dead,4,1,-3,5,0.8,-0.6,1
1073802444,iran_policy,2721,33301,863,30361,4,1,0,0,iran nationalcouncil resistance coalition democratic iranian organizations groups personalities founded rajavi host no2rouhani,a former us senator also years member house representatives he spoke jun^iran regime aggression key issue paulryan gulf regional tour the iranian regime regional eansio^newt gingrich former speaker us house representatives the willingness many people coming diff^reality based us policy iran will bring regime change at freeiran2108 gathering paris o^solidarity statement beatriz becerra mep june 'freeiran convention paris i think rajavi,4,1,-3,5,0.8,-0.6,1
21765964,KrisKetzKMBC,14906,28642,795,210505,0,1,4,0,pm winning anchor years links rt not endorsements opinions mine husband wonderful,president trump tempers iran rhetoric speech vfw convention^los angeles ap jennifer aniston justin theroux separating two half years marriage the^david cassidy fighting memory loss wants 'enjoy life abc news via^los angeles ap jennifer aniston justin theroux separating two half years marriage the^los angeles ap jennifer aniston justin theroux separating two half years marriage the,4,1,-3,5,0.8,-0.6,1
31697703,dw_culture,1031,20329,679,27406,0,0,4,1,from arts culture lifestyle trends bring best germany europe follow us join discussion,amal george clooney welcome twins world celebrates normal baby names^amal george clooney welcome twins do like names chosen^amal george clooney welcome twins world celebrates normal baby names^under pseudonym emma loman german actress filed lawsuit harvey weinstein accusing disgrac^princess eugenie granddaughter queen elizabeth ii engaged marry boyfriend jack brooksbank the weddi,4,1,-3,5,0.8,-0.6,1
104309271,bobclendenin,427,12975,197,43801,0,1,4,0,i put b subtle,a effort interview cuomo said t^i available^mark tom courteney cox creepy neighbor cougar town dr.^i available^mark tom courteney cox creepy neighbor cougar town dr.,4,1,-3,5,0.8,-0.6,1
136023366,IQtrivia,0,11183,131,377061,0,1,4,0,a live multiplayer trivia game played daily right twitter compete cash money iq score dm register next game,q3 president bill clinton signed brady bill law which law related guns^sorry celebs brands n't count^q8 speaking aging tv host forced leave post due sexual harassment allegations turns^q10 who never named time magazine person year adolf hitler steve jobs donald trump^q3 everyone loves sugar everyone loved romcom sugar daddy movie starring richard gere juli,4,1,-3,5,0.8,-0.6,1
15313939,chrisharnick,834,10444,254,33572,0,0,4,1,i love television much tv editor views tweets cats,i upset early jack rebecca even though i know outcome story that compellin^i forever awe lisa kudrow performance thecomeback it nuanced valerie cherish real^please somebody cast lisa kudrow tina fey julia louis dreyfus together something they sisters cou^please somebody cast lisa kudrow tina fey julia louis dreyfus together something they sisters cou^yes arresteddevelopment season really finally officially confirmed,4,1,-3,5,0.8,-0.6,1
18318098,theglobalist,494,8157,356,15334,4,1,0,0,eloring world really hangs together daily online magazine presenting comparative perspectives around world edited stephan richter,how could democrats resolve divisions speakership us house representatives nancypelosi^despite taking back control us house representatives democrats must also feel disappointed why^could fresh approach managing succession speakership us house representatives bring de^democrats taking control us house representatives make harder president trump push pol^erdogan losing last marbles he pays futile ad campaign germany invest turkey accuses german firms terrorism,4,1,-3,5,0.8,-0.6,1
207682058,ATLCW,214,6321,119,24337,0,0,4,1,the official twitter account atlanta cw like us facebook,after backlash kim kardashian defends kylie jenner forbes cover^shannen doherty surprises new charmed cast with her blessing on the reboot^kylie jenner admits she wants to marry travis scott^brad pitt says angelina jolie is manipulating media coverage amid child support battle^kaley cuoco marries karl cook,4,1,-3,5,0.8,-0.6,1
374356748,connortryan,1437,4810,145,40622,1,1,3,0,homepage editor alert-sender .com previously connor.ryan.com,rt news tucked snap earnings story cond nast shutting wired gq vogue channels snapchat cutting^breaking president barack obama deliver statement :15 rose garden partial iran agreement^exclusive disgraced today anchor matt lauer telling supporters back tv^exclusive the real reason jennifer aniston justin theroux split^exclusive matt lauer throws megyn kelly bus,4,1,-3,5,0.8,-0.6,1
310396618,PatriciaTreble,565,2698,109,21338,0,0,4,1,`` royal family game theory '' house windsor royal contributor go royal rt endorsement,editor the fab purse styling meghan duchess sussex^editor the fab purse styling meghan duchess sussex^the formal family shot wedding prince harry meghan markle taken green drawi^the kate skin bones stories back kate middleton not using surrogate despite report via^royal wedding update /5 meghan markle parents doria ragland thomas markle meet royal family j,4,1,-3,5,0.8,-0.6,1
102533175,Mix96Sac,1002,2154,127,40184,0,0,4,1,sacramento official at-work station marilyn nelson drive home,in case missed hollywood new power couple music official gt^what revenge seeking learning new relationship get details here gt^finished upbeat album ... amp split more ...^though divorced year ago bad blood^aprilthegiraffe pregnant we 'll watching will,4,1,-3,5,0.8,-0.6,1
1195175264,OliJColeman,1497,1053,18,1621,0,0,4,1,page six opinions obviously photo,in spite banned vogue alleged sexual misconduct bruce weber invited anna wintour daught^scoop 'dancing stars courting caitlyn jenner via^taylor kinney new girlfriend lady gaga split via^taylor kinney new girlfriend lady gaga split via^say goodbye kim bff jonathan cheban legally changing name 'foodgod via,4,1,-3,5,0.8,-0.6,1
30309979,BETMusic,768,5669532,16546,41419,0,0,1,3,black music for people people,former nfl star good morning america co host michael strahan attended nickelodeon kids choice sports awards^another suspect arrested xxxtentacion murder betbreaks^another suspect arrested xxxtentacion murder betbreaks^another suspect arrested xxxtentacion murder betbreaks,1,3,2,4,0.25,0.5,0
18071358,ZeeNews,48,4568768,2885,318809,1,2,0,1,channels i india largest news network i mn viewers i breaking news alert india world download zee media apps,two indian americans democratic party thrown hats ring us house representativ^live pm modi president trump issue joint statement white house rose garden shortly.^russia raises duties us goods response trade restrictions^oscars here complete list winners stood th academy awards,1,3,2,4,0.25,0.5,0
25985333,ntvkenya,234,2189025,1683,445742,1,1,0,2,follow breaking news kiswahili updates || || live stream,us shutdown house representatives senate pass contentious bill stop shutdown ntvatone^us president donald trump says briefed recording saudi journalist jamal khashoggi murder bu^the royal wedding update meghan markle walk aisle without father royal wedding amliventv^wendy williams reveals graves disease diagnosis talk show host says get ntvtoday,1,3,2,4,0.25,0.5,0
23818581,VICE,11192,1985623,17964,151962,0,0,1,3,original reporting everything matters sign vice newsletter,someone used algorithm paste face 'wonder woman star gal gadot onto porn video implication^kevin spacey ruthless frank underwood dead far unrevealed circumstances 'house cards just^everything need know 'twin peaks returns^everything need know 'twin peaks returns,1,3,2,4,0.25,0.5,0
810424,Gothamist,754,952595,7018,119016,0,2,1,1,gothamist website new york city everything happens get gothamist inbox today,giuliani is in new hampshire comparing obama to carter^giuliani tries heat up campaign new hampshire last week cnn/wmur poll likely repu..^chloe grace moretz and producers apologize for body shaming 'red shoes ad^the nypd released statement harvey weinstein arrested processed charged rape criminal se,1,3,2,4,0.25,0.5,0
85318467,TheNationNews,519,787093,917,168914,1,3,0,0,nigeria widest circulating newspaper accurate news sports entertainment need reach us info.net ig thenationnewspaper,history judge us harshly killings persist dogara speaker house representatives mr yakubu doga^a peculiar crisis demands decisive action i one hundred percent behind national assembly effo^calling calm restoration peace affected communities bordering abia state president sta^calling calm restoration peace affected communities bordering abia state president sta,1,3,2,4,0.25,0.5,0
9609632,australian,528,685678,5767,230930,1,2,0,1,news the australian newspaper the australian online,the us house representatives voted ban members sexual relationships employees^un wo n't work labor boatpeople the united nations high commission refugees refusing help proc ...^abc correct record neath the abc correct record media watch transcript program ca ...^weinstein company file bankruptcy,1,3,2,4,0.25,0.5,0
18266688,TomFitton,3053,665812,2619,29312,0,3,1,0,president judicial watch these personal views author new york times best seller clean house,another radical thinks ok meet terrorists gets key nsc job obama white house czars^here interview right demand answers spygate^tom fitton shadowbanning can result half country being left out debate^crisis deep state sedition president jw court victory fort hood soldier mueller,1,3,2,4,0.25,0.5,0
20678866,MENnewsdesk,1408,563748,2663,205731,0,1,1,2,breaking news sport showbiz manchester evening news,ad launched campaign urging firms open facilities^taylor swift booked entire city centre hotel ahead manchester gigs^love island sophie gradon found dead age^love island sophie gradon found dead police say death 'not thought suspicious,1,3,2,4,0.25,0.5,0
16672510,mediaguardian,117,509388,9470,62991,0,2,1,1,news comment analysis media team,betting media firms offer fund addiction awareness ad campaign^friday us briefing khashoggi search widens white house shifts tone^brad pitt angelina jolie search perfect pr hollywood divorce^pregnant serena williams poses nude vanity fair cover shoot,1,3,2,4,0.25,0.5,0
18917882,News12NJ,456,472599,1626,65647,1,0,0,3,news new jersey -hour news network download app go for news tips call 732 -3270 newjersey,breaking federal prosecutors charge nyc subway bomb suspect say wrote facebook trump failed protect nation^breaking police say golfer tiger woods arrested dui charge florida^jerry lewis comedian telethon host dies age^family fox news founder former ceo roger ailes dead breaking njmorningshow,1,3,2,4,0.25,0.5,0
19489239,Jerusalem_Post,459,430057,8656,210833,1,0,0,3,israel world news jewish state leading website best-selling english news source get jpost newsletter,rt house representatives unanimously passes us jordan defense cooperation extension act authorizing administration^breaking britain prince harry asks prince william best man wedding^breaking britain prince harry asks prince william best man wedding^legendary comedian don rickles dies breakingnews,1,3,2,4,0.25,0.5,0
2729061,doctorow,1716,420401,13018,210029,1,3,0,0,writer blogger activist if want reply use email blog suggestions bc4 a e2 d a77 f8e2 dbbe fc2 af,fox news accidentally puts poll graphic shows least trusted network^once student name birthday ssn us department education give everything else^yrago once student name birthday ssn us department education give everything e^neil gaiman read cheesecake factory menu raise 500k un high commission refugees,1,3,2,4,0.25,0.5,0
14957147,TheYoungTurks,10549,380075,6047,87057,0,2,1,1,hosted watch tytlive weeknights pm eastern,tyt contributor interviews stephanie kelton economic advisor bernie sanders presidential^we nation working poor people says tytlive talking income inequality unit^matthew embrace^morningjoe co hosts amp engaged,1,3,2,4,0.25,0.5,0
29979814,monaeltahawy,3324,323163,6488,450953,1,3,0,0,feminist tattoos mufc author the seven necessary sins women girls 2019 headscarves hymens 2015 pic s. enriquez-nistal,a record number women elected us house representatives midterm elections among them^here video debate saudi arabia the west get bed house saud^i know i beat man groped club montreal feb part rage anger ri^someone made moment notebooks people buy new ones even empty ones lie unused i retur,1,3,2,4,0.25,0.5,0
15612015,blackenterprise,9573,285027,3327,93013,0,3,1,0,info entrepreneurship tech personal finance business resources,be black women changing world this political amp communications strategist served t^financial disclosure reports now available sf executive branch personnel public financial disclosure report..^obama record we can act boldly about climate change full transcript president remarks th ...^basketball sneaker banned from nba ... controversies,1,3,2,4,0.25,0.5,0
20818801,dailykos,505,278406,7824,91948,0,3,1,0,news something,obama goal health care reform end year opening today white house forum health reform vow ..^weekly address biden federal judge blast republican senate leaving scotus vacancy open^it course chuck grassley touts 'bipartisanship republican weekly address^nbc kicks announcing hoda kotb officially replace matt lauer 'today co anchor,1,3,2,4,0.25,0.5,0
292083207,IronStache,4602,249143,1462,34599,1,3,0,0,dad/veteran/ironworker/cancer survivor former candidate congress wi01 founder ironpac,wednesday july th deadline register vote online wisconsin make sure 're registered vote^just single wall street executive ever served jail time financial crisis hundreds thousa^i finished speech wisconsin democratic party convention fired this blue wav^during debate said zero tolerance policy sexual assault so debate,1,3,2,4,0.25,0.5,0
85741735,AmazonHelp,69,240402,955,3798492,0,1,1,2,we answer amazon support questions days week support available english deutsch espa ol portugu s fran ais italiano t rk e,by default alexa uses ndtv news flash briefing content in order receive updates y^i get concern regarding product you connect support team^thanks reaching the selection titles included prime always changing occasi^we understand concern regarding availability subtitles 'the affair season everyt,1,3,2,4,0.25,0.5,0
119829799,CBSSunday,419,223721,2098,18792,0,1,1,2,looking cbs news sunday morning area find airs tv stations across nation,sunday profile preview john mellencamp profiles rocker fellow hoosier ex^tonight preview opens going public social media fertility struggles post^george clooney hospitalized scooter crash italy^april giraffe pregnant zoo announces baby no arrive spring,1,3,2,4,0.25,0.5,0
17820493,ocregister,2484,212481,1762,99946,0,0,1,3,orange county california news sports entertainment,what pentagon papers spielberg the post^brady bunch house closes sale 3.5 million almost twice asking price^eminem beyonce weeknd headline coachella valley music arts festival^what fave best halftime shows ever,1,3,2,4,0.25,0.5,0
25103000,WomansDay,5728,207921,973,32700,0,0,1,3,woman day best-selling monthly magazine u.s. we affiliated australian magazine,brad pitt is 'committed having healthy relationship with angelina jolie^prince harry meghan markle left empty seat princess diana royal wedding^dance moms star abby lee miller sentenced one year prison^everything we know so far about pippa middleton wedding,1,3,2,4,0.25,0.5,0
17006036,NARAL,6015,197988,2893,58090,0,3,1,0,naral pro-choice america fights protect eand reproductive freedom all,says past versus future wants bring women rights back cddebate va10^says past versus future wants bring women rights back cdebate va10^america country pro life actually means pro blastula pro embryo pro fetus pro baby.^it white men hiring white men tell stories white men. the women hollywood speak,1,3,2,4,0.25,0.5,0
20745274,BDisgusting,8677,187756,2244,84829,0,0,1,3,your source things horror,two main characters were originally going die stranger things season one including eleven^freeform nights halloween begins tonight full schedule^here schedule freeform annual 13 nights halloween^new twin peaks teaser features first footage revival,1,3,2,4,0.25,0.5,0
18071459,MarkSimoneNY,943,182233,1257,20080,0,3,1,0,radio/tv host heard wor radio monday thru friday am-noon nationally iheart radio seen fox pbs msnbc ny1 podcasts,did paul ryan release campaign ad what he weak part romney ticket^cbs face nation host john dickerson under fire for very softball interview with hillary^funniest segment sunday shows biased partisan host tv brian stelter slan^michelle obama pompous new book says never get donald trump birth certificate comments doe,1,3,2,4,0.25,0.5,0
121489431,CharlesPPierce,3120,174476,3330,80401,0,3,1,0,feed the politics blog charles p. pierce retweets necessarily mean endorsements aging epee hack ringsend cowboy truth odd number,greta vs managed score exclusive tv interview reclusive john mccain unpossible^they used case dismantling part brady bill precedent monday^four people wounded dc one million event we get brady bill good policy t^schiff dennis quaid,1,3,2,4,0.25,0.5,0
21252618,JakeSherman,3204,155001,3229,56953,1,3,0,0,playbook phish/dead fan jake politico dot com author nyt best seller the hill to die on,new york ap federal prosecutors charge nyc subway bomb suspect say wrote facebook trump failed protect nation^dickerson interview trump face nation/cbs this morning^meet press today^the washington nationals lost red sox the sox swept nats home they one game .500,1,3,2,4,0.25,0.5,0
16299627,CBSNewYork,3667,147937,2965,171096,1,1,0,2,your source new york news weather sports traffic /7 streaming cbsn new york,update federal prosecutors charge suspect underground port authority bus terminal bombing say wrote face^photos democratic presidential candidates debate in new hampshire^trick or treat here the most popular halloween candy by state^danielle herrington sports illustrated swimsuit issue cover girl,1,3,2,4,0.25,0.5,0
23820899,WFLA,2344,145704,1522,156176,0,1,1,2,wfla news channel news leader tampa bay,michael bennet democrat colorado wins election u.s. senate electionnight^david cassidy fighting memory loss wants enjoy life^comedian jerry lewis dies age^jeopardy host alex trebek recovering brain surgery blood clots,1,3,2,4,0.25,0.5,0
9609582,theTiser,197,140939,948,136603,0,1,1,2,adelaide news features the advertiser sunday mail facebook subscribe privacy,prime minister scottmorrison set give first major speech foreignpolicy today the hot topic of^sharon osbourne says kim kardashian treats daughter north 'like accessory^prince william prince harry best man upcoming wedding royals^james bond star sir roger moore dead cancer,1,3,2,4,0.25,0.5,0
25374806,GoodDaySac,5372,136901,633,52236,0,2,1,1,good day sacramento unscripted zaniness side news served days week sacramento favorite tv people,abortion rates united states dropped lowest level years according report released^abortion rates united states dropped lowest level years according report released^we 're hard time believing harry styles fashion icon shania twain^reports say kylie jenner is pregnant with first child,1,3,2,4,0.25,0.5,0
66933315,thesherylralph,1200,135280,738,64840,0,2,1,1,divinely inspired victoriously aware actor author producer health/aids activist wife mother influencer,"more ,000 americans killed centers disease control prevention reported thurs^more ,000 americans killed centers disease control prevention reported thurs^meghan markle criticized 'inappropriate shoulder dress queen birthday parade fox news^moesha cast has year reunion the real brandy gets emotional",1,3,2,4,0.25,0.5,0
3141672447,People4Bernie,1451,131875,1312,102743,1,3,0,0,we activists organizers building broad effective movement democratic change welcome political revolution internet mom feelthebern,rt our campaign outperformed every special election country house representatives we bette^bernie sanders begins speech foreign policy saisevents watch^in bronx headed second debate we able live stream debate^dear united states congress pay health insurance pay we want coverage get medicare4all singlepayer,1,3,2,4,0.25,0.5,0
36255721,9NewsQueensland,9535,130204,1131,241173,0,3,1,0,queensland nightly 0pm news simulcast river fm,the son gold coast murder victim read emotional victim impact statement his father killer senten^news reveal south east speed trap made state government almost 5000 hour reigniting th^the broncos one win away spot top four nil thumping titans gold^in service lasting hours performers including faith hill ariana grande jennifer hudson stevie wonder pa,1,3,2,4,0.25,0.5,0
9229732,FOX9,686,128594,1294,90612,0,1,1,2,twin cities news weather,white house vice president joe biden make statement rose garden^tmz kylie jenner pregnant travis scott baby^comedian actor singer jerry lewis dies age^former fox news chairman ceo roger ailes dead,1,3,2,4,0.25,0.5,0
15792387,WorldOfWonder,2455,124808,592,94562,1,0,0,3,creators million dollar listing wow presents plus backyard envy werq world the docu-series much,rt i forever humbled colleagues courage elect first woman speaker house representative^youtube star austin jones arrested child pornography charges via^brendon urie comes out pansexual i just like good people via^the pose trailer it your first look ryan murphy '80s era voguing tv series via,1,3,2,4,0.25,0.5,0
14264854,JohnnyJet,547,120327,3176,72811,1,2,0,1,founder named original travel influencer forbes,cond nast shutting wired gq vogue channels snapchat cutting employees worked the^according centers disease control prevention average american man weighs pounds nearly^according centers disease control prevention average american man weighs pounds nearly^does this photo prove amelia earhart survived her final flight via,1,3,2,4,0.25,0.5,0
14946895,virginianpilot,143,118225,1277,122595,1,2,0,1,breaking news reporting hampton roads virginia since follow reporters editors,currently arriving us capitol enter chamber house representatives^the stickers included images american flags appeared logos republican national committee^philando castile stopped times police was racial profiling^comedian jerry lewis dies age,1,3,2,4,0.25,0.5,0
110685556,RadioClydeNews,1308,105887,488,72111,1,2,0,1,the award-winning clyde news team brings breaking news exclusive stories want hear got story contact clydenews.com,former us president george hw bush died age he served st president united states^stats say strong growth scotland private sector economy last month led steepest monthly rise employment five years^it record broadcast we 'll get transcript soon^love island star sophie gradon dead,1,3,2,4,0.25,0.5,0
35702257,GDLA,11170,93843,943,53027,0,1,1,2,los angeles news weather entertainment official good day la account airing weekday mornings -10am,breaking president trump makes remarks joint republican issues conference philadelphia pa. watch^tmz kyliejenner pregnant travis scott baby^harry potter river cruise set sail summer cost serious cash via^richard simmons hospitalized california monday severe indigestion according tmz,1,3,2,4,0.25,0.5,0
191613738,FoxNewsLive,97,92837,1095,15842,0,0,1,3,original video fox news digital -- streaming on-demand -- covering latest trends entertainment politics technology lifestyle much,check biggest celebrity scandals^sophiegradon 'love island star dead^'superman star margot kidder dead^meghanmarkle admits 'misses suits,1,3,2,4,0.25,0.5,0
14504258,dailycamera,1245,92586,1571,82513,0,3,1,0,the daily camera newspaper boulder colo. covers local news sports lifestyles entertainment business opinion throughout boulder county,ken buck concedes michael bennet wins tight u.s. senate race covote^associate press confirms numbers ken buck leading michael bennet percent vote u.s. senate race^new obama web site confronts rumors mears democrat barack obama campaign said thursday m..^trump warns north korea 'fire fury nuke threat worsens via,1,3,2,4,0.25,0.5,0
22836731,Moneyish,4663,87842,2481,44183,0,2,1,1,this moneyish new way talking money,meet hispanic arab american running congress giving barack obama vibes^one four people considering plastic surgery look younger work^kim kardashian working free another felon^daniel craig confirms play james bond get old job back,1,3,2,4,0.25,0.5,0
274294204,willsommer,3568,87001,1492,13221,0,3,1,0,tech internet reporter i write newsletter conservative media will.sommer,scott pelley gets even outfoxed full minutes cernovich transcript brutal lack preparation.^here full stormy daniels transcript minutes^we live golden age right wing hucksters getting incredibly mad twitter before loomer alex^now gop rep claiming twitter biased twitter suggested one female staffers follow nanc,1,3,2,4,0.25,0.5,0
14089276,TheNewsPress,1191,85333,753,150165,0,1,1,2,reporting news fort myers cape coral sw florida since network breaking news things investigations food arts nature,obama campaign woos hispanics tv radio ads swfl^kevin hart confesses cheating pregnant wife^walmart remove 'cosmopolitan magazine checkout lines amid me too movement^summer phoenix files divorce husband casey affleck,1,3,2,4,0.25,0.5,0
4041824789,RSBNetwork,360,84025,674,12228,1,3,0,0,right side broadcasting network auburn al source live political event coverage rt endorsement ceo,we live facebook president trump address nation florida school shooting^watch live white house holds news briefing wednesday july know fake news con^watch live secretary state mike pompeo holds briefing white house^live white house press briefing g7 summit larry kudlow,1,3,2,4,0.25,0.5,0
362111287,AsteadWesley,1300,82225,1541,39039,1,3,0,0,national politics reporter the new york times cnn political analyst real one streets astead.herndon.com,police find white female bodies freezers black lives matter carved skin wut^my story elizabeth warren foreign policy speech american university latest sign certain^on msnbcs meet the press daily minutes^this disingenuous ridiculous read story fact friend faso note,1,3,2,4,0.25,0.5,0
14707666,MADmagazine,253,78950,802,4497,0,1,1,2,alfred,lawyers admitted trump wrote statement read trump jr. meeting russians trump tower t^taylor swift opened amas spectacular dance number front giant cobra swift said i huge con^alec baldwin believes would win run president he confident voters would choose^internet sensation april giraffe pregnant boy baby comes going neck,1,3,2,4,0.25,0.5,0
18124790,MSignorile,9435,76970,1557,60508,1,3,0,0,host michelangelo signorile show -6 et m-f journalist commentator best-selling author pit bull lover| mike.com,inside fake news sausage factory this is all about income^all media scooping cbs stormy daniels interview basketball went overtime timed^this might beat mooch record trump considers benching giuliani tv interviews is growing incre^great play clips rt will video interview howard dean comments later afternoon,1,3,2,4,0.25,0.5,0
2590835076,NH_India,315,72196,199,30495,1,3,0,0,national herald founded jawaharlal nehru is news website weekly newspaper focus people governance current affairs,us politician nancypelosi spoke little eight hours house representatives oppose b^pm narendra modi wife jashodaben modi eressed surprise video statement mp governor anandiben p^pandemonium marred jammuandkashmir governor n.n vohra opening address joint session assembly th^former us president barack obama criticised president donald trump decision pull united states the,1,3,2,4,0.25,0.5,0
20180101,wbalradio,4160,70822,1007,97135,0,2,1,1,wbal newsradio fm home baltimore ravens maryland station local news talk sports listen,white house vice president joe biden make statement rose garden we bring live happens am^vice president joe biden making statement rose garden listen live^the search new co host started year ago michael strahan left good morning america^richard simmons hospitalized monday rep calls severe indigestion,1,3,2,4,0.25,0.5,0
9601512,KPBSnews,3906,68045,1794,59208,0,2,1,1,we cover politics education health environment border radio 89.5fm tv online,president trump wednesday nominated retiring rep. darell issa head u.s. trade development agency whi^president trump wednesday nominated retiring rep. darell issa head u.s. trade development agency whi^meet mitchell year old atlanta became first african american photographer shoot a^after years getting new voice kermitthefrog,1,3,2,4,0.25,0.5,0
20539531,971AMPRadio,988,65622,754,67717,0,0,1,3,commercial free mondays -971-hits 4487,hooking caller tonight ampair standby boarding see new orleans keep li^congrats the singer announced engaged longtime girlfriend cherry seaborn^nickjonas priyankachopra engaged get full scoop ampradio celebritynews musicnews^amp lead music awards nominations get full list,1,3,2,4,0.25,0.5,0
20624061,springfieldNL,2570,63394,636,75003,0,3,1,0,best source news springfield mo. ozarks for sports follow for opinion follow,in missouri opioid overdose death rates significantly increased according centers for^the centers disease control prevention recommends distilled sterile cooled boiled water us^the centers disease control prevention recommends distilled sterile cooled boiled water us^celebrity blog brad pitt angelina jolie continue divorce talks privately,1,3,2,4,0.25,0.5,0
15771003,abc4utah,4196,62161,1185,124526,0,0,1,3,abc4 news the latest news weather programming information special offers ktvx,channing tatum wife jenna dewan tatum announce split^matt damon apologizes comments sexual misconduct^after years kermit frog getting new voice^announces new album reputation,1,3,2,4,0.25,0.5,0
20816085,KSEE24,1092,61603,501,103179,0,1,1,2,local news that matters,the centers disease control prevention says popular kellogg cereal linked salmonella outb^caitlyn jenner latest celebrity float run political office age president donald trump^former rep. anthony weiner sentenced monday months prison sexting minor^after years kermit frog getting new voice,1,3,2,4,0.25,0.5,0
12193342,rachelsklar,9352,60707,2686,113732,0,3,1,0,call congress 202 -3121 familiesbelongtogether believewomen,i 'm reliable sources twinsies rt on way cbs tape interview face nation bob schieffer^i new hampshire went debate hillary huckabee giuliani random events ... talked plenty^i remember going sad empty giuliani rally new hampshire there nothing cover^holla i get sick people trying create fights feuds women business do n't buy,1,3,2,4,0.25,0.5,0
95091601,PatsKarvelas,6433,60449,811,95224,0,3,1,0,presenter weekdays pm tv pm afternoonbriefing thepartyroom podcast host thefridayfix pm tv overbearing mother,my exclusive interview pm co chair advisory council andrea mason ahead week meeting^tonight pm est tv interview noel pearson ahead lowitja oration week way^yes watch nationalwrap tv pm tomorrow night the excellent hosting week auspol^i 'm back tv :15pm pm aest special leadership special radio auspol,1,3,2,4,0.25,0.5,0
28279637,dabeard,6747,53035,1956,77771,1,3,0,0,writer editor newsletterer strategist audience specialist priors say hey beardwrites.com love uplifting stories,it still early america already set new record number women running seats us hou^anderson cooper the president watches minutes watching tonight would say stormy dani^stormy and i like 'someone take magazine spank it. ... i n't think anyone ever^he chef changed dining scene los angeles. rip pulitzer wining food critic jonath,1,3,2,4,0.25,0.5,0
2249531,AndrewFeinberg,4545,49797,592,34444,1,3,0,0,i write stuff happening white house etc breakfast media elsewhere dm signal firstname firstnamelastname dot com retweets endorse,i call bullshit jeff sessions recused law doj rules codified code federal regulat^thread this conducts foreign policy perceived allies even despots suppress human r^i call bullshit jeff sessions recused law doj rules codified code federal regulat^surprise surprise tomorrow schedule daily press briefing we four,1,3,2,4,0.25,0.5,0
170439199,loverugbyleague,1325,45881,223,67943,0,3,1,0,leading rugbyleague website including exclusive news features interviews live scores stats fantasy rl download app ios/android,wigan released statement recent video went viral sam tomkins joel tomkins thoughts^wigan released statement recent video went viral sam tomkins joel tomkins rugbyleague^wigan released statement recent video went viral sam tomkins joel tomkins thoughts^have your say england face australia rugby league world cup final saturday think wil,1,3,2,4,0.25,0.5,0
2891898418,BritLGBTAwards,7731,45225,385,10901,0,0,1,3,celebrating individuals organisations outstanding commitment lgbt+ community,happy birthday phenomenal actress also wonderful lgbt+ ally well w^sam smith on gender identity i feel just as much woman as i am man^sam smith on gender identity i feel just as much woman as i am man^sam smith on gender identity i feel just as much woman as i am man,1,3,2,4,0.25,0.5,0
817976607398731776,ani_digital,0,44882,197,20924,0,3,1,0,asian news international.multi-media news agency content information platforms tv internet broadband newspapers mobiles,pakistan tehreek e insaf chairman pakistan prime minister waiting imran khan laid roadmap co^india vietnam signed four agreements one spheres communications foreign affairs academics an^four criminals killed one injured ongoing encounter special cell delhi police rajesh b^brad pitt currently engaged custody battle former wife angelina jolie spent father day wi,1,3,2,4,0.25,0.5,0
36726529,sbsun,308,42845,590,114044,0,0,1,3,local news matters we san bernardino county local news source localnewsmatters,what pentagon papers spielberg the post^neil diamond retires touring diagnosis parkinson disease^brady bunch house closes sale 3.5 million almost twice asking price^eminem beyonce weeknd headline coachella valley music arts festival,1,3,2,4,0.25,0.5,0
514513113,CNBCMakeIt,256,41961,727,48170,0,3,1,0,get smarter earn save spend money latest cnbc make it,the us department education awards 120 billion students every year here ways get financial^the us department education awards 120 billion students every year here ways get financial^the us department education awards 120 billion students every year here ways get financial^here many americans watched royal wedding prince harry meghan markle,1,3,2,4,0.25,0.5,0
20445524,KPLC7News,611,41673,423,95652,0,1,1,2,your reliable source news southwest louisiana catch us on-air online one free mobile apps,congratulations t.s cooley named blue ribbon school us department education^katie couric matt lauer today co host several years broke silence saturday sexual miscondu^koko gorilla knew sign language dies gt gt^legendary comedian don rickles dies age,1,3,2,4,0.25,0.5,0
15533253,CoMissourian,6375,39281,943,49509,1,3,0,0,mid-missouri finest news source email news.com call -882-5714 sports,the sentinel daily mail greitens said accuser admits photo session may dream politi^should schools allow student reported sexual assault cross examined alleged perpetrato^the past echos sunday presidential debate washu voters consider race law democratic representation^today front page sanborn field celebrates th birthday racers take missouri river tru,1,3,2,4,0.25,0.5,0
20687912,WLNS,777,37239,511,34987,0,3,1,0,the official twitter account channel hereforyou,president donald trump asked republican national committee chairwoman ronna mcdaniel serve second term^hosting thanksgiving year the u.s. department agriculture tips prepare safe thanksgiv^studies show one four pregnancies end miscarriage so light pregnancy infant loss awareness mo^another royal baby way buckingham palace now prince harry meghan markle eecting springtime,1,3,2,4,0.25,0.5,0
16785032,WMAR2News,1229,36677,972,153614,0,2,1,1,wmar-2 news maryland source online video news weather wmar-tv make sure watch marylandsmostaccurate weather team,city school officials release new statement viral video teacher punched student more details^fact checking democratic presidential candidate debate new hampshire^caitlyn jenner latest celebrity float run office^'game thrones stars kit harington rose leslie married,1,3,2,4,0.25,0.5,0
7027112,morten,12814,36486,558,33381,1,3,0,0,founder automagi sos pro editor publisher online media cnn vg dagbladet desk since journalist heart,rt shorter paul ryan i 'm humble country speaker of the us house of representatives https^the heat turned republicans return donations las vegas mogul nation co^bob woodward wrote president donald trump reportedly lied contradicted burst i^steve wynn resigned position finance chairman republican national committee amid,1,3,2,4,0.25,0.5,0
46185434,Araksya,822,36055,363,60444,0,3,1,0,kttv- fox wake early join l not morning person i play one tv,"romaine safe eat long lettuce central ca fda centers disease control prevent^romaine safe eat long lettuce central ca fda centers disease control prevent^jennie o turkey recalling ,000 pounds raw turkey ongoing salmonella outbreak the recall i^the chair california democratic party set social media spark urging people boycott in n out e",1,3,2,4,0.25,0.5,0
19655729,TelegraphFilm,1992,35145,982,21647,0,0,1,3,all things film our critics obey,charlie hunnam robert pattinson barely spoke making the lost city z^robert pattinson nearly fired twilight smiling enough^jennifer lawrence darren aronofsky split^golden globes live seth meyers prepares host awards,1,3,2,4,0.25,0.5,0
19084128,TeamRickPerry,7844,34749,1293,9648,1,3,0,0,staff account republican governor texas jan. jan. visit learn,reminds texas republicans vote sid miller ag commish early voting begins tomorrow tx2014^rt fed up our fight save america washington rick perry fed up via^rt book fed up our fight save america washington rick perry hachette audio^fed up our fight save america washington rick perry get book today,1,3,2,4,0.25,0.5,0
23125412,JamesPMorrison,2720,32270,780,20780,1,3,0,0,adorably antagonistic possibilist pointing potholes road happy destiny father/actor/teacher/songster/playwright/filmmaker/egalitarian,sorry spoil fun kids captain america called captain usa the americas america wakeupamerica^remembering republican cries civility sounded like someone shouting you lie president th^milano many comments indicate need refresher a say^at today press briefing reporter any comment president claim canada burned white house,1,3,2,4,0.25,0.5,0
202216517,UNHCRUSA,5874,28403,474,24851,0,3,1,0,the official account unhcr un agency united states caribbean withrefugees,thank city chula vista california mayor mary casillas salas signing the^thank south orange new jersey village president signing withrefugees statement o^thank montgomery county maryland county executive ike leggett signing withrefugees statement o^violent gangs threatening lives people central america thank ben stiller shari,1,3,2,4,0.25,0.5,0
300497193,tackettdc,1654,25408,944,52538,1,3,0,0,deputy bureau chief associated press,sessions said recused rules code federal regulations personal political relationship^french president spoke critically host foreign policy trade environmental decisions sp^key moments trump interview fox friends with fact checks via^mr. trudeau stabbed us back mr. kudlow said making statement president already agr,1,3,2,4,0.25,0.5,0
15446773,cronkitenews,2296,24136,864,34978,1,3,0,0,the news division covering arizona news find anywhere else watch weeknights operated asu,a number bills proposed arizona house representatives address issue wrong way driving.^we talk blatant discrimination said jackson brossy executive director navaj^only minutes catch interview john fer former pow cell mate^catch exclusive interview john fer cell mate pow vietnam tonight pm on,1,3,2,4,0.25,0.5,0
39352227,NZMorningReport,2066,24048,311,29761,1,2,0,1,susie ferguson corin dann authoritative comprehensive coverage local world events morning radio nz mon-fri am-9am rnz,m rena ko te r pare t nei r trump claims victory republicans lose control us house representatives nz^john mccain 'extremely influential capitol hill interview^john mccain 'extremely influential capitol hill interview^weinstein company file bankruptcy,1,3,2,4,0.25,0.5,0
76611108,nahaltoosi,1231,22822,770,20101,1,3,0,0,foreign affairs reporter politico she one back down. -- `` take long run short pier utter hack '' -- sebastian gorka,the u.s. house representatives overwhelmingly declares rohingya victims genocide myanmar.^elizabeth warren endorses first use policy nuclear weapons first major foreign policy speech ahead^elizabeth warren gives first big foreign policy speech ahead likely presidential run i got prepa^today speech foreign policy we continue centuries old mission defendi,1,3,2,4,0.25,0.5,0
17221207,CBS47,1283,22812,481,106130,0,1,1,2,eyewitness news,the centers disease control prevention says popular kellogg cereal linked salmonella outb^caitlyn jenner latest celebrity float run political office age president donald trump^former rep. anthony weiner sentenced monday months prison sexting minor^after years kermit frog getting new voice,1,3,2,4,0.25,0.5,0
21771008,1041JackFM,149,22007,160,24872,0,1,1,2,playing want jackaroundmn,icymi philando castile had been stopped times by mn police^john mayer hospitalized early tuesday morning emergency appendectomy^justin timberlake announces 'the man of the woods tour^holiday shopping hard maybe even harder blow discovering significant other/friend/whomeve,1,3,2,4,0.25,0.5,0
3061899414,gayety,31,20847,207,24620,0,0,1,3,a digital magazine gay bisexual queer trans men follow everywhere,caitlyn jenner considering bid us senate california via gay lgbt^rent will be fox next live tv musical event via gay lgbt^rupaul drag race all stars season crowns its winner via gay lgbt^hilarious golden girls parody stars trump putin pence kim jong ... via,1,3,2,4,0.25,0.5,0
10696392,FutureBoy,4097,20491,903,31498,0,3,1,0,elainer editor op-ed maker author how star wars conquered universe future-curious mind heart dms open,he candidate^called wants fact free talking point back^because lost million votes^his impeachment trial ultimate celebrity apprentice new counsel fired every week,1,3,2,4,0.25,0.5,0
6332292,ethanklapper,5458,18909,1180,74997,1,3,0,0,journalist licensed aircraft dispatcher m.s aeronautics candidate avgeek,"today federal register pages long i think trump meant say code federal regulations ,000 pages long^rt how michael bennet u.s. senate race colorado ken buck^rt flashback barack obama purges campaign web site critique surge iraq^cam tomorro press secretary robert gibbs convene camera gaggle brady press briefing room :30am",1,3,2,4,0.25,0.5,0
15423869,franklinavenue,815,18487,954,29300,0,0,1,3,senior editor screengrab host organizer former executive editor chief content officer da kine,katie couric admits she felt borderline bullied into having to make a statement matt lauer today exit^modernfamily renewed abc sixth season^we first title crisis next season fx ordered mrinbetween half hour drama starring scott ryan s^when fans get vote always get right giuliana rancic people choice awards coming e upfronts,1,3,2,4,0.25,0.5,0
153747564,RTE_Ents,2056,18241,224,30912,0,0,1,3,all things entertainment rt latest news reviews interviews listings elore,channing tatum jenna dewan announce separation^congratulations order irish starz actress confirmed engaged^diva las vegas lady gaga announces two year residency lasvegasgoesgaga^she baaaaaaaaaaack announces new album reputation taylorswift,1,3,2,4,0.25,0.5,0
15312292,WFRVLocal5,2848,18162,584,83345,0,1,1,2,official account wfrv cbs local a netar station serving northeastern wisconsin tweets retweets favorites intended endorsements,hosting thanksgiving year the u.s. department agriculture tips prepare safe thanksgiv^caitlyn jenner latest celebrity float run office^after years kermit frog getting new voice^breaking troy gentry montgomery gentry killed helicopter crash,1,3,2,4,0.25,0.5,0
163633469,presstelegram,614,18062,475,91724,0,0,1,3,local news matters we cover greater long beach area localnewsmatters,what pentagon papers spielberg the post^neil diamond retires touring diagnosis parkinson disease^brady bunch house closes sale 3.5 million almost twice asking price^eminem beyonce weeknd headline coachella valley music arts festival,1,3,2,4,0.25,0.5,0
23513177,power97wpg,8724,17297,215,41330,0,0,1,3,/ - : - :,icymi here complete list teen choice awards winners^icymi here complete list teen choice awards winners^if 've following jim carrey wrongful death lawsuit dismissed^you 'll find couch tonight twinpeaks returns everything you need to know,1,3,2,4,0.25,0.5,0
288993240,kmfmnews,841,16930,183,88335,0,3,1,0,the latest kent headlines kmfm news team on air am-6pm weekdays including the update pm am-1pm weekends email us news.co.uk,news murder investigation continuing man died hospital found injured gravesend^news less one four rape cases brought court kent police end conviction according new fi^from earlier less one four rape cases brought court kent police end conviction according t^showbiz royals leading way comes best dressed famous names britain queen the,1,3,2,4,0.25,0.5,0
19734918,AM900CHML,2101,16922,367,89206,0,2,1,1,hamilton news traffic weather talk radio listen online,the roy green show bonus interview reaction canadian federation independant business ontario fa^coming up show debate around video interaction cnn reporter whi^here complete list nominees golden globes who rooting^celine dion poses naked vogue magazine,1,3,2,4,0.25,0.5,0
19118915,1059thex,402,16267,189,64897,0,0,1,3,pittsburgh rock alternative your radio home pittsburgh penguins,fans react u2 cancels st. louis concert amid police protests^here how help victims las vegas mass shooting^neil diamond retires from touring after parkinson disease diagnosis^hugh hefner cause death has been revealed,1,3,2,4,0.25,0.5,0
21328006,Davidlaz,1314,15617,616,98604,0,2,1,1,consumer columnist los angeles times ktla-tv channel part-time radio host i get kicks waistline sunshine,pittsburgh gunman yelled 'all jews must die state union^pittsburgh gunman yelled 'all jews must die state union^oh thank god 'kylie jenner will return spotlight after giving birth source says^i wo n't commenting reports kylie jenner pregnant please respect privacy,1,3,2,4,0.25,0.5,0
2533104750,TexasStandard,1275,14987,423,28633,1,3,0,0,you texas standard time we production austin north texas san antonio houston,now texas rangers investigating sid miller taayer financed trip oklahoma jesus shot^the league conservation voters environmental advocacy group tracked congressional members votes env^nearly two million households texas considered food insecure us department agriculture^did state cuts in women health spending lead to closure of one in four family planning clinics,1,3,2,4,0.25,0.5,0
26185970,Ninecomau,335,14412,216,101901,1,0,0,3,australia largest news entertainment network,it massive night female candidates a record number women projected win seats us hous^comedian jerry lewis dies age news^swedish crown princess victoria allegedly groped french photographer jean claude arnault news^royal wedding meghan markle father walk aisle days meeting prince harry news,1,3,2,4,0.25,0.5,0
20627332,KHQA,1194,13356,390,78625,1,3,0,0,connecting tri-states news coverage email us news7.com quincy hannibal keokuk illinois missouri iowa retweets endorsements,junius rodriguez stopped studio interview ahead election democratic candidate^teachers each week feature new local classroom reciting pledge allegiance if classroom would li^the number confirmed cases polio like illness affecting mostly children continues rise centers f^the number confirmed cases polio like illness affecting mostly children continues rise centers f,1,3,2,4,0.25,0.5,0
19955763,Q1043,473,13131,236,44559,0,2,1,1,we new york classic rock q1043 home jim kerr show,this day rock cream started four week run number one album chart 'wheels fire '^this day rock bruce springsteen started four week run number one album chart 'born usa'^celebrities react trump withdraws steph curry white house invitation^neil diamond retires from touring after parkinson disease diagnosis,1,3,2,4,0.25,0.5,0
24963237,Matt_Kiser,1582,12613,447,23052,0,3,1,0,making go along past product stuff,nbc fox news pull trump campaign racist ad 'sunday night football backlash via^i think european union foe trump says ahead putin meeting helsinki via^the vanishing white house press briefing via^inside melania trump complicated white house life separate schedule different priorities via,1,3,2,4,0.25,0.5,0
1375870375,CoffeeWthKenobi,762,11820,289,66185,0,0,1,3,cwk place star wars discussion analysis rhetoric guests elore mythology star wars place intelligence humor,remembering carrie fisher would nd birthday always hearts ... starwars^what starring star wars the last jedi means kelly marie tran^billie lourd inherit mom carrie fisher estate^kyle newman offers direct star wars han solo movie for free,1,3,2,4,0.25,0.5,0
193622721,NewsRepublic,548,10371,294,15956,0,0,1,3,download news republic ios google play best-rated news app across stores,president donald trump first lady melania keep separate bedrooms 'they never spend night together^ryan seacrest kelly ripa new co host 'live people n't happy^the beyhive high alert speculation beyonce gone labor^richard simmons hospitalized time severe indigestion,1,3,2,4,0.25,0.5,0
16046443,jessemckinley,4361,10312,437,10443,0,3,1,0,albany bureau chief ny times sf bureau chief culture features clerkdom tips comments complaints jemcki.com -556-4181,poll whose speech longer convention nominee second half^at convention i 'm betting speech due around going lot referenc^this first convention speech gubernatorial election year he voted speaker res^if name recognition i hoping brad pitt angelina jolie billy joel get in,1,3,2,4,0.25,0.5,0
15096096,LisaMirandoCNN,4474,9660,235,42603,1,3,0,0,facts first rt endorsements the press not enemy a,president george h.w bush buried college station texas next late wife barbara died earlier^huckabee sanders i 've called lot names show referring morningjoe trump tweeted insult host mika^whca no white house briefing today^pm et white house press briefing cnn live,1,3,2,4,0.25,0.5,0
15426586,q95,1995,9647,125,28425,0,0,1,3,indy classic rock home the show listen fm iheartradio q95rocks,fans react u2 cancels st. louis concert amid police protests^here how help victims las vegas mass shooting^neil diamond retires from touring after parkinson disease diagnosis^hugh hefner cause death has been revealed,1,3,2,4,0.25,0.5,0
54683181,Bob_Grip,1871,9542,191,53259,1,2,0,1,second appearance movie fair game longtime anchor osu grad al b casters hall fame natas silver circle inductee,melania trump undergoes kidney surgery walter reed medical center^calls members u.s. senate including senator doug jones vote 'yes confirming judge ka^criminal inquiry sought hillary clinton use email via^tavis smiley sues pbs firing sexual misconduct allegations,1,3,2,4,0.25,0.5,0
15873811,marcela_elisa,1976,9422,324,65370,0,2,1,1,editorial writer columnist editorial board member born raised biling e marcela.garcia.com,the great alan wirzbicki writes one time unprepared interview lovely mccain tribute^the great alan wirzbicki writes one time unprepared interview lovely mccain tribute^meet celebrity divorce lawyer helping angelina jolie split brad pitt brangelina via^oh my lord barbra streisand had her beloved dog samantha cloned meet miss scarlett miss violet via,1,3,2,4,0.25,0.5,0
48791466,RedlandsNews,216,9236,197,93804,0,0,1,3,local news matters your source redlands local news localnewsmatters,what pentagon papers spielberg the post^neil diamond retires touring diagnosis parkinson disease^brady bunch house closes sale 3.5 million almost twice asking price^eminem beyonce weeknd headline coachella valley music arts festival,1,3,2,4,0.25,0.5,0
2978291435,HSBCgop,1917,8815,312,4178,1,3,0,0,we committee house representatives fighting behalf america entrepreneurs innovators chaired,did know read code federal regulations average speed would take nearly years h/t^we 're tired keeping secret chairman weekly republican address^hearing delayed french president address joint session congress comple^did know read code federal regulations average speed would take nearly years h/t,1,3,2,4,0.25,0.5,0
22588009,AndreaNRuth,583,8808,208,70571,0,3,1,0,associate editor pro-life i talk good bad ideas pnw nova,how late sarah sanders the p.m. press briefing finally started gt gt watch white house holds first press b^watch white house holds first press briefing two weeks livestream^exactly done four seasons comedians cars getting coffee without one it ... bizarre^ashlee simpson underappreciated she manufactured garbage mimicking avril lavigne the reason wa,1,3,2,4,0.25,0.5,0
425238594,HuffPostCaStyle,1089,8681,146,37685,0,0,1,3,covering things trending celebrity fashion beauty,paris fashion week attendees blame kim kardashian robbery^meghan markle brings blue jays pride pippa middleton wedding^the beauty essentials absolutely need festival season coachellatime^the beauty essentials absolutely need survive music festival season,1,3,2,4,0.25,0.5,0
115449038,VPCinfo,1266,8528,286,9157,1,3,0,0,the violence policy center vpc national educational organization working reduce gun death injury,a fake photo emma gonz lez went viral far right parkland teens villains via^house republican appropriators wednesday rejected proposal designate millions dollars centers for^so far year chicago fewer shooting victims period police said via^one person killed four others injured shooting downtown denver monday afternoon according,1,3,2,4,0.25,0.5,0
309099691,NYSFILM,781,7275,253,28323,0,3,1,0,growing film tv commercial production related industries new york state,filmmakers early bird rates offered submissions go f^getting ready dominicanfilmfest newyork july filmindustryeventinny^words wisdom cbs fridays filmedinny great ny economy nyspend and^filmedinny woodyallen untitled feature stars ellefanning,1,3,2,4,0.25,0.5,0
14357989,ItsDavidFord,2144,7199,153,25915,0,3,1,0,coffee addicted dog loving pop culture obsessed news media junkie ... chief comms officer prev ... normal gets you nowhere,the political tv ad archive making easier journalists report campaign spots^the transcript stormy daniels describes alleged affair donald trump ...^sen. john mccain praises ambassador killed libya refuses criticize obama interview^in wake cancellation megyn kelly today savannah guthrie hoda kotb al roker craig melvin e,1,3,2,4,0.25,0.5,0
9843332,AaronPena,4921,6568,316,28619,1,3,0,0,social media enthusiast fmr state representative gentleman day philosopher night ... rebel fate,floyd mayweather jr. donates whopping sum money houston hurricane^rt rick perry says switched gop younger age reagan true tcot rgv txlege^a comprehensive investigation voter impersonation finds credible incidents one billion ballots cast^at trump hotel site immigrant workers wary,1,3,2,4,0.25,0.5,0
24495618,SharSaysSo,1083,5856,120,191566,0,2,1,1,pop culture pundit freelance journalist podcast host i run living i never forgive pappadeaux location la sharsaysso,romaine lettuce unsafe eat form centers disease control prevention said today broad^romaine lettuce unsafe eat form centers disease control prevention said today broad^do notice people treat respond dressed clean cut rupaul stedman graham katradio^kylie jenner gives birth first child with travis scott via,1,3,2,4,0.25,0.5,0
1496219797,HiddenRemote,1157,5579,158,33890,0,0,1,3,a tv movie entertainment site,rachel bilson eddie cibrian star abc taketwo unlikely detective duo although could use wor^girls series finale preview how will hannah story end more^netflix gave us best tvshows movies year also broke hearts several times h^reasonswhy renewed season now timothy granaderos shares hopes see monty horr,1,3,2,4,0.25,0.5,0
19617087,KKCO11News,275,5428,281,42193,1,2,0,1,kkco news know,new ap federal prosecutors charge nyc subway bomb suspect say wrote facebook trump failed protect nation^trumpingj trump campaign hoping rally supporters ahead wednesday debate las vegas gt gt^exclusive matt lauer sits fmr president george w. bush first interview since left office ...^ap police say golf great tiger woods arrested dui charge florida,1,3,2,4,0.25,0.5,0
14676527,The_Citizen,633,5136,190,87160,0,3,1,0,a daily newspaper auburn new york cayuga county number one news source news tips citizennews.net,rep. john katko weekly republican address new visa waiver rules must enforced^what popular baby names state year born^chicago police multiple victims reported shooting hospital^mlb predictions who come top,1,3,2,4,0.25,0.5,0
4157736555,vergepop,16,4676,137,12260,0,0,1,3,covers music films shows games worth watching,the complete list grammy award winners^louis ck accused sexual misconduct five women^the weinstein company plans file bankruptcy^oscars complete list award winners,1,3,2,4,0.25,0.5,0
16246426,mcgintyman,719,4418,134,11852,0,3,1,0,former anchor news current rider bikes player bass,almost decades ago i interview i shared tv make room dropped^almost decades ago i interview i shared tv make room dropped^yielding time colleague sarah sanders tried cut white house briefing^the secret donald trump rudy giuliani know russia probe frightening likely true,1,3,2,4,0.25,0.5,0
571524686,TomDeesFOX13,2274,4374,82,18748,0,1,1,2,multiple emmy award winning journalist mississippi state graduate blackbelt guitar player slidell high tiger louisiana aaaa cross country champion,cohen responds president trump address joint session congress^richard simmons sues radaronline national enquirer protect privacy^photos miss north dakota cara mund crowned miss america^meghan markle dad heart surgery wo n't attend royal wedding report says,1,3,2,4,0.25,0.5,0
27273353,shansquared,2542,4324,193,12512,1,3,0,0,newsletters swang.com previously bacon beets battlestar galactica,it always jarring see news operations spectrum left news site calle^the political tv ad archive making easier journalists report campaign spots^the political tv ad archive making easier journalists report campaign spots^the political tv ad archive making easier journalists report campaign spots,1,3,2,4,0.25,0.5,0
720710699283046400,healybaum,1675,4161,75,10167,1,3,0,0,tv analyst|international adviser energy consultant|trump giuliani white house senior comms vet|media+market influencer|borntowin,floyd mayweather jr. donates whopping sum money houston hurricane houston news^u.s. liquefied natural gas ert capacity double end today energy u.s. energy i^u.s. liquefied natural gas ert capacity double end today energy u.s. energy i^u.s. liquefied natural gas ert capacity double end today energy u.s. energy i,1,3,2,4,0.25,0.5,0
3001431934,CapitalNWNews,4798,3973,38,18328,0,2,1,1,the news team tweet us stories e-mail northwest.news.com,people questioned murder man bolton the victim thirties assaulted aft^greater manchester police investigating separate murders manchester a man died collyhurst^david beckham n't going prosecuted speeding fine got london lawyer fought allega^there tribute sophie gradon last night episode love island found dead age of,1,3,2,4,0.25,0.5,0
36246939,malbertnews,115,3956,296,42143,1,3,0,0,chief national investigative correspondent peabody award winner former mail docs th st nw dc malbert.com,latest george hw bush st president united states died statement office announced de^sen. shaheen tells senators targeted widespread hacking attempts rpts^more when asked identify biggest foe globally right pres trump told european unio^sources tell four people dead shooting annapolis police release number public,1,3,2,4,0.25,0.5,0
364481118,poet_economist,3738,3874,228,35587,1,3,0,0,global strategy lead strategist founder opinions analysis,donald trump full blown melt losing house representatives yesterday year^on says see connection btw investigation kremlin operatives effor^on says seen first hand intense cruelty trump child internment camps^reading lincoln house divided speech republican convention illinois the future president mak,1,3,2,4,0.25,0.5,0
142134564,Laura_Figueroa,2548,3549,170,20700,0,3,1,0,white house correspondent new mom.mrs hernandez proud alum like run always living big apple dreams,as trump tweets morning rep. trey gowdy noteworthy read gowdy interview fox news last night gt gt^full statement trumpputinsummit says indefensible president suggest mor^fantastic people trump whispers parents slain brentwood teens kayla cuevas nisa mickens enters ro^cuomo possible guv run cynthia nin but name recognition i hoping brad pitt a,1,3,2,4,0.25,0.5,0
23596654,JeffMartinMedia,4641,3425,123,18370,0,0,1,3,morning show co-host foodie mc/vo artist former cruisedirector,sharon amp ozzy osbourne split after years of marriage amidst cheating reports via^walmart remove 'cosmopolitan magazine checkout lines amid me too movement via^chip joanna gaines welcome baby no^the bachelorette finale who did rachel lindsay choose the winner miami chiropractor,1,3,2,4,0.25,0.5,0
14576889,760kfmb,677,2936,173,34216,1,1,0,2,at am760 approach day mission provide accurate information presented insightful interesting way a tegna station,mark larson spoke ed meese former us attorney general pres reagan discussed charges aga^fresh making rounds weekend political shows including meet press sam nunberg former adviso^tiger woods arrested florida dui charge released gt gt gt^miles teller reportedly arrested san diego drunk public,1,3,2,4,0.25,0.5,0
182880523,overheardpbs,1120,2928,97,5149,0,3,1,0,overheard evan smith produced hosted aired stations great interviews always news always sense humor,take look back texas monthly talks interview senator john mccain talks running pot^take look back texas monthly talks interview senator john mccain talks running pot^talks working white house book the briefing^he walks around streets new york says people come full thanks anythi,1,3,2,4,0.25,0.5,0
331105296,sbustosFL,91,2457,198,16741,1,3,0,0,sun sentinel deputy opinion editor email sbustos.com,former presidents walk fine line trump america^highlights trump address joint session congress^transcript former president obama speech blasting president trump via^transcript former president obama speech blasting president trump via,1,3,2,4,0.25,0.5,0
3115443364,Local24Brad,1375,2084,79,34538,0,3,1,0,local news cw news reporter,and also remember state the union president bush took time turn speaker pelosi con^and also remember state the union president bush took time turn speaker pelosi con^today appeared responding release public hanging comment those co^former memphis mayor willie herenton this fake news the russians involved this involves high rank,1,3,2,4,0.25,0.5,0
1560879775,AllThingsCBS47,278,1992,120,19700,0,1,1,2,jax news weather sports community cbs programming plus little behind scenes ... get,chicago mercy hospital shooting what know victims^prince harry meghan markle a relationship timeline^labor day deals sales macy walmart best buy^ving rhames says police held gunpoint home neighbor reported burglary,1,3,2,4,0.25,0.5,0
27130640,CarlosCorrea2,1125,1819,92,11654,0,1,1,2,emmy nominee || || raised chicago || tv reporter ia mo nm ca || now digital reporter social media manager || insta carloscorreatv,after interviews today producers hire jenna hager daughter president george w.bush contributor calling natural^no joke you 're gon na get trouble samsmith oscars^abc 'modern family renewed third season^american idol renewed second season abc,1,3,2,4,0.25,0.5,0
24038596,ShaunWDSU,296,1293,25,3617,0,0,1,3,emmy-nominated anchor affiliate new orleans uber rating 3,channing tatum wife jenna dewan tatum announce split^'superman star margot kidder dead^ed sheeran made his game thrones debut internet had a lot thoughts^matt lauer reacts hoda kotb replacing him today,1,3,2,4,0.25,0.5,0
15841273,coryheikkila,421,707,38,34165,1,3,0,0,some things make sense like aliens four-wheel drive then things t. like muscles superheroes,controversial texas ag commish sid miller reportedly eyed trump cabinet post^utsa issues statement controversial video cops escorting student class^big quotes former president george w. bush today show interview^uniform crime reports san antonio,1,3,2,4,0.25,0.5,0
45461766,MYXphilippines,872,6490718,4080,106487,0,0,3,1,your choice your music the official twitter account music channel philippines,look did secretly get married^look are dating^listen shuts dating rumors^look photographed first time months,3,1,-2,4,0.75,-0.5,1
8841372,SAI,67,1284555,15394,163711,3,0,0,1,the latest tech news,snapchat shutting lens store months focus ad business^snapchat shutting lens store months focusing ad business^leonardo dicaprio says signed elon musk trip mars^ellen page accuses brett ratner 'blatantly homophobic abusive behavior,3,1,-2,4,0.75,-0.5,1
6107422,thetimes,770,1267452,10572,198820,0,0,3,1,the best journalism subscribe speak customer service team,their fans include prince harry duchess cambridge^david beckham prosecuted speeding charge celebrity lawyer dubbed mr loophole success^david beckham faces trial speeding allegation^kylie jenner tweet snapchat followed petition signed million people complaining redesign,3,1,-2,4,0.75,-0.5,1
14663955,CMT,12190,1262056,4253,103324,0,0,3,1,sat/sun a/8c,this moment waiting watch cmt drinkonit tribute no^tearing introduction mentor cmtawards want cuteness st^if 're keeping kardashians 'll fill little fact ... first love is^things never knew parenttrap gt catch tonight /5c,3,1,-2,4,0.75,-0.5,1
36065771,cntraveller,80,713235,5929,70026,0,0,3,1,travel inspiration editors cond nast traveller uk,the best photo locations london capturing city famous views tower bridge big ben pl^hungry these best restaurants london tacos freshly made pasta helpfully divided lo^the third series take us seventies meaning safari suits round dubious concept prince^prince harry meghan markle delayed honeymoon we discuss pros cons,3,1,-2,4,0.75,-0.5,1
42389136,TheRevAl,245,586575,5451,28953,2,1,1,0,baptist minister political civil rights social justice activist,the honorable jim clyburn us house representatives sc amp assistant democratic leader join^join the honorable cedric richmond us house representatives la delivers plenary thursday april^doing us syndicated radio show riding london england oxford i discussing bogus legal prem^talking comedian/actress finishing radio show rock,3,1,-2,4,0.75,-0.5,1
23798922,SELFmagazine,1998,508618,5814,104979,0,0,3,1,wellness trust teamself,angelina jolie i enjoy single it something i wanted^angelina jolie i enjoy single it something i wanted^angelina jolie i enjoy single it something i wanted^holiday gift idea hostess mostest rvtips cute kitchen towels ltd,3,1,-2,4,0.75,-0.5,1
335891957,FirstpostSports,783,438856,636,185077,0,1,3,0,bringing live updates breaking news opinions photos world sport,four pant beginning free arms we minutes away lunch let see australia ta^there quite familiar faces attendance tonight arthurashe for^there quite familiar faces attendance tonight arthurashe for^davidbeckham escaped prosecution speeding charge thursday football icon lawyer nicknamed m,3,1,-2,4,0.75,-0.5,1
138387125,TelegraphSport,873,234591,2680,171180,0,1,3,0,breaking news live coverage sport team,rory mcilroy safely clubhouse four one behind theopen^monaco grand prix predict podium who come top monte carlo^canadian grand prix predict podium who come top montreal^azerbaijan grand prix predict podium who come top baku,3,1,-2,4,0.75,-0.5,1
2969760609,POLITICOEurope,396,223127,4548,51948,2,1,1,0,politics policy power,former presidents walk fine line trump america^former presidents walk fine line trump america^former democratic presidential candidate hillary clinton skin crawled trump looming behavior debate^the british government worried trump may feel snubbed barack michelle obama invited prince harry s,3,1,-2,4,0.75,-0.5,1
21258217,GlobalEdmonton,414,209014,1309,175955,1,1,2,0,our city our news,texas official sid miller uses c word hillary clinton twitter^watch live hillary clinton addresses supporters campaign rally las vegas^here complete list nominees golden globes who rooting^jenner n't reveal final surgery last page,3,1,-2,4,0.75,-0.5,1
46671396,ProSyn,1894,187531,5338,74655,3,1,0,0,the world opinion page featuring exclusive commentaries leading thinkers statesmen policymakers practitioners activists,now retaken control us house representatives focus party agenda trum^to retake control us house representatives need address voters economic concerns^how democrats use takeover us house representatives influence trump foreign policy^the us department agriculture estimates cost raising middle class us child age 233,3,1,-2,4,0.75,-0.5,1
23459837,m_magazine,1249,152358,672,29850,0,0,3,1,m magazine source favorite celebs fun stuff advice diy projects,here real reason missed performance ... hint^the transformation went years blow your mind yearsofwowp gt gt^here full guide selena gomez demi lovato friendship years gt gt^here proof selena gomez amp taylor swift friendship stronger ever gt gt,3,1,-2,4,0.75,-0.5,1
16534576,chronicleherald,850,123442,1370,144213,0,0,3,1,the biggest best news site atlantic canada email us newsroom.ca,mariah carey new year eve performance 'they foiled^mariah carey new year eve performance 'they foiled^i wanted see wedding prince harry meghan markle i curious know traditio^james franco denies sexual misconduct allegations,3,1,-2,4,0.75,-0.5,1
26986497,EDP24,1934,106711,757,153542,0,1,3,0,latest news uk best regional paper norfolk north suffolk east cambs follow reporters,norfolk gym equipment firm role nike ad campaign^watch the queen duke edinburgh prince harry meghan markle royal family members leaving church s^will prince harry meghan markle spend christmas william kate anmer hall norfolk^will prince harry meghan markle spend christmas william kate anmer hall norfolk,3,1,-2,4,0.75,-0.5,1
20545835,newsmax,585,92028,2079,93529,2,1,1,0,breaking news eert analysis watch newsmax tv directv xfinity dish u-verse fios youtube app,ruling relapse dangerous community^not enough doctors va^what look forthcoming social security trustees report^chloe grace moretz upset 'red shoes body shaming,3,1,-2,4,0.75,-0.5,1
19078594,scottEweinberg,3701,80609,1932,177768,0,1,3,0,film writer nerdist fearnet etc found footage d i trapped devil co-creator,reagan n't office long made movie^she comedian i got ta funny i reply^scott i hear produced new film i wan na tell us yes man i hate spielberg films what^mel gibson vince vaughn dang someone make sure tim allen knows film exists,3,1,-2,4,0.75,-0.5,1
189280347,TheBertShow,12321,76849,425,66709,0,0,3,1,real funny hang us mornings radio stream us bert show app -855-237-8746 insta fb thebertshow,is justinbieber marriage danger haileybaldwin selenagomez^remember ugly hollywood beautiful everywhere else bert jennifer aniston new man justin theroux bertshowepicquotes^angelina jolie amp brad pitt daughter snagged st movie role amp every girl dream part princess aurora^remember thackery binx yep thackery zachary hocuspocus here looks like,3,1,-2,4,0.75,-0.5,1
14721839,The_Nation,338,76559,679,150672,0,0,3,1,keeping updated go,miley cyrus liam hemsworth reportedly call wedding^george amal clooney welcome birth twins amalclooney georgeclooney^biggest celebrity scandals hollywood stars entertainment^daniel craig confirms play james bond,3,1,-2,4,0.75,-0.5,1
304932002,davidmackau,1482,69973,1357,49980,0,0,3,1,deputy director breaking news ex australian knifey-spooney national champion,kim kardashian going white house normal thing happpen today^the guy gay british farm movie god own country playing prince charles season crown^taylor swift fans are relieved they no longer need to defend her against far right conspiracies via^house cards producers consider killing off kevin spacey frank underwood via,3,1,-2,4,0.75,-0.5,1
14330994,msnents,7266,56429,388,68989,0,0,3,1,showbiz news pics video entertainment follow team arsalane,it twilight interview interviews robertpattinson talks babies yes breakingdawn^miley cyrus liam hemsworth cancel honeymoon bora bora report^angelina jolie breaks silence divorce^frozen will elsa get girlfriend disney sequel idina menzel joins fan campaign,3,1,-2,4,0.75,-0.5,1
22153607,923amp,9188,54301,1096,131697,0,0,3,1,nan,hospitalization may indefinitely extended someone get mpc ... stat^mariah carey elains nye disaster listen guys foiled ...^wait second get engaged wilmer valderrama birthday^yaaasssss abc confirmed nickiminaj open music awards ... ca n't wait,3,1,-2,4,0.75,-0.5,1
26274219,BizBash,18536,50117,1312,47814,0,1,3,0,ideas news resources event planners eeriential marketers subscribe bizbashny returns october javits center,july trump delivers politically charged speech half empty v.f.w convention why academy behind th^may see eected cost breakdown prince harry meghan markle nuptials argentina apologizes for^may see eected cost breakdown prince harry meghan markle nuptials argentina apologizes for^october oscar board eels harvey weinstein james corden apologizes weinstein jokes amfar gala,3,1,-2,4,0.75,-0.5,1
274202514,FBlankenshipWSB,424,45178,191,11832,0,0,3,1,fred blankenship anchors channel action news :30 a.m. a.m. channel action news noon,wait the moment realize friday eve good morning america coming way have a^hey robin this wonderful wednesday getting started let keep rolling amazing good morn^i 'm big fan good morning america team make monday feel like friday they 're next keep th^add one job list.it official atlanta native ryan seacrest new live co host kelly ripa,3,1,-2,4,0.75,-0.5,1
42985637,radionz,325,41890,486,41877,3,1,0,0,we nz public broadcaster comprehensive nz news news current affairs audio features documentaries find us social,us president donald trump hailed big victory midterm elections democrats seized house repre^george h.w bush america last great soldier statesman jon meacham presidential biographer gave eulog^former us president george hw bush died age son george w bush announced^one world biggest tobacco firms accused staggering hypocrisy new ad campaign u,3,1,-2,4,0.75,-0.5,1
243230859,biography,340,41783,516,13634,0,1,3,0,capturing gripping surprising fascinating stories famous people every life story,years ago took role president dave featuring memorable address a^people still asking i knew star wars going big hit yes knew the one w^we supposed talk money people think difficult diva wi^said farewell live sidekick philbin day during year talk sh,3,1,-2,4,0.75,-0.5,1
17466604,AOLNews,455,37363,2412,56324,1,1,2,0,the official twitter aol news,fake news claims malia obama eelled harvard drug violation^these victims shooting chicago mercy hospital^a look inside relationship oprah winfrey stedman graham say avoiding marriage helped stay ...^ivanka trump trolled online 'why i disagree with my dad us weekly cover,3,1,-2,4,0.75,-0.5,1
15063044,scobie,347,34838,286,11584,0,0,3,1,royal editor large royal contributor host theheirpod positive vibes only dms open,leaving high note prince harry joined duchess meghan invested private secretary ed lane fox step^new princess charlotte photos first birthday tomorrow kate took anmer hall^when thought everyone jealous bentley always iconic^sources tell meghan markle officially picked wedding dress designer first fitting kensington palace last week,3,1,-2,4,0.75,-0.5,1
36323511,ETPanache,90,31097,387,57768,0,0,3,1,follow latest fashion tech celebrities healthyliving lifelessons entertainment a times internet product,move^hospitalised suffering exhaustion sleep deprivation^bradpitt relieved man angelinajolie brangelina^ben jen officially file divorce jennifergarner hollywoodcouples,3,1,-2,4,0.75,-0.5,1
14067246,Deggans,5887,27379,1255,38480,0,1,3,0,npr tv critic media analyst msnbc/nbc author race-baiter how media wield dangerous words divide nation black radio journalist per deadline,shades megyn kelly nbc joined cnn fox news facebook banning trump racist immigration/caravan ad afte^i 'll wnyc fm p.m. talking super bowl ads halftime music check list best halftime shows^interesting ... .nbc today show began a.m. hour w/craig melvin al roker hoda kotb anchoring replacing megyn^i consider prick. larry david whether insensitive character curb your enthusiasm compared donald trump,3,1,-2,4,0.75,-0.5,1
610702056,GoldmyneTV,9075,27285,78,103692,0,0,3,1,nigeria award-winning online tv channel best news local movies international shows music videos,the best dressed celebrities red carpet emmy awards winners list^kim kardashian is jealous that kylie jenner is becoming a better looking version of her^grammy awards red carpet moments the complete winners list^grammy awards red carpet moments the complete winners list,3,1,-2,4,0.75,-0.5,1
7764332,michaelhayes,2545,26581,1002,50254,3,0,0,1,journalist cnn medium the appeal elsewhere former staffer dms open record email mikeehayes.com,new york city subway bomb suspect wrote trump you failed to protect your nation on facebook before the attack^in complaint nyc subway bomb suspect evidence includes facebook post trump failed protect your^federal terrorism charges filed man accused nyc subway bombing according complaint morning o^harvey weinstein has been arrested and charged with rape a criminal sex act and sex abuse,3,1,-2,4,0.75,-0.5,1
77268813,thesuperficial,880,24388,836,21059,0,0,3,1,a weirdo used write website like real boy i even sidekick which totally sex thing i see,kris jenner made kylie jenner dump tyga because of charlie sheen^ben affleck amp jennifer lopez are back together f*ck it why not^kris jenner made kylie jenner dump tyga because of charlie sheen^jessica simpson if i so pregnant then how do you elain this purse dunn dunn dunnnnnn,3,1,-2,4,0.75,-0.5,1
21354482,scotsman_arts,37,22669,418,65688,0,0,3,1,all latest arts entertainment news reviews,sir billy connolly wife blasted sir michael parkinson claiming comedian longer able re^sir billy connolly wife blasted sir michael parkinson claiming comedian longer able re^sir billy connolly wife blasted sir michael parkinson claiming comedian longer able re^justin timberlake announces scottish date 'man woods uk tour,3,1,-2,4,0.75,-0.5,1
2997657300,THRGlobal,225,22643,414,9572,0,0,3,1,the latest news correspondents around globe tweets thr online international editor abid rahman,thecrown casts prince charles queen mother season^venezia75 vince vaughn recruiting mel gibson draggedacrossconcrete^cannes film festival unveils dates^'how get away with murder star karla souza alleges raped director mexico early career,3,1,-2,4,0.75,-0.5,1
3300172687,DavidHMandel,11,22331,244,15968,0,1,3,0,executive producer veep season writer curb your enthusiasm seinfeld snl don forget eurotrip clerks the cartoon,let forget trump made bozo deputy chairman republican national committee finance committee^david mandel emmys what nominees are saying via^matt walsh emmys what nominees are saying via^anna chlumsky emmys what nominees are saying via,3,1,-2,4,0.75,-0.5,1
54306634,RCNconnects,12199,22141,234,100288,0,0,3,1,official rcn tweets rcn committed bringing best digital cable tv high-speed internet phone bundles homes businesses tweeting days year,take advantage movies watch free preview check emilyblunt psycho^tarek christina butt heads comes spending money designs tune /8c see ove^a million dollar win loss tarek christina find anaheim hills home filled mold.^their story n't yet reasonswhy renewed season amp return details,3,1,-2,4,0.75,-0.5,1
79038387,laurenzima,861,21349,118,11186,0,0,3,1,journalist on camera entertainment tonight insta laurenzima,reminder becca tia chris harrison say colton thebachelor^seanlowe n't 'virgin thebachelor anymore thinks coltonunderwood handle time on^what love watching reese witherspoon tearing nicole kidman emmy win magical emmys^cheryl burke matthew lawrence engaged weeks first red carpet together years congrats,3,1,-2,4,0.75,-0.5,1
106116852,briancgrubb,958,20933,508,66146,0,0,3,1,writer editor uproxx email brian.grubb.com,regis philbin eating crabs tables away restaurant baltimore^pleased report take two starring rachel bilson disgraced actress begins working p.i playe^take two appears real show stars rachel bilson disgraced actress solves crimes private^first look travolta action ryan murphy new o.j simpson series this continues fascinate,3,1,-2,4,0.75,-0.5,1
362704645,abc7george,694,18061,338,10933,0,0,3,1,the eyewitness news entertainment guru subscribe off red carpet podcast clicking link,breaking well wishes reports hospitalized today emergency appendectomy^oh i would i 'll tell drove crazy one woman^oh i would i 'll tell drove crazy one woman^from deadline a federal judge sentenced former dance moms coach abby lee miller year day prison fraud charges,3,1,-2,4,0.75,-0.5,1
631686353,tv_brendon,5170,17823,201,9451,0,0,3,1,x emmy-winning producer entertainment tonight,a kensington palace spokesperson tells et meghan markle mother doria ragland happy love^sources confirm et krause show la tonight etnow purposetour^exclusive miley cyrus liam hemsworth still together despite breakup rumor^david foster katharine mcphee are engaged,3,1,-2,4,0.75,-0.5,1
32625284,97xonair,1782,14169,242,65996,0,0,3,1,tampa bay new alternative,those beautiful children amal george clooney welcome twins^cnn mistakes faith hill faith evans twitter erupts^wishing quick recover way selena gomez reveals kidney transplant francia raisa donor^for anyone like n't cable completely missed movie amp tv awards co,3,1,-2,4,0.75,-0.5,1
35862157,mwtnews,338,12373,210,29782,3,0,0,1,the midland reporter-telegram daily newspaper midland texas member hearst community newspapers,heated debate surrounds push deep fryers schools texas agriculture commissioner sid miller cowboy ...^texas ag chief sid miller interviewing usda post friday^former president george h.w bush buried beside wife barbara bush daughter robin died age le^miss district columbia k ra mccullough crowned miss usa without controversy,3,1,-2,4,0.75,-0.5,1
18079519,KFYRTV,160,10373,342,53592,0,0,3,1,your news weather sports leader western north dakota,trump warns north korea 'fire fury nuke threat worsens^fairy tale castle host prince harry meghan markle modern royal wedding^angelina jolie brad pitt headed court custody battle^the mother day vendor show another way people get house sunday the event organized,3,1,-2,4,0.75,-0.5,1
24740781,ks95,253,9192,126,25971,0,0,3,1,ks95 kstp-fm st. paul/minneapolis today variety,here full list winners th primetime emmy awards emmys^katyperry might thrown shade taylorswift american idol what think^katyperry might thrown shade taylorswift american idol what think^edsheeran announced engaged long time girlfriend cherry seaborn,3,1,-2,4,0.75,-0.5,1
14786823,ObserverStyle,2920,9154,478,9523,0,0,3,1,reporting breaking news trends celebrities influencers fashion fitness health real estate design beauty food drink world luxury brands,this prince william kate middleton first official appearance together six months^kate middleton prince william went anmer hall returned mystique^meghan markle prince harry missing two prince charles birthday parties^is prince harry meghan markle n't photographed pippa middleton wedding,3,1,-2,4,0.75,-0.5,1
334303819,947thewave,692,8622,104,20892,0,0,3,1,the wave soul southern california,listen pm deborah open phone lines wave caller win two tickets see^song day live website listen pm hour sam smith 'stay with me^your trip a day song of the day samsmith stay with me listen pm hour chance win^johnlegend playing role jesus nbc next live musical 'jesus christ superstar,3,1,-2,4,0.75,-0.5,1
46455548,NMDEMS,4312,8528,227,15880,3,1,0,0,we building future new mexico families sign make sure miss thing,senator announced support visit website help us win house re^this district could decide control entire house representatives luckily us rea^democrats win control house representatives without winning cd visit t^the war poverty years later,3,1,-2,4,0.75,-0.5,1
52188144,969thegame,994,7385,137,93963,0,0,3,1,radio home ucf orlando magic tb bucs orlando city sc lineup open mike -9a beat sports a-12p in zone -6p listen,celebrities react trump withdraws steph curry white house invitation^ryan lochte charge dropped in rio robbery case^celebrities react nfl players kneel lock arms during national anthem^here how help victims las vegas mass shooting,3,1,-2,4,0.75,-0.5,1
35931016,LeniseLigon,2038,7272,147,32096,0,0,3,1,tv news anchor grad vegetarian marathoner public speaker i giving back,channing tatum wife jenna dewan split after nearly years marriage via^channing tatum wife jenna dewan split after nearly years marriage via^gwyneth paltrow says brad pitt threatened kill harvey weinstein alleged sexual harassment via^/20 anchor elizabeth vargas announces exit from abc news e news,3,1,-2,4,0.75,-0.5,1
33957999,einfal,5023,7091,186,129930,3,1,0,0,pesquisador independente cve |mossad via hezbollah quote source redemption bring forth- talmud all opinions mums,texas official uses obscenity clinton twitter agriculture commissioner sid miller ... via^breaking federal complaint says portauthority bomber akayed ullah posted facebook morning attack trump^lew new scribble dollar bill nyt barack obama eected pick treasury secret ... via^the law firm representing democratic national convention host committee effort ... via,3,1,-2,4,0.75,-0.5,1
114947295,LCJReviews,983,7041,189,21266,0,1,3,0,emmy-winning critic entertainment reporter host animation scoop rapid reviews lcj q a podcast,bradley cooper amp say one hundred percent perform shallow oscars song nomin^happy birthday this first time met live live looking forward next time^bryan cranston kevin hart amp nicole kidman former weinstein company movie theupside distributed s^dennis quaid carrie coon james franco headline end summer sci fi drama kin my review,3,1,-2,4,0.75,-0.5,1
794424389454340096,10Daily,1052,6154,66,30511,0,1,3,0,daily committed relationship news benefits sport weather opinion celebrity tv tech lifestyle everything,in interview president border patrol foundation ron colburn said pepper spray used^frontbencher emma husar accused eing basic instinct style damning report^pics young royal mum catherine duchess cambridge sweet^pics young royal mum catherine duchess cambridge sweet,3,1,-2,4,0.75,-0.5,1
30276642,KylieEricaMar,171,4623,81,17329,0,0,3,1,host co-host lead anchor bfca film critic btja tv critic instagram,kendall jenner snaps kris wanting include caitlyn jenner kuwtk click recap^on kuwtk gets upset trying control instagram posts click re^shares uncomfortable super emotional reliving tristan cheating scandal o^this wants marry frances mcdormand click,3,1,-2,4,0.75,-0.5,1
161096061,VentonBlandinTV,2760,3787,97,18859,0,0,3,1,god family career people chicago emmy-nominated regional murrow award-winning,yo stl i want chat^yo stl i want chat^yo stl i want chat^during morning devotion amp reflection i remembered i phone a friend told wish this wa,3,1,-2,4,0.75,-0.5,1
417164775,SandyLeeTV,977,3714,105,16186,0,0,3,1,emmy gracie winning producer photographer columbia j,enjoyed working w/ rt kelly osbourne wants loved^today know starting new chapter third hour show as evolves want kno^some advice randomly wake sleep turn i laughing crying e^good know ... clarkson clarifies comment when i really skinny i wanted kill,3,1,-2,4,0.75,-0.5,1
27512619,TheBGates,911,3651,224,84764,0,0,3,1,journalist incurable elorer quasi-hipster crossfit studying sketch comedy introvert troublemaker alum estudiando espa ol,audition cheers bkstage kanyewest americanidol kimkardashian^makes appeal people offended comedians laugh she also speaks shoul^i begging years since track record proven pretty solid i ho^it weird would release first look season season,3,1,-2,4,0.75,-0.5,1
17215027,QMFM,222,3627,91,12851,0,0,3,1,today best variety mclaren,american idol wants come back kanye west judge listen sleaze gt^what brad pitt jennifer aniston possibly getting back together listen today sleaze^what brad pitt jennifer aniston possibly getting back together listen today sleaze.^girl trip announces las vegas residency,3,1,-2,4,0.75,-0.5,1
459663438,GoldsmithB,99,3481,63,9573,0,1,3,0,investor consultant was co-host pod political co-head us contributor producer enjoys dim sum,tragic early death pancreatic cancer jonathan gold great critic revolutionary his life work was^katie couric opens up about matt lauer firing today show via^if love politics want break kavanaugh check podcast documentary i made it^part palin documentary apple podcasts today katie couric her famous palin interview trump,3,1,-2,4,0.75,-0.5,1
133496245,CabbageTV,1443,2969,131,121168,1,0,2,1,god masterpiece anchor gmaweekends aiken bureau chief counting blessings chasing dream past,just in federal prosecutors charge nyc subway bomb suspect say wrote facebook trump failed protect nation^midlands man could win big vacation nbc live kelly ryan scnews sctweets^midlands man could win big vacation nbc live kelly ryan scnews sctweets^just in kensington palace says prince charles walk meghan markle aisle royal wedding,3,1,-2,4,0.75,-0.5,1
23647244,tinawargz,1916,2780,33,59879,0,1,3,0,internet professional/writer/cackler co-host very obsessed everything will try date mom,mamma mia here we go again better office space^ocean anne hathaway look what you made me do^nicole kidman singing a case of you practical magic the history of pop culture^just panicked like full minutes badly i needed juice i literally shouted words i feel like j,3,1,-2,4,0.75,-0.5,1
2188052916,YahooEntsME,1601,2645,27,13823,0,0,3,1,yahoo maktoob entertainment lifestyle source hollywood arabia bollywood pinoy celebs movies beauty plus fashion travel,kim kardashian defends kylie kendall jenner^are ben affleck jennifer lopez back together^jennifer aniston 'knows her truth with justin theroux^house cards back kevin spacey says frank underwood wo n't stop wanting president,3,1,-2,4,0.75,-0.5,1
2439245995,AshJamesWIlson,677,2536,53,7417,0,0,3,1,former news anchor freelance reporter- wife mom blue hen,jennifer aniston justin theroux split 'lovingly after two years marriage via^jennifer aniston justin theroux split 'lovingly after two years marriage via^jennifer aniston justin theroux split 'lovingly after two years marriage via^does this photo prove amelia earhart survived her final flight via,3,1,-2,4,0.75,-0.5,1
28661767,943WSC,311,2531,85,27203,0,0,3,1,charleston news weather information station stimulating talk w/kelly golden glenn beck rush limbaugh sean hannity dave ramsey panthers affiliate,celebrities remember orlando pulse nightclub shooting victims one year later^celebrities react nfl players kneel lock arms during national anthem^grammy awards see the full winners list^here how help victims las vegas mass shooting,3,1,-2,4,0.75,-0.5,1
24932347,KOCOPatrina,905,1757,58,24479,0,0,3,1,news reporter uk born-tx raised die-hard cowboys spurs fan life family friends opinions rts endorsements negative tweets/ppl blocked,my favorite time year halloween celebrating everybody looks great^my favorite time year halloween celebrating everybody looks great^it remade three times starring judy garland james^not fan scripted shows haven watched one since th season scandal best tv ri,3,1,-2,4,0.75,-0.5,1
33635539,brrriitttnnii,716,1537,14,5115,0,0,3,1,senior marketing tech writer former tv editor/reporter will discuss sports cheese llamas ufc comedy pugs nyc austin based,channing tatum jenna dewan split years marriage needless say world keeps spinning^selenagomez natural beauty ...^channing tatum jenna dewan split years marriage needless say world keeps spinning^things we ca n't wait see kelly ripa new live co host ryan seacrest,3,1,-2,4,0.75,-0.5,1
4711447096,kevanfox26,54,155,3,4858,0,0,3,1,fox26 meteorologist active member american meteorological society,blake shelton calls meeting gwen stefani 'a miracle after 'hitting rock bottom^brad pitt angelina jolie get trial date their custody battle^blake shelton calls meeting gwen stefani 'a miracle after 'hitting rock bottom^koko gorilla knew sign language dies,3,1,-2,4,0.75,-0.5,1
25093616,MensHealthMag,1112,4527993,17482,116154,0,0,1,2,men health magazine ultimate guide fitness health weight loss nutrition sex style guy wisdom,at dennis quaid fitter actors half age^our picks best super bowl halftime shows ever how think black eyed peas stack sunday^the best superbowl halftime shows ever any missed tweet us,1,2,1,3,0.3333333333333333,0.3333333333333333,0
92731878,CapitalFMKenya,319,1419280,1276,392312,0,2,1,0,the best mix music/ news/ sports/ lifestyle,trade war ramps us threatens 200bn chinese goods^trade war ramps us threatens 200bn chinese goods^trump warns north korea fire fury,1,2,1,3,0.3333333333333333,0.3333333333333333,0
18040230,malaysiakini,159,1279064,1722,183135,0,2,1,0,malaysiakini award-winning independent news provider the editorial built fast accurate independent news well-informed diverse views,video it minor mistake says dr m guan eng use chinese official statement^mahathir un speech proposed basis foreign policy^north korea planning strike guam warns 'fire fury,1,2,1,3,0.3333333333333333,0.3333333333333333,0
454340464,Polygon,111,878162,7198,65444,0,0,1,2,polygon website renaissance gamer that fancy way saying write game thrones sometimes but usually games,dragalia lost nintendo next mobile game shapeshifting dragons monster companions action rpg fighting^these best new tv shows^everything know star wars episode ix far,1,2,1,3,0.3333333333333333,0.3333333333333333,0
22565066,PEOPLEPets,1329,869232,1988,25962,0,0,1,2,cute pet photos celebrity pets funny videos must-see animal stories editors people,amanda seyfried shares 'good advice she used when introducing her dog finn her baby girl^olivia wilde dog 'best friend paco dies her birthday^fiona baby hippo dad henry dies after battling infection,1,2,1,3,0.3333333333333333,0.3333333333333333,0
184647530,dose,234,829470,6011,51514,0,1,1,1,everything need know everything worth knowing,according centers disease control prevention nearly two every inspections contains improp^watch angelina jolie breaks silence divorce shares emotional tribute late^jada pinkett smith calls golden globes snubbing 'girls trip breakout star tiffany haddish,1,2,1,3,0.3333333333333333,0.3333333333333333,0
21829541,NRA,885,789817,4412,18008,1,2,0,0,the nra america longest-standing civil rights organization nra a,they plan seize power washington capturing house representatives u.s. senate then cru^why chief flynn think brady bill anything assault weapons ban briefed better^blaming guns rational response first guns commit crimes also because,1,2,1,3,0.3333333333333333,0.3333333333333333,0
148529707,RBReich,275,708514,11050,10847,0,2,1,0,berkeley prof former sec lab movies `` saving capitalism '' `` inequality all '' netflix books the common good saving capitalism etc,the tax policy center research arm brookings institution urban institute done new ...^the democratic national convention drafting committee approved draft democratic platform ...^president obama delivers remarks abraham lincoln national cemetery memorial day,1,2,1,3,0.3333333333333333,0.3333333333333333,0
44839509,CNBCTV18Live,548,684611,1750,888497,1,2,0,0,the cnbc-tv18 news ticker twitter the news breaks first,facebook ceo mark zuckerberg testifies us house representatives says personal data included^cnbctv18market asia tumbles early trade despite strong us close trump announcement list tarif^coming up at :30 pm trump trade war china responds kind tariffs 34 bn us goods,1,2,1,3,0.3333333333333333,0.3333333333333333,0
102700680,Davos,933,678949,5276,42952,1,2,0,0,the livetweet/automated account world economic forum follow main account annual meeting hashtag wef19,"the us house representatives one member every ,000 people^/7 cheng wei founder chairman board ceo didi kuaidi china amnc15 futurechina^/6 cheng wei founder chairman board ceo didi kuaidi china amnc15 disruption",1,2,1,3,0.3333333333333333,0.3333333333333333,0
50772918,ClayTravis,346,628619,3647,98971,0,1,1,1,-9 et tv show :30 et author republicans buy sneakers too dad three boys lawyer,this i also say democrats want beat trump stop focusing impeachment amp removal off^kanye west secretly recorded taylor swift phone call amp kim kardashian played snapchat amp taylor ripped^i love house cards kevin spacey frank underwood rank worst southern accents time he top five sure,1,2,1,3,0.3333333333333333,0.3333333333333333,0
8940342,HoustonChron,498,623877,4935,211555,1,1,0,1,news headlines tweets houston chronicle journalists,texas ag commissioner sid miller calls hillary clinton c word twitter yes real^most popular baby names every us state^meghan markle dad attend royal wedding walk aisle half brother calling for,1,2,1,3,0.3333333333333333,0.3333333333333333,0
569053466,legitngnews,4555,610309,730,235608,0,1,1,1,ex leading way we cover politics business sports entertainment news enrich nigerians lives,full speech president buhari closing ceremony apc convention^david beckham ranked among current highest paid stars^shares first photo new born daughter chicago west,1,2,1,3,0.3333333333333333,0.3333333333333333,0
592730371,JackPosobiec,984,541881,4345,106972,0,2,1,0,host veteran intel officer co-founder task force aegis anti-woke,in cnn comments viewers seem agree company statement video fake we^i told officials wh concerned president record remarks leaked lindsay walte^i love treats social media like anyone would personal page posting bday vi,1,2,1,3,0.3333333333333333,0.3333333333333333,0
1017158666,AbbTakk,1,513717,662,1720727,1,0,0,2,official twitter account abb takk news,bill end us aid pakistan moved house representatives^daniel craig confirms he will play james bond again^daniel craig confirms he will play james bond again,1,2,1,3,0.3333333333333333,0.3333333333333333,0
3150940290,thewire_in,127,501915,1445,75510,1,2,0,0,india foremost independent news-site carrying critical opinion investigations reportage click support us,us house representatives defeat trump immigration bill^found lost an indian fossil hunter chase dinosaur relics^worldcup among four defending champions last five editions faltered first hurdle afte,1,2,1,3,0.3333333333333333,0.3333333333333333,0
16310534,thebump,1037,450797,2229,22449,0,2,1,0,empowering affirming mom maternal instincts keeping aheadofthecurve,popular baby names by state that did n't make the national rankings^popular baby names state state^a royal baby is way meghan markle prince harry,1,2,1,3,0.3333333333333333,0.3333333333333333,0
20689749,TheSunFootball,600,425848,3374,207365,0,0,1,2,breaking news goals live coverage,the eye watering amount david beckham earns month^cristiano ronaldo girlfriend georgina rodriguez gives birth baby girl^cristiano ronaldo girlfriend georgina rodriguez gives birth baby girl what cute name,1,2,1,3,0.3333333333333333,0.3333333333333333,0
55118669,PhilstarNews,226,406094,1867,232255,0,2,1,0,official online arm star group publications breaking news features special reports multimedia,the president statement comes months diplomatic spat kuwait filipino foreign affairs officials^four suspects killed drug raids bulacan one pampanga quezon past two days^here full list academy awards oscars winners far via,1,2,1,3,0.3333333333333333,0.3333333333333333,0
14956372,WRAL,7797,379804,2403,145217,1,1,0,1,breaking news wral wralinvestigates oys nbc affiliate,breaking feds charge nyc subway bomb suspect say wrote facebook trump failed protect nation^new story in chicago shooting victims hours minutes wral^new story reports say kylie jenner pregnant first child wral,1,2,1,3,0.3333333333333333,0.3333333333333333,0
33235771,MiaFarrow,1350,379739,3755,71394,0,1,1,1,the life nation secure nation honest truthful virtuous frederick douglass,a comprehensive investigation voter impersonation finds credible incidents one billion ballots cast^beautiful rendition song stand by me performed royal wedding prince harry meghan markle by^celebration game thrones fans def including kit harington jon snow rose leslie ygritte gett,1,2,1,3,0.3333333333333333,0.3333333333333333,0
14074515,USAGov,1124,345367,5638,18134,1,2,0,0,we help discover official u.s. government information services internet retweets follows equal endorsement,have registered vote do n't wait online registration open states^today george washington delivered first inaugural address joint session congress^today george washington delivered first inaugural address joint session congress,1,2,1,3,0.3333333333333333,0.3333333333333333,0
654203,IOL,11823,338629,1647,305625,0,1,1,1,independent online i connecting south africans i driving change i telling stories that matter i news heart south africa,bricssummit2018 the full text speech prepared delivery president cyril ramaphosa brics bus^look prince harry wife meghan married may welcome first child world next sp^stop saying i baby wedlock cardi b confirms via twitter married woman cardi b reveals,1,2,1,3,0.3333333333333333,0.3333333333333333,0
24980246,NikkiFinke,5690,302277,4130,44854,0,1,1,1,ceo publisher showbiz fiction penske business media consultant founder ex-moscow/london/wash dc/hollywood journalist,rt comedy central fake news the daily show makes real news with interview^disney casts angelina jolie brad pitt daughter as young princess^cw fall premiere dates network to roll out lineup october originals held back via,1,2,1,3,0.3333333333333333,0.3333333333333333,0
9532402,BuzzFeedBen,5475,300611,8049,124053,0,2,1,0,buzzfeed editor-in-chief beats working living email gchat ben.com,rt will video interview howard dean comments later afternoon^rudy giuliani new hampshire saturday blue motorcycle business suit^taylor swift fans are relieved they no longer need to defend her against far right conspiracies,1,2,1,3,0.3333333333333333,0.3333333333333333,0
25525507,broadwaycom,557,297306,2595,68440,0,0,1,2,nan,broadway alum amp oscar nominee emma stone eyes la la land movie musical^house of cards emmy winner new york stage star reg e. cathey dead^katharine mcphee david foster engaged,1,2,1,3,0.3333333333333333,0.3333333333333333,0
15518000,urbandictionary,3,287831,3105,4881584,0,2,1,0,mention tweet urban dictionary definition,sotu state of the union address^slytherin slytherin one four houses harry po ...^fury crazy tom cruise example appearance oprah winfrey show,1,2,1,3,0.3333333333333333,0.3333333333333333,0
23605284,InterviewMag,224,287697,4642,18581,0,0,1,2,nan,i lift chiwetel amp nicole kidman then julia roberts gets in moving^is little finger villain who win iron throne aidangillen answers questions^cover star penelope cruz talks passion motherhood amp hollywood obsession aging wome,1,2,1,3,0.3333333333333333,0.3333333333333333,0
23585395,tvonetv,6279,286368,1476,66591,0,0,1,2,a television network representing best past present future black entertainment tv represent,after years finally sharing secret keeping stedman graham happy and mood watch inside^supposedly last video janet hubert calls black media even us ni**a networks invites will jada p^janet hubert calls black media even us ni**a networks invites will jada pinkett smith butcher,1,2,1,3,0.3333333333333333,0.3333333333333333,0
620136960,cgtnamerica,2055,275510,1165,59950,1,2,0,0,watch live material distributed cgtn america behalf cctv more info available department justice,federal prosecutors charge nyc subway bomb suspect say wrote facebook trump failed protect nation^hofstra university long island getting ready tomorrow first presidential debate^hanging around outside debate venue hofstra university first presidential,1,2,1,3,0.3333333333333333,0.3333333333333333,0
14085070,carlzimmer,1314,274461,5915,47209,1,2,0,0,columnist author she has her mother laugh parasite rex etc,inside fake news sausage factory this is all about income via^new numbers thursday centers disease control prevention show drug overdoses killed than^new numbers thursday centers disease control prevention show drug overdoses killed than,1,2,1,3,0.3333333333333333,0.3333333333333333,0
16004411,Missinfo,545,256526,3168,103386,0,0,1,2,your favorite rappers favorite confidante serving truth snark hip hop missinfotv also email missinfo.tv,shots fired during video shoot amp^justin bieber cancels remaining purpose world tour dates^announces 'man woods tour,1,2,1,3,0.3333333333333333,0.3333333333333333,0
2257546388,DrJoeAbah,2747,255527,389,122917,0,2,1,0,governance public service reforms public policy political economy rusty law todayshypothesis ebeanochronicles retweets encourage debate,well done continue advocate police reforms endsars cc a^all most important survey asking choose one four^i often wrong but i afraid wrong i simply apologize learn make amends nothing spoil,1,2,1,3,0.3333333333333333,0.3333333333333333,0
2489431314,MirwaizKashmir,75,247679,284,2277,0,2,1,0,chairman all parties hurriyat conference,welcome statement un chief backing report askingfor international investigation^the meeting welcomed recent statement pti chief imran khan calling dialogue kashmir we urge govt of^grieved death destruction caused floods indian state kerala people kashmir empathise with,1,2,1,3,0.3333333333333333,0.3333333333333333,0
16929600,NYTmag,207,247118,5705,28289,0,2,1,0,stories sunday magazine we email,the u.s. department agriculture estimates us eat pounds turkey year migh^the u.s. department agriculture estimates us eat pounds turkey year migh^'just get us room the women hollywood speak out maureen dowd,1,2,1,3,0.3333333333333333,0.3333333333333333,0
58819992,BDliveSA,240,246206,1257,215057,1,2,0,0,business day south africa best daily business newspaper part businesslive network we also facebook linkedin,democrats seize us house representatives trump dodges 'blue wave^china vows retaliate us raises stakes trade spat tariffs 200bn goods^these us goods china target tit tat trade,1,2,1,3,0.3333333333333333,0.3333333333333333,0
250386727,Everytown,8486,246111,1935,20584,1,2,0,0,everytown gun safety movement americans working together end gun violence build safer communities,when said going throw leaders bought nra threat promise together^dr. tamara o'neal one victims last night shooting chicago mercy hospital shooter forme^today miami u.s. rep debbie wasserman schultz endorsed fixgunchecks thank tweet,1,2,1,3,0.3333333333333333,0.3333333333333333,0
16513416,fox35orlando,14148,238763,1572,199757,0,2,1,0,official fox orlando/wofl account breaking news weather politics sports,the centers disease control prevention says salmonella outbreak linked turkey^the centers disease control prevention says salmonella outbreak linked turkey^remembering carrie today would carrie fisher nd birthday the actress best known playing princ,1,2,1,3,0.3333333333333333,0.3333333333333333,0
25728193,DrJenGunter,15244,237850,2557,178353,0,1,1,1,ob/gyn appropriately confident lasso truth canadian spice i speak one the vagina bible bestseller omg jensplaining nyt contributor,dear perhaps know radiologist interview effects traumatic childho^they afraid^hope n't osteoporosis gt gwyneth paltrow reveals how she broke her foot via,1,2,1,3,0.3333333333333333,0.3333333333333333,0
122339767,bdnews24com,13,233082,248,301969,0,1,1,1,official twitter account bangladesh largest news publisher bilingual internet-only /7 news sport entertainment opinion since,`much progressive movement roots nationwide volunteer network built bernie sanders p^north korea says considering strike us territory guam trump warns 'fire fury^priyanka chopra nick jonas reportedly engaged,1,2,1,3,0.3333333333333333,0.3333333333333333,0
236891946,AJStream,898,227439,3205,160583,1,2,0,0,the stream al jazeera global audience becomes global community tell us stories want amplified live youtube,house committees chaired democratic party leaders republicans lost majority u^do disability requires straw use drink how think businesses going strawless better i^npr fact checked first us presidential debate realtime top live transcript,1,2,1,3,0.3333333333333333,0.3333333333333333,0
759692754985242625,kumparan,2,225113,457,307217,0,2,1,0,percayakumparan,temuan berdasarkan hasil riset lembaga kesehatan masyarakat as centers disease control prevention cdc^temuan berdasarkan hasil riset lembaga kesehatan masyarakat as centers disease control prevention cdc^tiket konser syr enggak kalah mahal dari tiket konser diva pop internasional berapa kira kir,1,2,1,3,0.3333333333333333,0.3333333333333333,0
99928370,Koimoi,975,217942,331,62086,0,0,1,2,latest bollywood news quick reviews the one stop box office guru follow facebook- instagram koimoi,really excited friend amp mum meghanmarkle meghan bollywoodnews koimoi^here newly engaged couple snapped engagement bash.^here newly engaged couple snapped engagement bash.,1,2,1,3,0.3333333333333333,0.3333333333333333,0
14411304,sacbee_news,212,217850,3018,252213,0,2,1,0,official account the sacramento bee california news sports entertainment politics readlocal subscribe today,donald trump acting like candidate ballot week staging daily double header rallies blas^philando castile stopped times police was racial profiling^cristina mendonsa co host kfbk morning news show starting monday radio station announced thursday mend,1,2,1,3,0.3333333333333333,0.3333333333333333,0
18755564,kroq,5090,192574,1933,46575,0,1,1,1,the world famous kroq fm -520-1067 an station stream us,the debate discuss whether are luc amp songs summer..^watch new 'aquaman trailer starring jason momoa nicole kidman^set play hugh hefner new movie playboy founder life,1,2,1,3,0.3333333333333333,0.3333333333333333,0
15169032,KXAN_News,2822,186565,2502,135587,0,2,1,0,in-depth investigative updates kxan newsdesk day night,kxan completed interview president george w. bush keep eye kxan.com raw interview soon feed^one critically injured sanmarcos apartment fire five non life threatening injuries four accou^man posed justinbieber harrystyles online entice girls sentenced years prison,1,2,1,3,0.3333333333333333,0.3333333333333333,0
96675300,mayawiley,3267,177836,1430,27240,0,2,1,0,nbc news legal analyst univ prof views typos r mine give light people find way ella baker,joining talk michaelcohen resigned republican national committee post today^trump tough talk carried interest hedge fund taxes does n't match his plan debates2016^i using interview demonstrate children long term effects opioid use what kanye west said a,1,2,1,3,0.3333333333333333,0.3333333333333333,0
28350927,Stratfor,1115,170049,5323,57786,0,2,1,0,the world leading geopolitical intelligence platform putting global events perspective empower businesses governments individuals,in speech italy prime minister suggested gov't would n't veto eu sanctions russia time he also^trump less interested breaking trade barriers u.s. goods overseas restricting imports^washington rolling toughest sanctions yet iran in process forcing countries busi,1,2,1,3,0.3333333333333333,0.3333333333333333,0
701138666962419712,Soundcity985FM,415,159696,156,176556,0,0,1,2,using power music bring together young influencers nigerian youth transmitting streaming online dial lagos,game thrones star sophie turner is engaged joe jonas news gameofthrones joejonas^second suspect xxxtentacion murder case has been arrested news^second suspect xxxtentacion murder case has been arrested news,1,2,1,3,0.3333333333333333,0.3333333333333333,0
190905427,ForAmerica,542,142020,1723,33530,1,2,0,0,our mission reinvigorate public principles american exceptionalism freedom prosperity virtue president,filed celebrity opinions one cares miley cyrus calls 'a f king nightmare^same rep. luis gutierrez offended chants u.s.a. state union oh ok^a powerful moment first address joint session congress r.i.p thank william ryan,1,2,1,3,0.3333333333333333,0.3333333333333333,0
18851248,AlterNet,16361,139377,6926,55796,0,2,1,0,alternet progressive news magazine online community,report shows bernie sanders 'laying groundwork launch bigger presidential campaign first^white house releases doctored video infowars falsely accuse cnn acosta 'inappropriate behavior pre^ivanka trump 'why i disagree with my dad profile is driving people crazy,1,2,1,3,0.3333333333333333,0.3333333333333333,0
20093858,KARK4News,2597,134530,896,166744,0,1,1,1,kark news delivers local news matters central arkansans hours day air online go change4kark,tonight democratic presidential candidates debate new hampshire things2know arnews^rapper travis scott pleads guilty disorderly conduct arnews^bill cosby found guilty sexual assault retrial,1,2,1,3,0.3333333333333333,0.3333333333333333,0
29097819,EpochTimes,104,129321,1577,136330,0,0,1,2,an independent award-winning voice print online integrity truthfulness reporting email sign,videos day slams i never forgive him what he did our military^jim carrey cleared as wrongful death lawsuit dismissed^kevin spacey 'frank underwood dead final season 'house cards houseofcards,1,2,1,3,0.3333333333333333,0.3333333333333333,0
75797367,dandrezner,994,128126,3365,188049,0,2,1,0,professor contributor author the ideas industry shaker hands mel brooks,after reading transcript oprah minutes segment i honestly understand trump would that^interesting burt helped write trump big foreign policy speech campaign^the movie eits five different times pentagon papers us presidents truman,1,2,1,3,0.3333333333333333,0.3333333333333333,0
19401084,KAKEnews,435,124880,878,132663,1,2,0,0,kake news on your side powerful name kansas news breaking news weather alerts topics impact,federal prosecutors charge nyc subway bomb suspect say wrote facebook trump failed protect na^update chicago police say suspected gunman killed four victims critical condition an^approximately :10 ap white house vice president joe biden make statement rose garden,1,2,1,3,0.3333333333333333,0.3333333333333333,0
398088661,MEPFuller,4118,122846,2764,58924,1,2,0,0,congress stuff huffpost take tweets seriously literally send email matt.fuller.com,pelosi finishing our basic request honor house representatives give us vote. again wants^rep. keith rothfus whether troubled anything president said yesterday take look stateme^it time year i cover sunday shows frantically begin googling channel meet press dc,1,2,1,3,0.3333333333333333,0.3333333333333333,0
15469000,PENamerica,5183,120179,2086,42530,1,2,0,0,we stand intersection literature human rights protect open eression u.s. worldwide annual festival,the u.s. house representatives adopted vote house resolution calling immediate relea^rudy giuliani fire saying truth n't truth interview chuck todd he since tried^trump criticized press speech veterans foreign wars convention leading boos heckling of,1,2,1,3,0.3333333333333333,0.3333333333333333,0
2930935453,ThePrintIndia,84,118937,501,57411,0,2,1,0,substance print speed digital,hi please read full transcript interview please refer answers questions amp^one every four girls india fears abducted amp raped public survey produced sajid ali^royal wedding prince harry meghan markle fairy tale come true mumbai ngo reports,1,2,1,3,0.3333333333333333,0.3333333333333333,0
15359578,christinawilkie,6264,117263,2284,34237,0,2,1,0,covering white house .com alum rts huh christina.wilkie.com cell signal -286-6875,new full transcript stormy daniels interview gt gt gt^oof yesterday vfw announced last minute trump speech moved convention center into^i grading president anything i leave historians merely trying elain that,1,2,1,3,0.3333333333333333,0.3333333333333333,0
356162725,DavidAmoyal,990,112479,1661,396995,0,2,1,0,calcio rock n roll editor english host writer columnist contact david.amoyal77.com,opening scene reservoir dogs like welcome jungle gnr first album statement intent wa^feels like starting take granted their run past four years makes one great^what bigger rip tom petty song sam smith stay me i back,1,2,1,3,0.3333333333333333,0.3333333333333333,0
233737858,SenRonJohnson,672,109697,2614,5200,0,2,1,0,chairman homeland security governmental affairs committee subcommittee europe regional security cooperation tweets ron signed rj,extraordinary individual he irreplaceable united states senate more m^extraordinary individual he irreplaceable united states senate more m^john mccain feisty guy also one first people stand say okay let figure out,1,2,1,3,0.3333333333333333,0.3333333333333333,0
29549839,CommonSense,7632,106374,2289,27986,0,0,1,2,global nonprofit helping families navigate media tech digital parenting age-based media reviews/recs advice research privacy policy digitalwellbeing,who gets decide politically correct let keeptalking finale americainsideout with^the results bestofbest poll these awesome games books tv shows movies voted best p^after years getting new voice via,1,2,1,3,0.3333333333333333,0.3333333333333333,0
1853937570,ChennaiTimesTOI,331,105430,105,27045,0,2,1,0,official handle chennai times follow updates tamil film industry lifestyle fashion stories city updates,poses shutterbugs adangamaru press meet^jayamravi smiles adangamaru press meet^reveals kidney transplant shares hospital picture bff actress,1,2,1,3,0.3333333333333333,0.3333333333333333,0
269897088,thezoereport,664,98201,1027,46505,0,0,1,2,an online fashion lifestyle destination sign newsletter,kate middleton announced pregnant 're freaking^see met gala red carpet arrivals gt metgala2015^meghan markle prepped skin 325 facial pippa middleton wedding,1,2,1,3,0.3333333333333333,0.3333333333333333,0
1133998249,NTVnewsroom,398,97164,120,173808,1,0,0,2,breaking news live updates digital team,us shutdown house representatives senate pass contentious bill stop shutdown ntvatone^the royal wedding update meghan markle walk aisle without father royal wedding amliventv^wendy williams reveals graves disease diagnosis talk show host says get ntvtoday,1,2,1,3,0.3333333333333333,0.3333333333333333,0
1501471,LanceUlanoff,8705,96114,6088,75010,1,0,0,2,editor-in-chief tech social media eert tv guy ex-mashable pcmag untangled newsletter,melania trump undergoes kidney surgery walter reed medical center^neil diamond retires from touring after parkinson disease diagnosis^nooooo 'superman star margot kidder dead rip,1,2,1,3,0.3333333333333333,0.3333333333333333,0
1426645165,bustle,2262,95296,1509,51740,0,0,1,2,for women moving forward fast,how about we do n't eect meghan markle amp kate middleton to get along written^icymi mindy kaling is reportedly pregnant with her first child^mindy kaling is pregnant with her first child amp yes you can freak out via,1,2,1,3,0.3333333333333333,0.3333333333333333,0
234843092,voadeewa,229,95268,143,63035,0,1,1,1,informs connects engages audience pakistan pashtun belt democracy regional politics rights extremism,pres.trump highlighted need us mil win war agnst taliban afghanistan. i hav^trump warns 'fire fury north korea threats do n't stop^miss district columbia usa kara mccullough left reacts crowned new miss usa,1,2,1,3,0.3333333333333333,0.3333333333333333,0
714731566828793857,BloombergQuint,248,94253,983,163357,0,2,1,0,india premier multi-platform business financial news company for bqblue subscription queries email support.com,here transcript interview us president^facebook zuckerberg delivers opening statement day testimony house energy commerce co^trump warns north korea 'fire fury tensions rise,1,2,1,3,0.3333333333333333,0.3333333333333333,0
46686058,Humanists_UK,2796,92644,1266,42482,1,2,0,0,we advance free thinking promote humanism create tolerant society rational thinking kindness prevail registered charity,excellent see open humanists us house representatives we hope midterms s^is europe repeating mistakes fascinating interview threat^yes fact raised interview agree but spec,1,2,1,3,0.3333333333333333,0.3333333333333333,0
288755234,EliotHiggins,2774,92144,3000,233903,1,2,0,0,founder bellingcat working podcasts books surprises,facebook did n't hire george soros^statement cameroon minister communication video allegedly showing cameroonian troops executing^the white house statement reportedly claim technical analysis videos images munition remnants ru,1,2,1,3,0.3333333333333333,0.3333333333333333,0
16910746,HNNAfrica,4,91998,364,106457,1,2,0,0,the great journalist nigeria us trained clinical pharmacist public relations specialist wellnessnigeria truthneverdies,women us house representatives wake nigerian women the activists like did it en^transcripts american morning^hnnpolitics wan na say rooting u we watched u from nigeria last night i 'm member,1,2,1,3,0.3333333333333333,0.3333333333333333,0
40761274,wave105radio,3287,88831,418,74288,0,0,1,2,the south best variety hits home rick jackson breakfast weekdays 0am download new app follow,selena gomez reveals kidney transplant hospital^lifestyle details prince harry meghan markle wedding cake revealed^news details prince harry meghan markle wedding rings revealed,1,2,1,3,0.3333333333333333,0.3333333333333333,0
824157,mathewi,3953,88244,6048,236550,1,2,0,0,i write digital media columbia journalism review i eert stucco veteran love outlaw peru via,sources cond nast shutting vogue wired gq channels snapchat letting go employees it^pontin david carr noted multiple factual errors review wolff murdoch book mark berman alrea^this insane the wsj thinks breach trust release transcript record interview with,1,2,1,3,0.3333333333333333,0.3333333333333333,0
146958450,ragipsoylu,2093,87284,1072,19127,1,2,0,0,turkey correspondent e-mail ragip.soylu.com turkey syria middleeast,in response us house representatives senate letters asked release pastor brunson er^not trump white house press briefings also us state department briefings disappearing in june^white house says trump received briefing cia director gina haspel returned turkey discuss,1,2,1,3,0.3333333333333333,0.3333333333333333,0
24057048,AM980News,826,87189,729,74969,0,0,1,2,london breaking news station non-stop news traffic weather home,here complete list nominees golden globes who rooting^update london acting mayor issues statement hollywood filmmaker london native paul haggis accused o^roger ailes former fox news chairman ceo dead,1,2,1,3,0.3333333333333333,0.3333333333333333,0
975200486,RepThomasMassie,1371,82145,1668,5194,1,2,0,0,u.s. rep ky th district chairman nd amdt caucus political science denier greenest congressman mit sb sm sassywithmassie,actually beginning next congress half us house representatives served yea^my short speech response french president address joint session congress^remember globalist invited republicans address joint session us congress i urged c,1,2,1,3,0.3333333333333333,0.3333333333333333,0
17468528,JarettSays,3795,81984,1785,113352,0,0,1,2,netflix social // dogs best people i know,old mtv shows i wish were streaming sorority life dancelife rich girls sandblast making the video diary ashlee simpson show^just got first look ryan murphy feudbetteandjoan new title amp retro costuming/styling gave life tca17^lena dunham joins american horror story season,1,2,1,3,0.3333333333333333,0.3333333333333333,0
18917594,foxcarolinanews,2922,81876,688,140859,0,1,1,1,the official twitter account fox carolina news,trump nikki haley 'i think terrific woman frankly the first republican presidential debate ...^mariah carey new year eve performance 'they foiled^district columbia crowned miss usa congratulations kara mccullough photo ap images,1,2,1,3,0.3333333333333333,0.3333333333333333,0
33960482,ClancyReports,12773,80044,1677,115422,0,1,1,1,international journalist,in chicago one weekend shooting victims zero arrests^harvey weinstein revelations gwyneth paltrow angelina jolie others say weinstein harassed them^the weinstein company file bankruptcy efforts sell company collapsed,1,2,1,3,0.3333333333333333,0.3333333333333333,0
57248499,7NewsPerth,1663,77342,557,39930,0,1,1,1,first news perth rick ardon susannah carr news,returned field australian soil darwin four months one year ban follo^the beckhams climbed harbour bridge ticking bucket list item trip sydney david beck^after months speculation palace announced prince harry engaged american actress meghan markle,1,2,1,3,0.3333333333333333,0.3333333333333333,0
5743162,SunFoundation,555,76358,4039,22090,1,2,0,0,we national nonpartisan nonprofit organization advocates open government contact info.com,good news us house representatives passed hr5443 today the bill would require e f^the administrator testifying u.s. house energy amp commerce committee^the published transcript record briefing* attributable senior administration off,1,2,1,3,0.3333333333333333,0.3333333333333333,0
17137971,thecwsandiego,1332,75056,1489,58212,0,0,1,2,san diego cw tegna station,kendall jenner majorly shades scott disick over photo with sofia richie his kids^who remembers brady bunch iconic house it sale 1.9 million the original owner^watch luke skywalker returns millennium falcon new 'star wars the last jedi trailer.,1,2,1,3,0.3333333333333333,0.3333333333333333,0
16045956,GroverNorquist,1843,74415,2189,39139,1,2,0,0,president americans tax reform husband father two young ladies,"federal criminal statutes also ,000 criminal regulatory offenses code federal regulations how many name^us house vote today h r death tax repeal act passed yea nay roll call thank congressman brady texas^this obama hoped ***67 voters believe income inequality america problem unit",1,2,1,3,0.3333333333333333,0.3333333333333333,0
283386225,ofirgendelman,813,73039,1009,40374,1,2,0,0,prime minister netanyahu spokesperson arab media,pm netanyahu met w/ delegation us senators led amp met earlier w/ delegation us h^pm netanyahu statement flying brussels i discuss series regional developme^video pm netanyahu interview cbs face nation,1,2,1,3,0.3333333333333333,0.3333333333333333,0
334767152,Tatlermagazine,2019,72851,884,41260,0,0,1,2,est.1709,from sienna miller cindy crawford^things know pippa middleton fianc james matthews^princess eugenie outfit tomorrow royal wedding revealed ...,1,2,1,3,0.3333333333333333,0.3333333333333333,0
24195274,falenkdwb,2555,71226,167,34337,0,0,1,2,dave ryan the morning show dry shampoo* host `` heartbroken '' podcast,nick jonas talks awkward double date brother joe taylor swift selena gomez calls^listen taylor swift new song gorgeous find^get couch ready the schedule freeform nights halloween,1,2,1,3,0.3333333333333333,0.3333333333333333,0
12579352,BillyCorben,3448,69319,971,123091,0,2,1,0,florida man director cocaine cowboys the u broke dawg fight screwball streaming netflix,thanks reply the initial justification use force subject concealed h^longtime miami commission watcher amp gov't accountability guru thinks political^cop arrested hannibal buress disorderly intoxication drank fireball tito vodka kendall,1,2,1,3,0.3333333333333333,0.3333333333333333,0
12837932,csgazette,2826,67250,1195,165290,0,2,1,0,pulitzer prize winner colorado second-largest newspaper delivering news cosprings news tips,wiens formally joins gop race u.s. senate the race gop nomination michael bennet seat u.s ...^in u.s. senate michael bennet says seeks partnerships partisanship^reports brad pitt accused child abuse investigation,1,2,1,3,0.3333333333333333,0.3333333333333333,0
43532023,schemaly,7622,65368,1865,73101,0,1,1,1,author/rage becomes her dir/wmc speech project fighting institutional tolerance online abuse she/her opinions personal political,cbs undoubtedly counting basketball overtime released full transcript interview ... .stormy daniels des^victim survivor after years britney spears jury still ca n't wait talk and^who run world fierce women channel rage kickass music i made spotify playlist inspired by,1,2,1,3,0.3333333333333333,0.3333333333333333,0
21560443,metacritic,391,65019,2289,24013,0,0,1,2,jason dietz marc doyle reviews scores the best critics film music tv games inst,angelina jolie all films considered^modern family cougar town the middle renewed abc another season^modern family cougar town among abc shows renewed season futon critic,1,2,1,3,0.3333333333333333,0.3333333333333333,0
39231672,HPUKParents,5572,63600,784,103449,0,0,1,2,parents we together,jennifer aniston justin theroux 'lovingly split amicable divorce^anna kournikova enrique iglesias 'welcome twins secret^janet jackson shares first adorable photo baby boy eissa al mana,1,2,1,3,0.3333333333333333,0.3333333333333333,0
31115275,RussParrShow,513,61013,416,19025,0,0,1,2,to listen go,paris jackson on reports she has come out as bisexual everyone has known for years this is not news^biracial black american actress engaged britain prince harry^joe jackson laid to rest near michael in private family funeral,1,2,1,3,0.3333333333333333,0.3333333333333333,0
9295212,JimMacMillan,1147,60373,2563,78392,1,2,0,0,fellow don miss better gun violence reporting summit community gun violence /8 philly early bird rates,nice job everyone ..the cnn porn scare fake news spreads^meanwhile chicago year date totals show percent drop murders percent drop shooting victims^one reporter said police rarely see four people shot i aware least six separate,1,2,1,3,0.3333333333333333,0.3333333333333333,0
16318652,SpecNewsATX,7974,57935,1657,97415,1,1,0,1,central texas -hour news weather sports channel follow us facebook,sid miller wins republican nomination texas agriculture commissioner^stage set hofstra university first presidential debate^on heels goldenglobes win jamesfranco denies multiple allegations sexual misconduct made multip,1,2,1,3,0.3333333333333333,0.3333333333333333,0
9581122,mysuncoast,850,55485,640,61144,0,0,1,2,abc7 news leader sarasota/manatee counties news tip -923-6397 news.com share pics/vids us thru,david cassidy fighting memory loss wants 'enjoy life^it offical meghan markle dad wo n't attend royal wedding details^breaking news meghan markle dad wo n't attend royal wedding,1,2,1,3,0.3333333333333333,0.3333333333333333,0
18791654,evanasmith,4426,54763,1571,34834,1,2,0,0,ceo host former editor political junkie passable tennis player fanboy future ex-vegetarian,inbox tyler endorses ag commissioner brutalizes incumbent sid miller s^my one interview december war terror torture running president and^my one interview december war terror torture running president and,1,2,1,3,0.3333333333333333,0.3333333333333333,0
185376376,cspanhistory,3180,54295,667,11160,1,2,0,0,elore people events document american story on c-span every weekend hours history,in became first woman speaker us house representatives she donated artifacts from^we know face know ready face eleanor roosevelt speaking nation^icymi watch full interview looking back vietnamwar years later.,1,2,1,3,0.3333333333333333,0.3333333333333333,0
22419345,annetdonahue,2130,53655,806,79926,0,2,1,0,i wrote book called nobody cares get write bunch places i love i also big fan mall she/her annetdonahue.com,one hundred percent^one hundred percent^dream world star born would titular line bradley cooper says putting american hustle wig,1,2,1,3,0.3333333333333333,0.3333333333333333,0
799250105572491264,dlacalle_IA,14348,53112,1062,33793,1,2,0,0,phd economist author chief economist professor spain advisory married kids,it honour privilege see quoted house representatives us t^us economy is clearly stronger eu japan first quarter gdp monthly data suggests q gdp gro^us international trade deficit goods services decreased 43.1 billion may 46.1 billion ap,1,2,1,3,0.3333333333333333,0.3333333333333333,0
19346335,RAMRANTS,7671,52696,663,140381,0,2,1,0,i know i look like i conservative activist that point staff seen the hill wapo fox news dot com etc opinions,why interview michael avenatti terms he declined appear tucker carlson begs for^if call friend plan publish volatile quote allegedly noted saying in^princess diana coat arms depict non royal entity strangled crown also ench,1,2,1,3,0.3333333333333333,0.3333333333333333,0
28158298,NEWS957,1511,52375,594,118831,0,1,1,1,news talk sports halifax ns all-news mornings afternoons live local talk rick howe sheldon macleod best sports content radio,former u.s. first lady michelle obama deliver speech montreal^david cassidy fighting memory loss wants 'enjoy life news^koko gorilla learned sign language dies,1,2,1,3,0.3333333333333333,0.3333333333333333,0
158691443,KVJShow,14155,52336,205,48769,0,0,1,2,the kevin virginia jason show listen,rumor kim kardashian kanye west secretly planning big wedding it would third marriage kardashian^cardi b shows ellen degeneres how she got pregnant^coldplay dedicates new song houston hurricane harvey victims miami,1,2,1,3,0.3333333333333333,0.3333333333333333,0
15681597,ALT987fm,1428,51432,682,81435,0,0,1,2,la new alternative mornings -782-7987 text altsummercamp,fans react u2 cancels st. louis concert amid police protests^jimmy kimmel officially returning host oscars^the narwhal frappuccino is here it tastes like pink starburst,1,2,1,3,0.3333333333333333,0.3333333333333333,0
2581857086,NewsroomPostCom,177,50015,219,149813,1,2,0,0,we share news views,a bill introduced us house representatives end non defence aid pakistan islamabad p^india going find us president donald trump said media briefing white house in^news flash five dead chartered plane crashes mumbai suburb four passengers including pilots one ped,1,2,1,3,0.3333333333333333,0.3333333333333333,0
28599820,RepDianaDeGette,11033,49768,1581,5213,1,2,0,0,member congress colorado st congressional district senior member energy commerce committee,happening join facebook live trump care harm nation^in weekly democratic address i speak republican efforts erode health care coverage pre exis^in weekly democratic address i speak republican efforts erode health care coverage pre exis,1,2,1,3,0.3333333333333333,0.3333333333333333,0
6597892,sevendaysvt,1917,49721,744,30374,0,2,1,0,we independent vermont newspaper website covering news politics food arts culture,sen. raised nearly 1 million six weeks could transfer money presidential campa^ready kick back book try lives russian centenarians born revolution middlebury prof^view an 'ode hyperobject griots thread bierstadt returns athenaeum,1,2,1,3,0.3333333333333333,0.3333333333333333,0
108352504,KNWAnews,2068,48965,509,80702,0,1,1,1,your source local news northwest arkansas have story email us news.com // instagram knwanews // nwanews,local democrat amp republican recap first presidential debate arpx^rapper travis scott pleads guilty disorderly conduct^grammy nominated dj avicii found dead nwanews nwark,1,2,1,3,0.3333333333333333,0.3333333333333333,0
777960145359867904,jimandsamshow,132,48543,165,11238,0,0,1,2,jim norton sam roberts mornings am et siriusxm channel on demand jimandsam,trump rescinds rules bathrooms transgender students jimandsam^paz de la huerta accuses harvey weinstein raping her twice jimandsam^'kevin can wait kill erinn hayes character leah remini becomes series regular,1,2,1,3,0.3333333333333333,0.3333333333333333,0
21445580,NYDNSports,2542,48533,1129,99442,0,0,1,2,the award-winning sports team like us facebook,drivers stop your protests nascar owners threaten fire drivers kneel national anthem^former tennis star anna kournikova singer enrique iglesias welcome twins report^wwe star big van vader dead,1,2,1,3,0.3333333333333333,0.3333333333333333,0
94741751,jbf1755,2004,48361,666,40994,1,2,0,0,history prof yale cohost eert early us politics a.ham available the field blood violence congress road civil war,you still want keep going here last stab they u.s. passports they dele^the book argue violence caused civil war but i suggest wa^the book argue violence caused civil war but i suggest wa,1,2,1,3,0.3333333333333333,0.3333333333333333,0
214337395,jessesingal,2301,48063,1005,105424,0,2,1,0,writing book contributing writer/former staffer jesse.singal.com email best contacting did read article,clearly is n't becoming men rights activist let alone alt righter as per pa^how weird think year britain currency everyone hauling aroun^now little time passed i noticing weird hell claims critiques atlanti,1,2,1,3,0.3333333333333333,0.3333333333333333,0
45919773,alysiareiner,532,47808,390,15142,1,2,0,0,hero villain you decide fig sunny blahblahblah theatres vod jan,so excited about this the daily show michelle wolf lands her own netflix late night^love thread oneinfour^thank u leive amp i profoundly grateful choice i want ev,1,2,1,3,0.3333333333333333,0.3333333333333333,0
407395156,CaulfieldTim,1977,47606,1029,58090,0,2,1,0,professor health law science policy speaker tv host author is gwyneth paltrow wrong about everything instagram netflix,water wars the cult like efforts get fluoride america drinking supply via^water wars the cult like efforts get fluoride america drinking supply via^gwyneth paltrow goop issues rare response critic via,1,2,1,3,0.3333333333333333,0.3333333333333333,0
40099803,965TDY,6414,45603,381,122128,0,0,1,2,today hits a-10a -7p p-12a hit music news pop culture what philly,have seen jennifer lopez new boyfriend^philly wife eniko parrish eecting first child together couple^mindy kaling pregnant first child,1,2,1,3,0.3333333333333333,0.3333333333333333,0
35511525,amconmag,400,44417,1418,96400,0,2,1,0,tac bimonthly print daily digital magazine measured principled conservatism we believe ideas ideology principles party,what could brand new suburban style house middle old city that may future pos^beijing acquiring u.s. tech quickly one radar tactics funding start ups silicon valley^peter van buren there blue wave next week in fact game house flip flop i predict la,1,2,1,3,0.3333333333333333,0.3333333333333333,0
19202060,EricaEhm,4092,44241,1559,88841,0,0,1,2,storyteller disruptor interviewer host founder ehm co. digital agency founder insta,inspiring quotes amazing female rock stars celebrate international women day^she hostess mostest ideas cheap n cheerful hostess gifts^she hostess mostest ideas cheap n cheerful hostess gifts gt,1,2,1,3,0.3333333333333333,0.3333333333333333,0
512225400,CornellWBrooks,1755,44148,636,17391,0,2,1,0,prof. dir trotter collaborative school vis prof. 18th pres ceo attorney minister activist husband dad,join cbc panel black america war poverty years later :30pm^how many individual tragedies take add systemic catastrophe it early premature concl^what kanye west said about slavery obama mental health his new interviews the new york times,1,2,1,3,0.3333333333333333,0.3333333333333333,0
129879105,MikeEmanuelFox,2675,43317,697,24325,1,2,0,0,new jersey guy westfield exit greek orthodox christian loyal rutgers alum honorary texan years fox news since july,should american people entrust us majority th congress i plan run speaker of^:00am the president delivers statement rose garden open press scotusmarriage^wh :10pm the vice president delivers statement the president also attend open press rose garden fnpolitics,1,2,1,3,0.3333333333333333,0.3333333333333333,0
115464939,CaitrionaPerry,3021,41345,441,10325,1,2,0,0,irish journalist.anchor frmr us corr rt news author '' the tribe the inside story irish power influence us politics in america tales trump country '',facebook ceo mark zuckerberg testify us house representatives energy commerce committee next^clinton campaign says bill take place hillary rally scheduled las vegas wednesday^in new book former white house press secretary sean spicer describes president trump unicorn riding un,1,2,1,3,0.3333333333333333,0.3333333333333333,0
558360059,Zigmanfreud,18931,40642,657,133016,0,2,1,0,senior columnist talk show host 2-time talkers magazine top filmmaker emmy-winner conservative/libertarian georgetown hoya husband/father,uh gop twitter feed touting barack obama economic records that seems really odd ...^so eminem frontrunner democratic presidential nomination likely vp pick an eminem/t^earlier week i wrote i doubted savannah guthrie ability replace matt lauer heavy news intervi,1,2,1,3,0.3333333333333333,0.3333333333333333,0
23745072,DougSaunders,2371,39736,1841,110729,0,2,1,0,richard von weizs cker fellow robert bosch academy berlin international-affairs columnist the globe mail author arrival city books,a guy responds hitler nuremberg speech asking yes solution follows u^grandpa statement president mean make comfortable grab whiteboard^hundal the pentagon papers snowden nsa reveals perfect illustrations manning n't,1,2,1,3,0.3333333333333333,0.3333333333333333,0
805780479496568832,XHNorthAmerica,7,39678,110,8723,0,2,1,0,xinhua news agency north america brings china insight global view north american affairs,according centers disease control prevention suicide percent us last two d^trump touts america first foreign policy attack globalism unga speech face blank stares headshake^also list top viral videos u.s. singer halftime show super bowl li y,1,2,1,3,0.3333333333333333,0.3333333333333333,0
50401467,JoshMankiewicz,2068,39400,427,185909,0,1,1,1,these hips lie,part la gone actually one great parts^gwyneth paltrow angelina jolie others say weinstein harassed them^jason priestley says he punched harvey weinstein face golden globes party via,1,2,1,3,0.3333333333333333,0.3333333333333333,0
16299754,RamCNN,13293,39388,983,89011,1,2,0,0,cnn editorial negotiator-at-large former s. asia correspondent eclectic interests rts may pass throughs likes bookmarks some restrictions apply,melania trump undergoes kidney surgery walter reed medical center^internet archive looking software extract political ads tv archives boing boing via^keeping tradition trump delivered last weekly republican address election,1,2,1,3,0.3333333333333333,0.3333333333333333,0
250492272,igorbobic,997,39008,1237,89551,1,2,0,0,politics reporter huffpost california raised bosnia born former chargers fan igor.bobic.com,pelosi ends hour change speech daca honor house representatives give us chance vote floor^pelosi ends hour change speech daca honor house representatives give us chance vote floor^halperin read huckabee response obama morning joe gov says ridiculous make nuclear deal iran,1,2,1,3,0.3333333333333333,0.3333333333333333,0
13111552,wibw,474,38799,480,81023,1,0,0,2,official twitter account wibw rts follows endorsements,trump failed protect nation akayed ullah posted onto facebook account way monday m^james franco denies sexual misconduct allegations^april giraffe mom captured millions hearts last year live streamed delivery last year i,1,2,1,3,0.3333333333333333,0.3333333333333333,0
75016074,MacOtani,3050,37463,143,163032,0,1,1,1,scribe media social media producer consultant content creator father god st opinions mine swalanyeti rt endorsement macotani.com,trump asking congress mexico pay border wall^sean spicer press conference saturday night live avec kristen stewart via^royal wedding drama father walk meghan aisle,1,2,1,3,0.3333333333333333,0.3333333333333333,0
15825577,julibriskman,1071,32093,125,6057,0,2,1,0,candidate loudoun county board supervisors loco2019 single mom ultramarathoner mba volunteer longmayshewave,yes we did and much result hard work state sen soon to^autocraticcapture^not witch hunt methodical investigation netting major results mafia,1,2,1,3,0.3333333333333333,0.3333333333333333,0
140286364,nielslesniewski,2582,31736,1330,85253,0,2,1,0,stroke survivor senior writer graduate bourbon drinker niels.com,using congressional gallery membership proxy beltway media probably fair n't assume thos^we authoritarian government we 're monarchy saudi foreign minister says^stanton go press conference farragut salt dome tomorrow,1,2,1,3,0.3333333333333333,0.3333333333333333,0
19393349,Paul_Sacca,3772,31344,453,36821,1,0,0,2,don blaspheme,9 members house representatives us senators taken campaign co^star wars director rian johnson reveals who the last jedi is sorta plus new pics of snoke^in case doubt yes everything terrible ... farrah abraham daughter sips 150 apple juice gold,1,2,1,3,0.3333333333333333,0.3333333333333333,0
512174178,USDOTFHWA,141,30499,660,7888,0,2,1,0,the federal highway administration ensures america roads bridges highways continue among safest technologically sound world,did know elsie eaves first woman full member american society civil engineers^on day object lesson road work began replacing gravel road macadam road grounds^on day final section adirondack northway i opened first long distance toll free,1,2,1,3,0.3333333333333333,0.3333333333333333,0
18730191,gbpressgazette,366,30448,696,132079,0,1,1,1,the latest news stories press-gazette media green bay wisconsin,readers see many babies state share name popular names changed tim^steven van zandt member bruce springsteen e street band rock roll hall fame^legendary comedian don rickles dies kidney failure,1,2,1,3,0.3333333333333333,0.3333333333333333,0
14124866,azalben,810,30092,458,61593,0,2,1,0,managing editor formerly tv guide/mtv news/etc buy books sure i podcast,in fact cursedchild far literally focused past versus future there shockingly exciting moments ... 7/^someone white house press briefing ask sarah sanders leave^in general incredible hulk feels like big screen version 70s show clear know th,1,2,1,3,0.3333333333333333,0.3333333333333333,0
162114001,gaylelemmon,12621,28551,977,49378,1,2,0,0,author nyt best sellers ashley war dressmaker khair khana shield ai adjunct sr fellow council for relations all views rts not=endorsement,a us congress delegation led nancy pelosi minority leader united states house representatives arri^from chad bokoharam assailants cut throats people wounded two others kidnapped women^the u.s. saudi relationship right great majority leader said separate interview bloomb,1,2,1,3,0.3333333333333333,0.3333333333333333,0
18036062,SamuelAAdams,1709,28502,879,132007,0,1,1,1,senior editor slate member my typestyle determines dek style,i particularly love complaints lodged paul krugman nyt column^i realize i 'm getting ahead game imagine babies robert pattinson twigs would^justin timberlake announces new album man woods,1,2,1,3,0.3333333333333333,0.3333333333333333,0
291630681,Inkhabar,975,26751,377,192801,0,2,1,0,official handle inkhabar online avatar india news x7 national hindi news channel livetv,moblynching childlifting^with aim avoiding repeat catastrophe india building tsunami early warning system ...^katie holmes dines mystery man,1,2,1,3,0.3333333333333333,0.3333333333333333,0
2159970682,GhesheS,15681,25995,202,17918,0,2,1,0,foreignnewseditor onlineeditor socialmedia breakingnews eert onlineeditor55.com +2348116954632,transcript democratic presidential debate milwaukee^transcript democratic presidential debate milwaukee^george clooney divorce rumors reportedly amal blindsided by gay allegations pic of hubby kissing,1,2,1,3,0.3333333333333333,0.3333333333333333,0
89207192,rosaclemente,1915,25475,502,41396,0,2,1,0,st black puerto rican/afro-latina run vice-president green party bronx born soon dr. clemente organizer lecturer indepndent journalist,according centers disease control prevention percent latinas rape survivors p^according centers disease control prevention percent latinas rape survivors p^sexual misconduct allegations r. kelly spanning years one timeline via,1,2,1,3,0.3333333333333333,0.3333333333333333,0
190738551,1310NEWS,1023,25265,490,103746,1,0,0,2,news news talk sports,nasa denies false story 've paying people smoke marijuana however willing to^prince charles walk meghan markle aisle royal wedding stepping father br^prince charles walk meghan markle aisle royal wedding stepping father br,1,2,1,3,0.3333333333333333,0.3333333333333333,0
11954462,rebel19,1385,24080,561,50782,0,2,1,0,cultural critic editor special projects host rebel critic-at-large surviving white gaze a memoir simon schuster,why ppl tweeting transcript and/or revelations minutes stormy daniels intrvw airs do n't^seems white sean hannity interview roseanne barr fox news hannity via^do n't entirely understand i 'm much trouble finding black writer response chris rock today media oscarssowhite,1,2,1,3,0.3333333333333333,0.3333333333333333,0
30581721,kerrymflynn,4130,23846,664,55324,1,1,0,1,media reporter alum dms open kerry.flynn.com new fandom love,rt news tucked snap earnings story cond nast shutting wired gq vogue channels snapchat cutting^his campaign money gone television ads consultants it gone online advertising sanders digita^question snapchat future post redesign,1,2,1,3,0.3333333333333333,0.3333333333333333,0
27733550,Pfro,5021,23028,586,64272,0,2,1,0,journalist adventurer polymath best-selling author formerly yahoo travel now blocked since,this guy bleeds money every decision ever made office maralago repainting air force one red^just speech cincinnati ohio ... donald john fans republicans yes donald john much^donald trump celebrity apprentice the white house gets new contestant dennis rodman might go singapore.,1,2,1,3,0.3333333333333333,0.3333333333333333,0
20117134,kpfallon,1828,22639,434,25539,0,2,1,0,i senior entertainment reporter also i tired hungry,alison great state tv union thank articulating i think lot of^alison great state tv union thank articulating i think lot of^milo ventimiglia hunter parrish mandy moore love triangle recalls specific confused sex dre,1,2,1,3,0.3333333333333333,0.3333333333333333,0
15470058,NZParliament,544,22114,303,5735,1,2,0,0,official account nz house representatives bringing news info get involved online mon-fri am-5pm rts follows endorsements,visiting members commerce energy committee us house representatives met minister cl^today in the house talks us parliament plan today including business statement th^today in the house lots questions today variety topics plus bidois make his,1,2,1,3,0.3333333333333333,0.3333333333333333,0
87476737,RobynCurnowCNN,2364,22050,455,5316,0,2,1,0,anchor correspondent/ instagram,not funny the statement joke laughable says former u.s. director national intelligence james clappe^cnn says trump comments montenegro/nato sends message putin ok go o^inside melania trump complicated white house life separate schedule different priorities,1,2,1,3,0.3333333333333333,0.3333333333333333,0
1671848557,AyresAlyssa,2124,21560,391,34289,1,2,0,0,org book our time has come how india making its place world fmr state das sa kamala2020,great story wd even greater months ago inside fake news sausage factory this is all about income^in words normal foreign policy speech the problem nothing really normal right now.^i listened imran khan speech here say foreign policy a glimpse pakistan foreign,1,2,1,3,0.3333333333333333,0.3333333333333333,0
1536236778,SheThePeople,714,21487,506,45679,0,1,1,1,the women channel instagram feminist connect.tv fearless womenatwork digitalwomenawards womenwriters,the videos show maedehhojabri year old gymnast dancing followers making bold statement brea^with everyone eyes today let take look timeline relationship^officially engaged traditional ceremony today priyanka chopra home r,1,2,1,3,0.3333333333333333,0.3333333333333333,0
140844060,TheAtlPolitics,1003,21442,1087,13597,1,2,0,0,political news insights analysis staff contributors,during funeral service washington national cathedral former president delivered tribute george h^in interview fox news president dismissed william mcraven hillary clinton fan asked to^however improbable giuliani '12 run may seem new hampshire criticizing mitt romney,1,2,1,3,0.3333333333333333,0.3333333333333333,0
823410689817583616,JamesThompsonKS,2513,20164,209,10780,1,2,0,0,father husband army infantry vet civil rights attorney fmr candidate u.s. house rep. chair ks th congressional district living net cancer,our campaign outperformed every special election country house representatives we be^even though debates ron estes rare sightings bigfoot please stay tuned kwch channel fo^enjoyed lunch today st. john /2 y/o loyd ratts made day said concerned about,1,2,1,3,0.3333333333333333,0.3333333333333333,0
2896213998,sharjah24,318,20071,145,291490,1,2,0,0,sharjah hour digital news website uae emirate sharjah,mohamed bin zayed receives chairman foreign affairs committee us house representatives discus^according centers disease control prevention necrotizing fasciitis serious bacterial infecti^according centers disease control prevention number americans becoming sick mosquito t,1,2,1,3,0.3333333333333333,0.3333333333333333,0
17870319,RFI_En,194,19385,931,44813,0,1,1,1,radio france internationale world news features sport english broadcast daily french capital paris,us/afghanistan/pakistan obama outlines new afpak strategy us president barack obama promised troops ..^motor racing brad pitt wave flag start le mans hour race^serena williams withdraws australian open,1,2,1,3,0.3333333333333333,0.3333333333333333,0
2291870822,RobNelsonABC7,6504,19347,217,12657,0,1,1,1,newjersey native adopted new orleanian devout tar heels fan news anchor/reporter news nyc tune,breaking nyc loses bid host democratic national convention the committee chosen philadelphia^today 's remix happy st birthday julia roberts this big hit iconic role pretty woman^rock legend tom petty dead manager confirms,1,2,1,3,0.3333333333333333,0.3333333333333333,0
60671176,chrismpeters,1642,19056,649,72414,0,2,1,0,nhl draft prospects analyst espn,princeton ryan kuffner one top undrafted ufa ncaa season four points 2g t^probably lot change four years hopefully one changes nhl actually goes back^north dakota making interesting quick second period luke johnson chi scores seconds beautiful shot,1,2,1,3,0.3333333333333333,0.3333333333333333,0
261690223,LifeNationalUAE,879,19004,272,28313,0,0,1,2,the national newspaper features account keeping date latest uae arts lifestyle news journalists,speculation jennifer lawrence blame anna faris chris pratt split^holly bolly ben affleck jennifer garner officially file divorce lady gaga rocks coachella^holly bolly ben affleck jennifer garner officially file divorce lady gaga rocks coachella,1,2,1,3,0.3333333333333333,0.3333333333333333,0
52141198,ScottTaylorTV,8877,18555,359,74865,0,1,1,1,i-team reporter email tips scotttaylor.com,city cleveland the cleveland dnc host committee officially withdrawn bid host democratic national convention^georgina chapman life after harvey weinstein via^koko gorilla knew sign language dies,1,2,1,3,0.3333333333333333,0.3333333333333333,0
1628841380,AdrianaCohen16,792,18403,306,11231,0,2,1,0,proud mom | syndicated columnist radio host adrianacohenshow |national tv commentator lover,excerpts interview w a rosenstein recuse given witness b fbi shoul^icymi my interview w today adrianacohenshow he reacted head scratching endo^a disgrace ashamed staring movie rewrites history amp disrespects am,1,2,1,3,0.3333333333333333,0.3333333333333333,0
313545488,LauraLitvan,1389,18245,646,8939,1,1,0,1,i cover u.s. senate elections bloomberg news washington rts e-mail llitvan.net,should american people entrust us majority th congress i plan run speaker of^just see judge mean receiving due process white house press secretary sar^anthony weiner sentenced months prison charges related sexting minor,1,2,1,3,0.3333333333333333,0.3333333333333333,0
30534749,995thewolfdfw,3660,18101,176,41350,0,0,1,2,texas country playing now -787-1995 fb instagram,says new song turninmeon inspired ... heard song yet^reminds fans that is greatest^announces new album reputation comes nov just time christmas shopping,1,2,1,3,0.3333333333333333,0.3333333333333333,0
18920863,CFOXvan,884,16557,436,53659,0,0,1,2,the world famous cfox,van halen top list perform halftime show super bowl xlvii .. bringing rock back^apparently mario longer plumber according nintendo i guess parkour thing really took^rumour eminem beyonc the weeknd headline coachella would first time year history,1,2,1,3,0.3333333333333333,0.3333333333333333,0
102716915,marybschneider,2238,16416,462,114626,1,2,0,0,i editor years covering politics state government the indianapolis star i remain the twitter lady,rt towards end speech house minority leader nancy pelosi said our basic request honor house representati^i enthralled mccain campaign amp privileged follow nh recognizing^tfw want watch deadline white house turn tv find actually white house useless,1,2,1,3,0.3333333333333333,0.3333333333333333,0
1704646470,mirandayaver,3669,16385,401,68466,0,2,1,0,political scientist us law policy health policy postdoc freelance writer phd cal bear comedian fiend fan,janee project vote brennan center several studies showing whites more^i teaching dred scott next week national federation independent business v. sebelius we^i obsessed carrie fisher though more,1,2,1,3,0.3333333333333333,0.3333333333333333,0
22013225,KDKARadio,803,16278,391,42472,0,1,1,1,official twitter kdka radio listen anytime anywhere app,developing one suspect custody four dead shooting capital gazette newspaper near anna^trump warns north korea of 'fire and fury^former dance moms reality tv star abby lee miller sentenced year day prison,1,2,1,3,0.3333333333333333,0.3333333333333333,0
803061715,RobynElyse,3263,16270,235,26619,0,2,1,0,america sweetheart she/her,phil robertson promises to go into hiding if donald trump loses election stakes higher than ever^phil robertson promises to go into hiding if donald trump loses election stakes higher than ever^obviously vlad the impaler literal vampire reason queen elizabeth s,1,2,1,3,0.3333333333333333,0.3333333333333333,0
4833396790,buzzdotie,1060,15627,111,56774,0,0,1,2,ireland newest brightest website,"brad pitt put vast fortune good use recently offering pay 120,000 watch episode of^harvey weinstein smiles handcuffed charged rape committing criminal sex act sexua^prince charles walk meghan markle aisle royal wedding",1,2,1,3,0.3333333333333333,0.3333333333333333,0
294300657,LyndaObst,3184,15047,218,20535,0,2,1,0,all- media opinion-ator movie/tv maker author hello he lied sports fanatic without portfolio lifelong pot stirrer,macron speech congress rousing rebuke trump foreign policy via viva france^grassley giuliani pardon comments 'i think i would hire new lawyer cnn politics^reese witherspoon mgm bringing the gang back for legally blonde via yay,1,2,1,3,0.3333333333333333,0.3333333333333333,0
14909525,AJCRodneyHo,2152,14625,446,18611,0,0,1,2,i blog tv radio atlanta journal constitution,who american idol season^ryan seacrest kelly ripa new live co host^handicapping dancing with stars season jordan fisher win,1,2,1,3,0.3333333333333333,0.3333333333333333,0
37547375,joefav,468,14609,811,47207,1,2,0,0,yr. vet sports entertainment marketing pr consultant blogger dir industry relations columbia university sports management,inside fake news sausage factory this is all about income^how npr factchecked first presidential debate realtime top live transcript via^im eecting four stops today la first ever nhl nba nfl worldseries o,1,2,1,3,0.3333333333333333,0.3333333333333333,0
179971182,MarlenaTV,3581,14527,297,23136,0,2,1,0,past producer pr emmy award-winner eagle bos ct roots chicago assoc board fmr,referencing ag sessions comments fox news separation families rev james martin tells^father james martin calls comments following law biblical obscene live cnn^wow gwyneth paltrow angelina jolie others say weinstein harassed them,1,2,1,3,0.3333333333333333,0.3333333333333333,0
24196684,ArthurDelaneyHP,1467,14488,568,7510,0,2,1,0,reporter arthur.com,it almost romney campaign thought would effective put obama welfare lots tv ads^i sentimental mitt romney campaign i remember obama giving away free welfare ads^things donald trump adult man might never done life purchased groceries changed diaper suffere,1,2,1,3,0.3333333333333333,0.3333333333333333,0
3010084370,scoopwhoopnews,256,14306,185,31920,0,0,1,2,we tell stories mainstream ignores welcome scoopwhoop new channel unscripted get see non-fiction content,georgeclooney and wife amal alamuddin welcome twins ellaandalexander^is returning as the host for the oscars next year oscars90 academyawards^ben affleck amp jennifer garner officially file divorce,1,2,1,3,0.3333333333333333,0.3333333333333333,0
97030466,DailyFreeman,920,14149,358,146998,1,1,0,1,news organization serving new york hudsonvalley since news.com,akayed ullah posted statement facebook account monday morning attack stating trump you^liam olivia top ny state list popular baby names^youtube sensation april giraffe pregnant,1,2,1,3,0.3333333333333333,0.3333333333333333,0
33235204,bethfertig,2302,14095,671,39359,0,0,1,2,senior reporter covering immigration courts radio former education reporter author night owl u-michigan alum board member string quartet ethel,summary mayor press conference couch lots data trucks amp salt 're n't drive^anthony weiner sentenced months prison sexting minor despite request parole via^anthony weiner sentenced months prison sexting minor must turn nov via,1,2,1,3,0.3333333333333333,0.3333333333333333,0
14661912,kjzzphoenix,2119,14037,521,57802,1,2,0,0,kjzz award-winning listener-supported public radio station member station phoenix arizona for community event info follow,o halleran represents arizona st congressional district named chair blue dog coalition i^part league conservation voters says putting nearly 3 million towards support^the us department agriculture released crop outlook,1,2,1,3,0.3333333333333333,0.3333333333333333,0
4212736883,lifemotto,183,13933,237,19700,0,1,1,1,advice worth sharing world influential people editors time,the surprisingly popular baby names every state^kim kardashian terrified kids grow social media^bradley cooper irina shayk welcome first child,1,2,1,3,0.3333333333333333,0.3333333333333333,0
8475532,sdkstl,3299,13877,968,78001,1,2,0,0,staci d. kramer writes media tech sports life characters sometimes longer trust but verify she former editor paidcontent,our basic request honor house representatives give us chance vote f^jay wallace statement includes mention growing antagonistic tone president press^i love going eat way theater critic loves theater i love going farmers markets i love stickin,1,2,1,3,0.3333333333333333,0.3333333333333333,0
26035764,HeatherWhaley,1628,13653,156,22920,1,2,0,0,stone cold crooked know,america wake this horrific^eliot i call bs slippery slope you look old enough remember brady^give break ask voted against brady bill called gun viol,1,2,1,3,0.3333333333333333,0.3333333333333333,0
29540950,RevChuckCurrie,3018,12898,268,35496,0,2,1,0,clergy director chaplain asst prof dmin chicago mdiv views course,bernie sanders voted brady bill he voted give gun manufacturers unprecedented protections against^except tens thousands denied guns brady bill eired assault weapons ban^in charlottesville aftermath coming attack condemning sides asked staff,1,2,1,3,0.3333333333333333,0.3333333333333333,0
1721619236,courtneyknorris,3255,12585,169,14479,1,2,0,0,reporter producer alum playwright spj| dog mom | rt endorse tipscnorris.org,the cnn porn scare fake news spreads via^statement white house treatment reporters the president aides suggested they^judge barrett woman consideration support sean hannity fox news host close tru,1,2,1,3,0.3333333333333333,0.3333333333333333,0
14261961,GerrickKennedy,1289,12522,439,51760,0,0,1,2,journalist r b scholar `` parental discretion is advised '' working book whitney houston ig,my gosh gt jordan feldstein maroon manager brother jonah hill dies via^lcd soundsystem gavin russom comes out transgender now it time become whole person via^legit squealed gt meryl streep joins big little lies season via,1,2,1,3,0.3333333333333333,0.3333333333333333,0
22774516,sm_sears,1223,12298,512,23412,0,2,1,0,columnist author the indomitable investor vix uncle,minutes interview transcript^fb zuckerberg testimony released house committee energy amp commerce^wirehouse sadly shirtless brad pitt fight club photo creepy sign 're street fighting men,1,2,1,3,0.3333333333333333,0.3333333333333333,0
63314984,thehoya,298,12258,279,14232,1,2,0,0,the hoya founded largest student-run newspaper serving gu d.c. we also include,georgetown university students faculty prominent alumni celebrated president george h.w bush legacy prio^nearly students signed letter urging georgetown university transparent u.s. department e^three listening sessions gather student feedback u.s. department education nov. proposed changes,1,2,1,3,0.3333333333333333,0.3333333333333333,0
113199229,NBChristinaGinn,5455,12112,209,34069,1,2,0,0,executive producer alumni space geek news nerd wife mom pronouns she/her,every journalist america go sleep tonight wake tomorrow morning wondering next but^current state infrastructure america via american society civil engineers^trump i very pro choice via,1,2,1,3,0.3333333333333333,0.3333333333333333,0
112223288,thewolfca,2209,12042,226,49916,0,0,1,2,central ontario best rock follow jocks kearnsy,allegedly assaulted ex girlfriend sued he claims allegations false^rachel mcadams welcomes first child boyfriend jamie linden report^did binge watching holidays what show binge watch ps no spoilers please netflix,1,2,1,3,0.3333333333333333,0.3333333333333333,0
67635390,TVWatchtower,3317,11504,465,164584,0,0,1,2,tiffany vogt senior entertainment reporter member television critics association opinions rt fyi,new tv shows i really enjoyed summer canadian imports burden of truth kristin kreuk/p^first look ryan murphy american horror story via^that right scandal returns tonight new episodes looks like cast coming ready party,1,2,1,3,0.3333333333333333,0.3333333333333333,0
17049057,christinaderosa,1314,11434,229,23486,0,0,1,2,sag-aftra actress series regular seen producer ucla alumni chairwoman,happiest birthday blessings actor wonderful humanitarian richardgere^end after season report e news^congratulations mindy rt is pregnant with her first child report,1,2,1,3,0.3333333333333333,0.3333333333333333,0
1618380482,CollierForTexas,557,11413,121,4328,1,2,0,0,i still fighting bring common sense compassion back texas government,are serious leaders texas sid miller sure one we serious leader^tune watch mike texas democratic convention speech tdp18^lieutenant governor candidate mike collier convention speech huge hit thanks kind words,1,2,1,3,0.3333333333333333,0.3333333333333333,0
70677953,NBC6News,327,11144,282,54304,0,2,1,0,nbc your weather authority,the debate shreveport mayor adrian perkins asked does chief crump absence address biggest issue p^the debate shreveport mayor mayor tyler asked how convince voters rejected on^gwyneth paltrow says ex boyfriend brad pitt threatened harvey weinstein producer committed alleged act,1,2,1,3,0.3333333333333333,0.3333333333333333,0
75112775,theeagledallas,276,11111,120,25205,0,0,1,2,mornings w/ am-10am am-3pm the russ martin show pm-7pm klinger pm-12am,fans react u2 cancels st. louis concert amid police protests^neil diamond retires from touring after parkinson disease diagnosis^billboard music awards nominations see full list of bbmas nominees,1,2,1,3,0.3333333333333333,0.3333333333333333,0
16909907,washpostbiz,355,10730,554,49594,0,2,1,0,news analysis economic policy big business technology state economy,october in live interview concluded cnbc sen. john mccain r ariz. alaska..^a comprehensive investigation voter impersonation finds credible incidents one billion ballots cast^go buy ivanka stuff kellyanne conway said then first daughter fashion sales eloded,1,2,1,3,0.3333333333333333,0.3333333333333333,0
615513,MattDentler,1240,10724,424,35617,1,2,0,0,present father husband movies past sw cinetic blockbuster video employee month,the cnn porn scare fake news spreads the verge^a comprehensive investigation voter impersonation finds credible incidents one billion ballots cast^rip legend,1,2,1,3,0.3333333333333333,0.3333333333333333,0
34608547,iamaniesia,5533,10574,451,97594,0,0,1,2,mygloballife |journalist under40 tedx speaker advisor |memes w/ shade rts views,lawd kevin costner ... bobbybrownbet^'walking dead promotes trio series regular season^tony awards nominations the complete list,1,2,1,3,0.3333333333333333,0.3333333333333333,0
193904358,TenikkaANjax,8816,10540,247,54677,0,0,1,2,cbs47/fox30 anchor wife daughter sister auntie foodie nc native,amp hilarious this cute hereforit yeezy kimye thefarewellseason^from koko gorilla whose sign language abilities changed view animal intelligence dies^man inspired als ice bucket challenge dead,1,2,1,3,0.3333333333333333,0.3333333333333333,0
50426041,mix1073DC,9841,10532,210,47572,0,0,1,2,dc best music mix request ig mix1073dc,are getting divorce say ai n't^clarkson perform together first time open amas this sunday /7^madonna throws gypsy themed th birthday party see all pics,1,2,1,3,0.3333333333333333,0.3333333333333333,0
18338516,Sil_Lai,481,10140,224,21186,0,2,1,0,author black lotus feminist bryn mawr mcbride scholar as seen on/in cnn msnbc essence npr redbook et al cancer sun/scorpio moon she/her,folks tweeting transcript stormydaniels minutes interview lame right c'mon no spoilers^what happening emails manafort tad devine bernie sanders top strategist presidential ca^well quick is pulling its widely mocked ad,1,2,1,3,0.3333333333333333,0.3333333333333333,0
185478824,matthaggman,2218,9619,416,14294,1,2,0,0,husband son brother friend,easy ways support teammatt make sure 're registered vote tell frie^thanks everybody coming first debate campaign season terrific energy incredible cr^i 'm ready excited debate tonight hope see couple hours rsvp link fol,1,2,1,3,0.3333333333333333,0.3333333333333333,0
70991021,VinnyMcAv,3082,9497,260,23719,0,2,1,0,uk correspondent sometimes foreign correspondent instagram standard views disclaimer,wow gone lengths video statement make interesting christmas johnson household^breaking joe biden run president he making statement wh rose garden flanked president obama^also time celine dion vh1 diva awesome riparetha,1,2,1,3,0.3333333333333333,0.3333333333333333,0
16521441,Rock1053,4588,9471,144,24639,0,0,1,2,kioz rock san diego active rock station owned operated iheartmedia inc. rock san diego station plays hard rock,fans react u2 cancels st. louis concert amid police protests^neil diamond retires from touring after parkinson disease diagnosis^heather locklear arrested for battery after attacking a cop and an emt,1,2,1,3,0.3333333333333333,0.3333333333333333,0
2438179831,HeartNENews,5948,9434,115,31110,0,0,1,2,we news team heart north east got story email northeast.news.com call newsroom,david beckham prosecuted speeding charge lawyer successfully fought allegation on^love island star sophie gradon died age she starred series show police say a^reality tv star kylie jenner pregnant first child according us reports heartnews,1,2,1,3,0.3333333333333333,0.3333333333333333,0
22793955,indiacom,344,9321,254,161980,0,1,1,1,follow breaking news around world live cricket updates bollywood gossips travel tips latest trends,baijal noted chief minister quoted selectively letter july erroneously accused o^david beckham face trial over speeding offence^playboy magazine founder hugh hefner cause of death revealed by his widow crystal,1,2,1,3,0.3333333333333333,0.3333333333333333,0
76633633,CapLancashire,1238,9302,110,83928,0,2,1,0,lancashire new hit music station,model featured sexist ad campaign says n't feel degraded lancashire based goodwin smith firm adv^lancashire firm ad campaign banned watchdog they criticised degrading women^david beckham prosecuted speeding charge celebrity lawyer nick freeman nicknamed mr loophole,1,2,1,3,0.3333333333333333,0.3333333333333333,0
368859833,RadioTayNews,896,9209,127,24477,1,1,0,1,radio tay news provides news matters people across dundee perth angus north east fife,former us president george hw bush died age he served st president united states^new stats show strong growth scotland private sector economy last month led steepest monthly rise employment five years^prince harry asks william best man royalwedding2018,1,2,1,3,0.3333333333333333,0.3333333333333333,0
285829499,mommyishdotcom,1152,9088,239,19803,0,1,1,1,a day day look world parenting imperfect,before you name that new baby check out most popular baby names every state^why 're freaking kate middleton pregnancy rumors yet^john stamos eecting first child with fiancee caitlin mchugh,1,2,1,3,0.3333333333333333,0.3333333333333333,0
24545198,laceylett,2608,8960,181,20339,0,1,1,1,nbc affiliate kfor-tv anchor/reporter music craver thrill seeker travel lover health nut opinions email ideas lacey.lett.com,the us centers disease control prevention published survey thursday showing suicide rates increased^prince harry meghan markle wed may cnn^i beg disagree meghan markle calls prince harry 'best husband ever during her first royal enga,1,2,1,3,0.3333333333333333,0.3333333333333333,0
15339223,KTENnews,153,8800,300,38086,0,2,1,0,providing local news updates sherman denison tx ada ardmore ok surrounding tema areas,** watch live now ** president trump delivers remarks national federation independent business^** watch live now ** the first white house press briefing two weeks^nbc taps hoda kotb replace matt lauer today show hodakotb todayshow mattlauer,1,2,1,3,0.3333333333333333,0.3333333333333333,0
20433493,adamlongoTV,5839,8782,274,19525,0,2,1,0,years news anchor/reporter professor ironman maryland alum cho tys mco phx dc,the white house revoked access credentials cnn reporter jim acosta go video :26 elain how^local houston station interview president george w. bush^hoda kotb replace matt lauer nbcs today show,1,2,1,3,0.3333333333333333,0.3333333333333333,0
163283448,yesnodetroit,4013,8153,166,58202,0,0,1,2,founder writer lifestyle blog covering food entertainment travel tech editor day blogger night,reese witherspoon refused to reveal what happens in legally blonde but i think we all know the truth^i saw building i last month ... looks awesome toy story land open walt disney worl^amy schumer marries chef chris fischer surprise wedding after few months dating,1,2,1,3,0.3333333333333333,0.3333333333333333,0
18768802,mpamagmedia,1183,8060,439,20110,0,0,1,2,mpa the association magazine media industry association multi-platform magazine companies,magazine media spotlight wmmedia names most powerful moms including kylie jenner beyonc jennifer lopez s^reveals what it really like pose nude magazine body issue^anna wintour responds mario testino bruce weber sexual misconduct allegations via,1,2,1,3,0.3333333333333333,0.3333333333333333,0
498960989,JTiloveTX,1545,7557,337,8015,1,2,0,0,chief political writer austin american-statesman,seeking unseat sid miller ag commissioner tells texas young democrats this pr^so far questions book fed up our fight save america washington^finally courtesy convention speech entirely devoted leonard cohen anthem including intro and,1,2,1,3,0.3333333333333333,0.3333333333333333,0
2329171057,WTOPEnt,248,7510,64,12732,0,0,1,2,in effort streamline twitter handles sunset account feb. follow entertainment news analysis,what your favorite superbowl halftime show here list memorable^now actually eat breakfast tiffanys^your morning whoa msnbc co hosts joe scarborough mika brzezinski engaged,1,2,1,3,0.3333333333333333,0.3333333333333333,0
2783877936,JBRAgent,1454,7257,53,15209,0,0,1,2,jbr creative management agent writer dramaturg producer life coach cbt coach genderqueer prefer j jbr pronoun he stay connected stay creative,october long way away a star is born with lady gaga amp bradley cooper gets first look cinemacon^creative arts emmys complete list winners^please let called i 'm cher bitch announces broadway musical based life coming .,1,2,1,3,0.3333333333333333,0.3333333333333333,0
14305753,jczamora,2497,7199,408,46317,1,2,0,0,fellow // comms prof. former periodico law medialaw mpa oas scholar,after poor response amp considerable public/inter pressure guatemala published weak statement^univision news transcript the amp democratic debate via demdebate^running transcript third final u.s. presidential debate v/ debate2012 decision2012 transcript,1,2,1,3,0.3333333333333333,0.3333333333333333,0
846354889819279360,thefix,44,7114,205,4926,1,2,0,0,political analysis the washington post scott,"george h.w bush got hear eulogy died his reaction priceless^rudy giuliani revealing interview sean hannity annotated^a russian firm spent 100,000 facebook ads trump spent 0 tv ads first days campaign",1,2,1,3,0.3333333333333333,0.3333333333333333,0
570567264,itsYourGrace,5506,7091,180,136647,0,2,1,0,born talk play radio a.m. p.m. my tweets personal opinion married/2gsd /1adorablerescue flhome/tx,where outrage obama his admin thing according agent interview w^hey dan u think sunday news talk shows discuss fisa info if truly journali^gwen stefani is convinced blake shelton is people sexiest man alive 'i really scored via,1,2,1,3,0.3333333333333333,0.3333333333333333,0
24525474,glindsey1003,5920,6689,88,26827,0,0,1,2,movies music memes radio guy the bull houston,no shame fliporflop game guiltypleasure^jason aldean wife brittany eecting baby no^kelly clarkson host billboard music awards nominees announced,1,2,1,3,0.3333333333333333,0.3333333333333333,0
3288216585,EromoEgbejule,436,6650,118,17977,0,2,1,0,journalist milanista trabadour kubolor,*3 minutes falz literally gave state the union address four days th anniversary democra^thank state union address el presidente thisisnigeria^random fun fact sam onyemelukwe runs trace nigeria used manage kush took us group,1,2,1,3,0.3333333333333333,0.3333333333333333,0
12120112,cweiser,3546,6289,321,28596,0,2,1,0,mobile planner government politics business cincinnati enquirer rts signal agreement,breaking vice president biden coming labor day coney island picnic^fact check speech greater cincinnati monday via^'this mayor held press conference city salt dome ahead first big snow to,1,2,1,3,0.3333333333333333,0.3333333333333333,0
731435059,FoxFilesFNC,934,5739,101,20473,1,1,0,1,fox news series w/ investigations national security crime high-profile interviews newsmakers,family private investigator there evidence seth rich contact wikileaks prior death story wttg^via catherine herridge exclusive house intel gop asked trump declassify key parts carter page fisa applicati^harvey weinstein georgina chapman reach settlement divorce foxnews,1,2,1,3,0.3333333333333333,0.3333333333333333,0
25934849,klawls,1432,5531,227,46154,0,1,1,1,tv critic // co-host // everything i dog,ca n't wait episode takes place four seasons one year life^i hoping i 'm saved view i saw trailers like ince w^attention outlander fans the show return november renewed seasons,1,2,1,3,0.3333333333333333,0.3333333333333333,0
390765919,963bigfm,2747,5460,153,43726,0,2,1,0,big hits real classic rock ygk,the centers disease control prevention telling people dress chickens halloween does^the centers disease control prevention telling people dress chickens halloween does^allegedly assaulted ex girlfriend sued he claims allegations false,1,2,1,3,0.3333333333333333,0.3333333333333333,0
22957861,951wape,349,5063,162,43738,0,0,1,2,jacksonville hit music station the big ape mobile app available apple android stores,lorde disses taylor swift lamar odom feels betrayed khloe kardashian via^daytime emmy awards complete winners list^colin trevorrow back direct jurassic world,1,2,1,3,0.3333333333333333,0.3333333333333333,0
3087530495,greatdaywash,2019,4904,137,17178,1,1,0,1,great day washington best you dc md va tell stories share favorite places things every morning,you 've heard rumors ... snapchat really shutting new year^the popular baby names ranked state^if missed pre black friday sales weekend n't fret find best deals get black,1,2,1,3,0.3333333333333333,0.3333333333333333,0
15980895,newyorkcommuter,4746,4892,124,29983,0,0,1,2,digital/social media guy walt disney television long-time nyc commuter via trains automobiles occasional planes,simon cowell returning 'american idol^jada pinkett smith calls tupac shakur biopic 'deeply hurtful^holiday movies you can binge watch netflix,1,2,1,3,0.3333333333333333,0.3333333333333333,0
285119407,JayWBZ,3585,4760,139,16695,1,1,0,1,assistant director news programming boston news radio,president george hw bush died^washington ap white house vice president joe biden make statement rose garden^the mark twain prize american humor awarded julia louis dreyfus john f kennedy center,1,2,1,3,0.3333333333333333,0.3333333333333333,0
2414850630,SpecNewsSA,848,4707,223,42681,1,1,0,1,san antonio -hour news weather sports channel facebook us,sid miller wins republican nomination texas agriculture commissioner^stage set hofstra university first presidential debate^on heels goldenglobes win jamesfranco denies multiple allegations sexual misconduct made multip,1,2,1,3,0.3333333333333333,0.3333333333333333,0
16817966,kherman,679,4611,219,9085,1,2,0,0,ken herman austin american-statesman columnist,ut/texas tribune poll shows bush sid miller vulnerable runoff^guv candidate lupe valdez shows boots speech texas democratic convention tdp18^u.s. senate candidate beto o'rourke hammers home point speech texas democratic convention fort worth,1,2,1,3,0.3333333333333333,0.3333333333333333,0
236622220,BDormanTV,4357,4569,176,63822,0,1,1,1,x emmy-winning p.m. p.m. anchor| cbs tulsa rt endorsements tips/cell -805-3023,breaking vice president joe biden make statement white house rose garden cnn^simon cowell returning 'american idol abc^'rent set fox next live musical,1,2,1,3,0.3333333333333333,0.3333333333333333,0
20489098,RosieEmery,4343,4506,560,37002,0,0,1,2,press secretary-green party canada author/emmy-award-winning tv producer/singer/songwriter/educator grew sherwood forest grateful tweets,bravo taylorswift standing believes do n't let bullies get courage women^beauty pregnant serenawilliams poses nude vanity fair cover shoot women^ladygaga announces two year las vegas residency music,1,2,1,3,0.3333333333333333,0.3333333333333333,0
60995964,davidalexander5,2428,4452,219,38335,0,1,1,1,longtime news agency journalist correspondent jerusalem new delhi london years washington stints pentagon white house,economists example starting look whether rise called superstar firms contributing to^what covfefe trump tweet unites bewildered nation^bill cosby found guilty sexual assault retrial via,1,2,1,3,0.3333333333333333,0.3333333333333333,0
44162172,Newschannel6Now,159,4432,176,67332,0,0,1,2,newschannel always looking switch breaking news weather alerts email tough questions want answered news.com,icymi beyonce paid tribute saturday historically black colleges universities also reunited des^from clueless to congress clueless actress former fox news commentator stacey dash running congress.^congrats uncle jesse promoted full fledged dad john stamos eecting first child hi,1,2,1,3,0.3333333333333333,0.3333333333333333,0
626005522,LetishaANjax,848,4416,104,20380,0,2,1,0,morning news anchor cbs47 fox30 podcast host producer audacity storytelling letisha bereola find instagram letishatv,measles cases around world surged according new report jointly published wo^measles cases around world surged according new report jointly published wo^defending self made title forbes gave sister kylie lots people upset that.,1,2,1,3,0.3333333333333333,0.3333333333333333,0
25900803,Fox35Danielle,921,4247,65,19242,0,0,1,2,emmy winner hard workin mom tv newsie entrepreneur contributor florida girl cali girl always opinions m/o rt endorsements,go reege at regis philbin still life party via fox35^breaking judge declares mistrial bill cosby sexual assault case jury says hopelessly deadlocked fox35^sir roger moore dead at james bond star dies after battle with cancer via fox35,1,2,1,3,0.3333333333333333,0.3333333333333333,0
57407600,MetroFocus,1403,4246,221,29212,1,2,0,0,news smart conversations in-depth reporting ny nj public television part wnet new york public media provider,undergoes kidney surgery walter reed medical center^ad firm sues stiffing rebranding campaign^give keynote speech nys democratic convention,1,2,1,3,0.3333333333333333,0.3333333333333333,0
206242312,WBKR,280,4233,35,24841,0,0,1,2,the country station wbkr,kizzy smitten blake shelton dancing stars julianne hough kizzy cousin foot loos ...^it back the nights halloween movies freeform/abc family schedule^it back freeform/abc family nights halloween movie schedule we 've got check out~,1,2,1,3,0.3333333333333333,0.3333333333333333,0
38478823,1059TheBrew,2192,4208,117,15901,0,0,1,2,the brew portland rock station.home weekdays -10am,fans react u2 cancels st. louis concert amid police protests^neil diamond retires from touring after parkinson disease diagnosis^hugh hefner cause death has been revealed,1,2,1,3,0.3333333333333333,0.3333333333333333,0
286302235,Inqkriordan,2408,4206,145,15468,1,1,0,1,i philadelphia inquirer columnist serving fresh slices south jersey life phone -815-0975/email kriordan.com,a fake photo emma gonz lez went viral far right parkland teens villains^on morning joe huckabee assails hillary following rules hails ky clerk ...^lady gaga announces year las vegas residency starting via,1,2,1,3,0.3333333333333333,0.3333333333333333,0
25168531,kiss1077,419,4153,66,10199,0,0,1,2,lethbridge best music mix kiss mornings w/ weekdays -10 minutes commercial free kiss start workday,today marks year anniversary premiere dawson creek starring james van der beek katie holmes jo^ed sheeran engaged longtime girlfriend cherry seaborn he posted photo instagram cap^it summer love after two months dating engaged,1,2,1,3,0.3333333333333333,0.3333333333333333,0
22935653,jtuohey21,2744,3845,193,26379,0,2,1,0,senior dme the boston globe i run eress desk audience engagement teams i tweet boston news sports media,whoa criminal inquiry sought hillary clinton use email^mad men indeed trump campaign hired ad firm called draper sterling really via^mit professor neri oxman may moved brad pitt via,1,2,1,3,0.3333333333333333,0.3333333333333333,0
42910967,WKDZ,566,3804,44,49136,1,1,0,1,breaking news weather sports western kentucky -- nab marconi small market u.s. radio station year,the u.s. house representatives passed five year agriculture improvement act wednesday afternoon.^after months heavy rains severe weather across commonwealth governor matt bevin monday submitted eme^so sad 'superman star margot kidder dead,1,2,1,3,0.3333333333333333,0.3333333333333333,0
366423465,CShalby,993,3693,217,13510,1,2,0,0,reporter alum gwu reach colleen.shalby.com,all living presidents living first ladies attended george h.w bush funeral a member team who^long shot democrats taking lesson bernie sanders presidential campaign harnessing hundreds thousan^the republican convention goes charlotte nc reluctant bidder the mayor democrat already vowed,1,2,1,3,0.3333333333333333,0.3333333333333333,0
3067074632,Markphillips995,3145,3433,64,8815,0,0,1,2,afternoon personality the wolf christ follower husband dad marathon runner instagram refusemiddleage,says new song turninmeon inspired heard yet^reminds fans that is greatest^announces new album reputation comes nov. th just time christmas shopping,1,2,1,3,0.3333333333333333,0.3333333333333333,0
22493872,LiteMiami,636,3396,102,30382,0,0,1,2,a south florida radio station releasing particles festiveness love airwaves onto feed,icymi complete list grammy winners^have mercy uncle jesse eecting first child fianc e caitlin mchugh gt^richard simmons hospitalized severe indigestion details,1,2,1,3,0.3333333333333333,0.3333333333333333,0
476766914,AnicaPadilla,721,3337,204,42761,0,2,1,0,swan dive into the future social media manager formerly,fact checking last night democratic presidential candidate debate new hampshire demdebate^breaking vice president joe biden says running president statement rose garden^went prom guy got turned another girl,1,2,1,3,0.3333333333333333,0.3333333333333333,0
80364613,tufayel,1224,3245,82,16764,0,0,1,2,journalist editor professional beyonc stan senior editor culture/entertainment diversity buzzword t.ahmed.com,meghan markle next move suits moving u.k. prince harry engagement says royal eert^hugh hefner cause death revealed^oprah winfrey says god n't told run president,1,2,1,3,0.3333333333333333,0.3333333333333333,0
718827319,bblakelyFox46,2691,3208,118,25325,0,1,1,1,brien blakely -10 anchor/reporter wjzy fox husband father weekend warrior news junkie sports nut general lover wit sarcasm life carpe-diem,john mccain in words^lindsay shookus breakup ben affleck reportedly 'very hard 'she let hit bottom foxnews^'fixer upper stars chip joanna gaines welcome baby no foxnews,1,2,1,3,0.3333333333333333,0.3333333333333333,0
113053644,sesack,1991,3199,153,7873,0,2,1,0,nan,if u.s. russian international steel firm opens pa. shop^clinton references radiation eure bethlehem steel remarks philadelphia^watching u.s. open stop thinking ben stiller agassi skit so,1,2,1,3,0.3333333333333333,0.3333333333333333,0
39044325,marknyt,478,3193,168,33187,0,2,1,0,editor news desk the new york times tweeting interesting stories america,in chicago one weekend shooting victims zero arrests the new york times^philando castile stopped times police was racial profiling^hoda kotb named replace matt lauer co anchor nbc today,1,2,1,3,0.3333333333333333,0.3333333333333333,0
458825200,WANDTVDoug,2423,3160,156,45445,0,0,1,2,doug wolfe wand-tv news nbc x emmy nominated i-team investigative reporter co-host busboom wolfe talk fm five chicago headline club lisagor awards,the real reason jennifer aniston justin theroux split via^actor/comedian/director jerry lewis right dies age pictured comedy partner dean martin^carson daly mom pattie daly caruso dies e news,1,2,1,3,0.3333333333333333,0.3333333333333333,0
47348140,WarmTV,674,3133,139,30737,0,0,1,2,brooke cain tweets happiness warm tv blog the news observer,kathygriffin takes mom bucket list trip meet rickles betty white watch tonight^rt abc renewed modern family cougar town the middle next season^tv tonight the newgirl series ends good and people exit thevoice locals competing,1,2,1,3,0.3333333333333333,0.3333333333333333,0
38043113,LaMonicaPeters,3047,3070,34,8936,0,2,1,0,news reporter ap award winner cbk media mgmt links rts endorsements ucla bruin life,these victims chicago mercy hospital shooting via^shooting near chicago hospital leaves multiple victims via^katie couric opens up about matt lauer firing today show people,1,2,1,3,0.3333333333333333,0.3333333333333333,0
23623038,HispanicArts,1995,2996,109,11954,0,1,1,1,nhfa co-founders jimmy smits braga morales merel julia sanchez previewing future anchored eerience,trump asking congress mexico pay border wall^jennifer lopez stylists secrets behind dressing fashionable diva video do ...^ducktales lin manuel miranda joins disney toon reboot,1,2,1,3,0.3333333333333333,0.3333333333333333,0
1134610819,FOX15Abilene,880,2968,132,18977,0,1,1,1,kxva fox15 news pm pm wake up west texas :30am-8am news weather sports high definition big country,address joint session congress tweeted stateoftheunion joint session speech ever^emmy awards the winners list click list year major winners gt^following manchester bombing cancelled london premiere wonderwoman.,1,2,1,3,0.3333333333333333,0.3333333333333333,0
1246324087,andrewboxford,1265,2966,124,8899,1,2,0,0,reporter formerly get touch andrew dot oxford arizonarepublic dot com,with party taking control us house representatives rep ben ray lujan announces running assista^chevron pro democrat group state victory action league conservation voters top list single biggest d^verde voters got much money round 429k league conservation voters stronger new mexico i,1,2,1,3,0.3333333333333333,0.3333333333333333,0
50174697,PriscillaCasper,1064,2881,47,4101,1,2,0,0,news anchor weekdays noon pm trojan socal native insta,rep. martha mcsally given final speech u.s. house representatives prepares leave office^got chance speak senator john mccain ceremony today he says mccain american her^got chance speak senator john mccain ceremony today he says mccain american her,1,2,1,3,0.3333333333333333,0.3333333333333333,0
48361457,OdeoSirari,708,2817,30,6264,1,0,0,2,ex bbc currently news editor ktn ajea awards winner fairness equals justice peace love send news tips osirari.co.ke,george w. bush senior died^the british royal family confirmed prince charles step meghan markle father walk dow^the british royal family confirmed prince charles step meghan markle father walk dow,1,2,1,3,0.3333333333333333,0.3333333333333333,0
18189151,DCW50,752,2813,121,21938,1,2,0,0,washington dc home of the cw follow us facebook instagram,melania trump undergoes kidney surgery walter reed medical center^trump asking congress mexico pay border wall^trump asking congress mexico pay border wall,1,2,1,3,0.3333333333333333,0.3333333333333333,0
68796392,rusmclaughlin,656,2644,123,31534,0,2,1,0,senior content strategist former troublemaker my opinions represent everyone except sony amwriting scifi,if fox amp friends gave scott pruitt prior sign interview questions topics chance^if fox amp friends gave scott pruitt prior sign interview questions topics chance^i wonder would happen chris pratt zoe saldana followed dave bautista example personally i saw nea,1,2,1,3,0.3333333333333333,0.3333333333333333,0
17601196,SpecNewsILM,295,2572,174,40990,1,2,0,0,spectrum news wilmington coastal north carolina offers best -hour local news coverage plus weather sports favorite features,wilmington regional film commission director returns la tradeshow^spirited debate week infocusnc moderates hometown debate series iopl panel^philando castile stopped times police was racial profiling,1,2,1,3,0.3333333333333333,0.3333333333333333,0
164820327,USCX1954,586,2409,66,19431,0,1,1,1,former fresno bee reporter aka sub sailor uss puffer/ssn usc college desert neff high school grad my tweets views,philando castile stopped times police was racial profiling^morning joe hosts trump bring national enquirer into their feud via^craig mack flava ya ear rapper is dead via,1,2,1,3,0.3333333333333333,0.3333333333333333,0
249738547,NewsEdward,38,2313,87,4706,1,2,0,0,correspondent fox business network tune daily emmy award winning journalist personal twitter,in criminal complaint akayed ullah says criticized president trump facebook post accoun^us amp mexico reach agreement caravan mexican ambassador us says mexico asked un high commission refugees^wynn resorts announces steve wynn resigned ceo chairman board directors statement reads it w,1,2,1,3,0.3333333333333333,0.3333333333333333,0
24682023,Z965WAZY,1661,2058,35,10265,0,1,1,1,lafayette hit music station home purdue football noon in the,eww a new survey us department agriculture reveals americans n't properly wash hand^icymi al roker hoda kotb craig melvin replacing megyn kelly third hour ''the today show '' ~^trending congrats nick jonas priyanka chopra newly engaged shelby765,1,2,1,3,0.3333333333333333,0.3333333333333333,0
29965371,NewsTalkKSGF,345,1953,68,19924,1,1,0,1,springfield news talk fm,two people found dead ohio home early saturday morning following hour standoff^the centers disease control prevention says safe eat romaine lettuce^clueless star former fox news commentator stacey dash running congress california,1,2,1,3,0.3333333333333333,0.3333333333333333,0
1146770712,MrDrew_Taylor,952,1913,64,26741,0,2,1,0,reporter/digital producer sometimes trying find hot meal always trying get right email drew.taylor.com,criminal inquiry sought hillary clinton use email via^like best journalists jonathan gold chronicled community los angeles cared in a^back katie couric said one matt lauer annoying habits used pinch ass lot,1,2,1,3,0.3333333333333333,0.3333333333333333,0
854811342980567041,NSchneiderAZ13,839,1769,28,18639,0,2,1,0,universal health care advocate public education proponent organizer campaign manager/regional field director former house candidate,politics the disliked fake president nominates disliked fake supreme court justice is^one asinine comments i read today movies powerful emo^i heard rumor one screwed california elections,1,2,1,3,0.3333333333333333,0.3333333333333333,0
714629542145605632,KatieScottNews,949,1691,34,7542,0,0,1,2,national online entertainment reporter contact kaitlyn.scott.ca opinions mine company,here look timeline princeharry meghanmarkle relationship royalwedding royalengagement^james franco denies sexual misconduct allegations i whenever i know something wrong needs^here best blackfriday cybermonday sales feel free send way i add th,1,2,1,3,0.3333333333333333,0.3333333333333333,0
1398729764,NewsGuySean,1203,1670,58,9131,0,0,1,2,love san diego kansas city native smu grad love news politics pets food spirited debate rts not endorsements,what covfefe trump tweet unites bewildered nation the new york times^hall fame quarterback troy aikman is engaged capa mooty people^the 'brady bunch house sale 2 million via,1,2,1,3,0.3333333333333333,0.3333333333333333,0
2391506039,mountainpartywv,439,1560,13,3647,1,2,0,0,west virginia progressive ballot-qualified party affiliated,revealed bias towards hillary clinton^meanwhile us energy information administration eia america official source ene^joemanchin,1,2,1,3,0.3333333333333333,0.3333333333333333,0
26338995,BigShotProducR,446,1460,45,10430,0,1,1,1,executive producer at cbs wtkr-tv university of arkansas graduate wps android technology fan follow,are aliens tonight debate sparked release military videos^taylor swift new music video a guide means via^taylor swift announces new album 'reputation via,1,2,1,3,0.3333333333333333,0.3333333333333333,0
17493348,HallErik,3868,1440,46,35213,0,2,1,0,lead sports producer usa today alumnus facebook hallerik7.com,fascinating interviews amp meetthepress week find amp watch^what happened podcast today^excellent story she suggests ann curry replaces matt lauer i vote makes retu,1,2,1,3,0.3333333333333333,0.3333333333333333,0
333201245,SarahGABC27,643,1388,16,17284,1,2,0,0,journalist choice potato lover birth emmy-nominated reporter grad,tears definitely welled jon meacham told story george h.w bush talking robin year o^this veteran served john mccain i 'm going lie i little misty eyed end intervi^this veteran served john mccain i 'm going lie i little misty eyed end intervi,1,2,1,3,0.3333333333333333,0.3333333333333333,0
24057044,Cynthia_Hubert,480,1276,61,9083,0,1,1,1,senior writer sacramento state journalist life stingers up,in chicago one weekend shooting victims zero arrests^morning joe hosts trump bring national enquirer into their feud^koko gorilla known using sign language dies,1,2,1,3,0.3333333333333333,0.3333333333333333,0
174511884,JoeBarracato,1161,1252,46,24643,0,0,1,2,sr. editor feed breaking news political topics social justice issues priors nydailynews nypost abc loves,zzzzzz ... jennifer lopez spent new year eve rumored boyfriend drake las vegas^this poor man ... richard simmons recovering hospitalized severe indigestion^'morning joe co hosts joe scarborough mika brzezinski engaged,1,2,1,3,0.3333333333333333,0.3333333333333333,0
113963505,eightiethmnt,1036,1193,52,7919,1,1,0,1,tech culture writer off-duty film buff bylines,snapchat reportedly shutting local stories team curates via^in interview blender john mccain named abba dancing queen number one favorite song via^the golden globes red carpet pre show live streamed twitter via,1,2,1,3,0.3333333333333333,0.3333333333333333,0
727252686966542336,18thIL,723,1061,26,1858,1,2,0,0,site re-purposed coming weeks,"junius rodriguez democratic candidate u.s. house representatives il please help us spread t^gop situationalethics when u.s. chamber commerce opposes child separation policy national f^only one household four il combined household income greater 100,000 ours working",1,2,1,3,0.3333333333333333,0.3333333333333333,0
317645449,Etomiuc,612,759,40,12836,1,1,0,1,senior correspondent radio free europe/radio liberty inc,denzel washington hit facebook fake news story trump^donald trump sets conditions defending nato allies against attack^australian open serena williams withdraws tournament,1,2,1,3,0.3333333333333333,0.3333333333333333,0
5402612,BBCBreaking,3,40679007,135507,35949,2,1,0,0,breaking news alerts updates bbc for news features analysis follow international uk latest sport news,us house representatives passes budget bill meaning brief government shutdown end working day starts^former us president george hw bush died age son george w bush announced^us new strategy afghanistan us president obama announced new strategy afghanistan pakistan ..,2,1,-1,3,0.6666666666666666,-0.3333333333333333,1
91478624,Forbes,5342,15608279,57614,225465,0,1,2,0,official twitter account homepage world business leaders,rising student loan debt created crisis higher education said u.s. department education secretary be^the world highest paid actresses gal gadot jennifer lawrence reese witherspoon more^the first official photos royal wedding prince harry meghan markle,2,1,-1,3,0.6666666666666666,-0.3333333333333333,1
39364684,chrissyteigen,5048,11755987,11219,68269,0,0,2,1,de-motivational speaker,ok im done i talked kim much i talked nene as a^course taylor swift dating jake gyllenhaal time come another one songs needs material^love rt /2 weeks one sexiest movies ever i 'm pregnant if /over watch sexy,2,1,-1,3,0.6666666666666666,-0.3333333333333333,1
2735591,FastCompany,4195,2337709,44664,228738,2,0,0,1,official twitter feed fast company business media brand inspiring readers think beyond traditional boundaries create future business,snapchat shutting snapcash^snapchat shutting snapcash^legendary comedian don rickles dies,2,1,-1,3,0.6666666666666666,-0.3333333333333333,1
1056850669,airnewsalerts,17,2156603,2607,241642,2,1,0,0,official account news services division all india radio,a bill introduced us house representatives end non defence aid pakistan islamabad provides mil^us house representatives vote tonight immigration bills president donaldtrump reverses migrant family separation policy^niti aayog inks pact us energy information administration step towards setting portal host data related energy sector,2,1,-1,3,0.6666666666666666,-0.3333333333333333,1
6959082,TimesLIVE,920,1210599,2236,272201,0,1,2,0,news features analysis newsroom sunday best reads follow smart news follow,losing one final unfortunate losing three four years careless^lamar odom feels betrayed khlo kardashian^watch angelina jolie breaks silence coping divorce,2,1,-1,3,0.6666666666666666,-0.3333333333333333,1
14464766,thelittleidiot,2042,1191325,10873,15796,0,1,2,0,bald alien adopted son john waters lover alf a.l.f animalrights littlepine impeachtrump vegan since,yes republicans congress voted fifty four times repeal patient protection affordable care act and^just unnecessarily cruel trump rescinds obama rules bathrooms transgender students^yup while wearing makeamericagreatagain hat tweeted abolishing th amendment.. ver,2,1,-1,3,0.6666666666666666,-0.3333333333333333,1
457984599,BreitbartNews,113,1165998,9071,114751,2,1,0,0,news commentary destruction political/media establishment,opinion obama epa engaged land water grab sid miller republican candidate texas agricult ...^miley cyrus vows leave u.s. f king nightmare donald trump gets elected^democrats apologize displaying russian warships convention the democratic national convention committee ...,2,1,-1,3,0.6666666666666666,-0.3333333333333333,1
21059255,tedlieu,9599,1118281,6648,23002,2,1,0,0,husband betty love life father two great kids usaf veteran member congress in order also i take orders vladimir putin,republicans control white house senate house help us take back house representatives^soon house representatives amp i elain american people top scandals of^honored receive environmental champion award amazing people los angeles league conservati,2,1,-1,3,0.6666666666666666,-0.3333333333333333,1
18369812,HIGH_TIMES_Mag,4013,715951,3742,71183,0,0,2,1,the magazine of high society,meghan markle nephew breeding new weed strain for royal wedding^meghan markle nephew breeding new weed strain for royal wedding royalwedding^let talk sex baby and weed course on newest ep high times green room podcast,2,1,-1,3,0.6666666666666666,-0.3333333333333333,1
35697740,DailyMonitor,374,638138,803,131520,0,1,2,0,official twitter handle daily monitor newspaper uganda leading independent daily,hillary clinton donald trump faced first us presidential debate hofstra university new york.^british actor idris elba r arrives fiancee sabrina dhowre l wedding ceremony britain prin^well wishers gather along long walk leading windsor castle ahead wedding carriage procession b,2,1,-1,3,0.6666666666666666,-0.3333333333333333,1
191795989,ewnreporter,825,610614,1735,288660,1,1,1,0,updates eyewitness news team always factual sometimes funny often insightful,breaking former us president george hw bush died age tp^spytapes kennedy it necessary ndpp disclose view whether transcripts form part record^faithmuthambi continues exactly phumla williams i worked could n't pass opportu,2,1,-1,3,0.6666666666666666,-0.3333333333333333,1
17229809,BAFTA,3087,526332,4367,23857,0,0,2,1,supporting celebrating talent film games tv industries check,there really one character every actor the voyage find one character happy birthday richard ge^some legendary practitioners bafta honoured tributes across years julie walters nolan nor^the nominations live streamed watch goldenglobes,2,1,-1,3,0.6666666666666666,-0.3333333333333333,1
117733767,ecr9495,1585,498708,468,70218,0,0,2,1,east coast radio kzn number hit music station whatsapp us connect us facebook,this diva never fall hearts today coketop40 significant chart drop moving down^selenagomez reveals kidney transplant^harry styles amp james corden kiss christmas themed 'carpool karaoke,2,1,-1,3,0.6666666666666666,-0.3333333333333333,1
35773873,boohoo,597,494777,864,40220,0,0,2,1,nothing looks good doyourthing shop got order query tweet cshelp,we 're sad hear currently hospital receiving treatment depression anxiety^huge congratulations fave prince amp engagement who else ca n't wait fairy tal^say it ain t so mac miller reportedly split which team teamariana teammac co,2,1,-1,3,0.6666666666666666,-0.3333333333333333,1
34892616,lorenridinger,1110,464020,2264,96134,0,0,2,1,co-founder vp successful internet beauty fashion entrepreneur socialmedia addict living best life,the kardashians done revealed short haircuts joining many^kim kardashian west wonderful friend bona fide brand mogul around powerhouse ...^shoppable celeb inspired holiday outfits instyle holidayfashion,2,1,-1,3,0.6666666666666666,-0.3333333333333333,1
15178186,guardianmusic,424,406454,6410,42732,0,0,2,1,squashing music characters since,'they foiled mariah carey blames production team new year disaster^i created character called katy perry i want katheryn hudson it scary^rapper nelly criminal investigation sexual assault,2,1,-1,3,0.6666666666666666,-0.3333333333333333,1
19280181,AdibHidayat,1966,403079,345,85732,0,0,2,1,father jemima jasmeena author band logy id id ina,vanity fair responds angelina jolie comments related its september cover story^vanity fair responds angelina jolie comments related its september cover story^beda tahun ... rt he asked said yes david foster katharine mcphee engaged,2,1,-1,3,0.6666666666666666,-0.3333333333333333,1
817386,Techmeme,921,399569,14973,133154,2,1,0,0,the essential tech news moment technology news site record not dummies,downloadable copies russia linked facebook ads broken quarter us house representat^snapchat shutting lens store friday two months launch^coinbase federal election commission filing says formed political action committee pac raise money,2,1,-1,3,0.6666666666666666,-0.3333333333333333,1
11319582,highsnobiety,674,342550,4339,20395,0,1,2,0,daily lifestyle news important stories trends fashion music sneakers design arts,junglepussy goes in fans amp haters state union video^kim kardashian announces kanye west postponed yandhi release date^kim kardashian reveals new 'yandhi release date trust me worth wait,2,1,-1,3,0.6666666666666666,-0.3333333333333333,1
23602600,timeshighered,3492,291672,5808,102966,2,1,0,0,global he news comment features publisher times higher education world university rankings for student advice see,democrats gained critical leverage push back trump administration higher education policies a^democrats gained critical leverage push back trump administration higher education policies a^according report office students research activity uk universities deficit,2,1,-1,3,0.6666666666666666,-0.3333333333333333,1
16639736,Tennessean,4237,283572,2740,189674,0,1,2,0,the place get latest nashville middle tennessee news questions/news tips digital.com,shooting near chicago hospital leaves multiple victims^reports brad pitt accused child abuse investigation^kevin hart confesses cheating pregnant wife,2,1,-1,3,0.6666666666666666,-0.3333333333333333,1
322308666,awesomenesstv,1063,266468,730,39946,0,0,2,1,professional stan community,rt today shout tomorrow dailyreport justin bieber fan arrested at his house^me why life falling apart *realizes mercury retrograde* me^oh snap rumor petedavidson engaged what think today surprise,2,1,-1,3,0.6666666666666666,-0.3333333333333333,1
37161598,HomeboyzRadio,2894,250707,357,514653,0,0,2,1,the home hiphop culture,kevin hart and eniko parrish welcome baby boy^jshbr over million views youtube jshbr just played 'taki taki^kylie jenner covers forbes richest self made women issue thoughts gmitm,2,1,-1,3,0.6666666666666666,-0.3333333333333333,1
27807739,987fm,867,247978,280,32506,0,0,2,1,singapore no.1 hit music station fm hitmusic sgradionetwork,hold up is already married the biebs apparently already married fiancee hailey baldwin^juice selena gomez reportedly entered rehab due stress hospitalised due kidney tran^reasonswhy renewed season more tapes person someone else,2,1,-1,3,0.6666666666666666,-0.3333333333333333,1
809887021,jfreewright,2945,234525,1817,35771,2,1,0,0,part-time actor full-time kook full-time resistance,meanwhile former speaker us house representatives john boehner still new spokesman marijua^also ur tl rts verifiable lies/hoaxes for exmpl malia obama n't eell^flocked eh her speech '08 convention impassioned resonant s,2,1,-1,3,0.6666666666666666,-0.3333333333333333,1
22882864,WBRCnews,1832,188436,1147,194171,0,0,2,1,the official twitter account wbrc fox6 news birmingham al wbrcandme content shared via tweets may republished air online,david cassidy fighting memory loss wants 'enjoy life^channing tatum wife jenna dewan tatum announce split^april giraffe pregnant,2,1,-1,3,0.6666666666666666,-0.3333333333333333,1
18999809,CBCCalgary,1718,180936,1713,91274,0,1,2,0,breaking news features local events eye world around us courtesy staff cbc calgary,rachel notley eected give campaign style speech ndp convention^meghan duchess sussex wears calgary designer dress london event^meghan duchess sussex wears calgary designer dress london event,2,1,-1,3,0.6666666666666666,-0.3333333333333333,1
436141986,SunSport,348,172935,1143,131785,0,0,2,1,exclusive stories breaking news sport desk,kanye west new yeezy basketball shoes could banned nba^kanye west new shoes could banned nba^cristiano ronaldo girlfriend georgina rodriguez gives birth baby girl,2,1,-1,3,0.6666666666666666,-0.3333333333333333,1
19903360,irishexaminer,574,169718,1622,313958,0,0,2,1,want send us story video contact digitaldesk.ie instagram examiner snapchat irishexaminer,check gorgeous pics taylor swift pda packed holiday calvin harris^david beckham fight speeding claim technicality^watch christopher plummer replaces kevin spacey 'all money world trailer,2,1,-1,3,0.6666666666666666,-0.3333333333333333,1
1033347878,JeremyMcLellan,2079,169081,495,29188,1,1,1,0,comedian catholic member muslim cousinhood us ambassador pindi boyz host for bookings contact rtigerman.com,as sergeant arms us house representatives i feel like i supposed somewhere right remember^after last night i really looking forward democratic presidential debates there gon na blood^devastated hear brad pitt angelina jolie going keep sex people official capacity,2,1,-1,3,0.6666666666666666,-0.3333333333333333,1
63362429,7NewsAustralia,155,149892,1084,141544,1,0,1,1,australia news happening follow us news,the house representatives voted tuesday eand terminally ill patients right try eerimental drugs y^brad pitt remarkable interview alcohol abuse led family breakdown news^hugh hefner cause death revealed news,2,1,-1,3,0.6666666666666666,-0.3333333333333333,1
17888589,bevysmith,2437,141175,955,211678,0,0,2,1,no bs i global gal tv radio personality social media racounteur host bevelations siriusxm radio andy channel pagesixtv cohost,cocaine hell drug lamar odom breaks his silence 'everything was my fault via^iaintyourmomma ozzy osbourne sharon osbourne split after more than years marriage^jessica simpson better spin bilking weight watchers big check i 'm glad i lost weight i 'm pregnant againspin beeyatch,2,1,-1,3,0.6666666666666666,-0.3333333333333333,1
12612432,jpodhoretz,1240,140064,3398,180510,0,1,2,0,editor commentary columnist new york post co-founder murdered weekly standard overuser phrase `` blithering idiot '',because i 'm open minded i hereby tweeting terrific column paul krugman^jack nicholson wedding toast about schmidt^one subject consumes every waking thought kelly ripa behavior set live thanks,2,1,-1,3,0.6666666666666666,-0.3333333333333333,1
2707085628,HuffPostIndia,24,132665,757,70080,0,0,2,1,the best internet,justin bieber brought selena gomez jamaica dad wedding^angelina jolie gwyneth paltrow others say harvey weinstein harassed^oscars the complete winner list,2,1,-1,3,0.6666666666666666,-0.3333333333333333,1
50239585,clementine_ford,3170,129416,1005,102317,0,0,2,1,foul mouthed best-selling author fight like a girl 2016 boys will be boys 2018 buy them please,the major plot hole runaway bride n't julia roberts years younger richard gere idea^brad pitt tabloid gossip anon woman says pregnant baby naturally means jenni^there line the handmaid tale addresses moti,2,1,-1,3,0.6666666666666666,-0.3333333333333333,1
226299107,BETNews,402,127396,665,36306,1,1,1,0,the official twitter home news,become massachusetts first black woman elected us house representatives take loo^philando castile stopped times minor traffic charges his family believes police targeting^kylie jenner defends herself against blackface controversy let calm says kim kardashian little ...,2,1,-1,3,0.6666666666666666,-0.3333333333333333,1
811533451,mtlblog,2276,126391,541,41131,0,0,2,1,your montreal culture,meghan markle and prince harry want to raise their royal twins in the united states montreal quebec canada^justin bieber and hailey baldwin may have already gotten married montreal quebec canada^montreal vanessa grimaldi winner of the bachelor has new boyfriend montreal quebec canada,2,1,-1,3,0.6666666666666666,-0.3333333333333333,1
3153723127,TimesofIslambad,882,124474,268,149231,2,1,0,0,pakistan premier news agency million monthly reach across online platforms nationalsecurity foreignpolicy defence,us mid term elections democrats retakes house representatives^us mid term elections democrats retakes house representatives^trade war us takes aim 200 bn chinese goods,2,1,-1,3,0.6666666666666666,-0.3333333333333333,1
76766018,Dexerto,1250,118530,390,82501,1,0,1,1,the world largest esports news site watch documentaries follow also,that amazing ... a candidate us house representatives reignites debate lack wom^rapper returned social media pretty unique rant 'mind control^the final week season fortnite upon us season begin theme here,2,1,-1,3,0.6666666666666666,-0.3333333333333333,1
14276734,JTAnews,810,117378,1606,66966,0,0,2,1,the global jewish news service years read archive glimpse jewish history,face israeli sunglasses brand^billy joel says night wore star david one memorable concerts^geraldo rivera apologizes bette midler alleged groping incident,2,1,-1,3,0.6666666666666666,-0.3333333333333333,1
3621476237,MTVBaseWest,31,113860,123,25399,0,0,2,1,the official account mtv base west africa uniting west africa music taking west african music africa world dstv ch,best reality tv series keeping up with kardashians slayed coming get mtvawards^best reality tv series keeping up with kardashians slayed coming get mtvawards^mtvnews host mtv video music awards gt gt gt,2,1,-1,3,0.6666666666666666,-0.3333333333333333,1
6721522,intifada,2,113661,3026,141975,2,1,0,0,palestine weapon mass instruction,ten democrats us house representatives calling israel immediately stop using deadly force agai^ten democrats us house representatives calling israel immediately stop using deadly force agai^new head office civil rights us department education part trump agenda main purpose,2,1,-1,3,0.6666666666666666,-0.3333333333333333,1
455764741,FreeBeacon,3926,109541,2516,139810,2,1,0,0,news freedom,nyc subway bombing suspect facebook trump you failed protect your nation^nyc subway bombing suspect facebook trump you failed protect your nation^joemanchin it was mistake support hillary clinton,2,1,-1,3,0.6666666666666666,-0.3333333333333333,1
46855751,NRJLebanon,1785,105102,212,17003,0,0,2,1,official page nrj hit music only facebook nrj lebanon fm instagram nrjlebanon,nrjcelebnews kim kardashian kanye west reportedly struggling come name^might getting back together details recent lunch date next popculture^nrjmusicnews apologizes fans cancels remaining dates purpose world tour on,2,1,-1,3,0.6666666666666666,-0.3333333333333333,1
7019512,shannoncoulter,10319,94808,1035,69997,0,1,2,0,founder president grab your wallet alliance `` consumer advocate '' -wapo `` unlikely general '' -nyt currently working end forced arbitration,hey karen boy reagan supported brady bill amp assault weapons ban johnson55^hey know *not* coming nbc the new celebrity apprentice just wanted remind have nice^kara swisher blocked onhere criticizing megyn kelly initial approach featuring,2,1,-1,3,0.6666666666666666,-0.3333333333333333,1
8249832,FresnoBee,738,90445,992,97742,0,0,2,1,the no source news california central san joaquin valley,report suffering severe sleep deprivation hospitalized fresno^wow secretly records phone call posts internet^meet ines rau playboy first ever transgender playmate,2,1,-1,3,0.6666666666666666,-0.3333333333333333,1
21103888,JohnWesleyShipp,759,88417,572,49958,1,1,1,0,actor/musician facebook johnwesleyshipp7.com instagram johnwesleyshippjr,a fake photo emma gonz lez went viral far right parkland teens villains^laura ingraham wrongly says claim support gun background checks debunked punditfact^hillaryclinton came to hellodolly tonight what thrill the crowd stood clapped chanted,2,1,-1,3,0.6666666666666666,-0.3333333333333333,1
24816848,HuffPostMedia,597,85813,3027,54452,0,0,2,1,this account longer updated please follow latest,what words pentagon papers government still classifying^'the larry david piece work insensitive also unfunny^'morning joe co hosts joe scarborough mika brzezinski get engaged,2,1,-1,3,0.6666666666666666,-0.3333333333333333,1
29681648,MOBOAwards,3391,81987,539,63402,0,0,2,1,creating opportunities platforms excellence music film wider cultural arena,karrueche tran granted five year restraining order chris brown^karrueche tran granted five year restraining order chris brown^jay z confirms new album :44 teases new single adnis,2,1,-1,3,0.6666666666666666,-0.3333333333333333,1
2962868158,RepDonBeyer,3462,77213,1317,19171,1,1,1,0,representing northern virginia va8 congress serve co-chair stopgunviolence equalpay,new revelations scott pruitt used epa staff personal chores set financial opportunities his^new revelations scott pruitt used epa staff personal chores set financial opportunities his^millions died protect free world wwi trump bothered honor memories instead h,2,1,-1,3,0.6666666666666666,-0.3333333333333333,1
377949581,NBCLatino,2731,72548,1107,45501,0,1,2,0,elevating conversation around latino news united states part direct questions a,soccer f tbol which one settles debate head worldcup latin^who else got excited watched preview new hit taki taki featuring pr^who else got excited watched preview new hit taki taki featuring pr,2,1,-1,3,0.6666666666666666,-0.3333333333333333,1
165870323,WHOSAY,3886,72415,608,22629,0,0,2,1,creative ideas drive measurable outcomes safely scale whosay weareviacom,dishes split amp current beau^trailer jennifer aniston gets revenge^what binge watch netflix favorite shows holiday,2,1,-1,3,0.6666666666666666,-0.3333333333333333,1
611439177,JoEmbassyUS,531,72117,299,12859,2,1,0,0,official account embassy hashemite kingdom jordan t +1 202 -2861 f +1 202 hotline +1 202 -9522,his majesty king abdullah received us house representatives delegation earlier week headed representa^his majesty king abdullah sunday received us house representatives delegation headed representative dar^a video statement his majesty king abdullah ii john templeton foundation announced his majesty the,2,1,-1,3,0.6666666666666666,-0.3333333333333333,1
3839,davewiner,3869,67363,5527,163724,2,1,0,0,on net since mid-70s started two silicon valley companies wrote wired fellow harvard nyu founder podcasting blogging rss open web,cannibals arrested florida claim eating human flesh cures diabetes depression false^cannibals arrested florida claim eating human flesh cures diabetes depression^political tv ad archive desperately needs rss feed archive blog please,2,1,-1,3,0.6666666666666666,-0.3333333333333333,1
21612122,HotlineJosh,1973,65135,2175,225162,0,1,2,0,politics editor national journal political reporting analysis without fear favor part political tip sheet part bs detector rts endorsements,former naacp president cornell brooks wise comments roseanne saga cnn ...^new against grain democrats need their own celebrity apprentice^new against grain democrats need their own celebrity apprentice,2,1,-1,3,0.6666666666666666,-0.3333333333333333,1
22408312,GioBenitez,2486,63825,656,24571,1,1,1,0,abc news correspondent storyteller elorer husband avocado addict lifelong learner fitness fan kindness warrior,full recusal statement attorney general jeff sessions^from transcript^zee so glad got see,2,1,-1,3,0.6666666666666666,-0.3333333333333333,1
21435658,wane15,371,61392,475,59890,1,0,1,1,fort wayne news weather sports coverage,eight people found dead four locations ohio details^trump warns north korea fire fury nuke threat worsens^golf great tiger woods arrested dui charge florida,2,1,-1,3,0.6666666666666666,-0.3333333333333333,1
52626508,Ranker,1393,55372,738,22642,0,0,2,1,you vote we rank influence rankings real time let voice heard celebrating best pop-culture ranker,yo jenner fire right go amp upvote^yo jenner fire right go amp upvote^the first teaser 'american horror story apocalypse arrived here everything know season f,2,1,-1,3,0.6666666666666666,-0.3333333333333333,1
23808856,ByEliott,1018,55081,1136,17531,0,1,2,0,cnn senior writer actual atlien unconflicted grad priors newspapers lighter side,because part video edited i n't think as i said transcript def record^kanyewest back in uganda talking instagram amp mind control and gifting prez yeezys by^jenner whoa murder photos showed jenner smoking you might research tweeting nasty allegations,2,1,-1,3,0.6666666666666666,-0.3333333333333333,1
27101698,Tom_Winter,2070,54699,1170,19182,2,1,0,0,nbc news correspondent investigations focused police courts corruption cyber security counter-terrorism stories eastern u.s,breaking according federal complaint accused nyc bomber akayed ullah posted facebook trump failed^that independent counsel law currently code federal regulations guides^vice president joe biden make statement :10pm rose garden i 'm guessing wo n't gardening initiative,2,1,-1,3,0.6666666666666666,-0.3333333333333333,1
51840066,RosiePope,1543,53672,511,12723,0,0,2,1,rosie pope days filled mom wife designer educator tv personality all-around guide women pregnancies beyond,kim kanye announced new baby girl name chicago west she arrived monday january th^kim kanye announced new baby girl name chicago west she arrived monday january th^rachel mcadams pregnant first child congratulations star boyfriend jamie linden baby,2,1,-1,3,0.6666666666666666,-0.3333333333333333,1
105411216,BilalKareem,215,52437,624,4040,2,1,0,0,journalist documentary filmmaker most conflicts resolved understanding opposing point view desire create win-win solutions,hi aishe how not sure saw article i encouraged send copy^^somalia the us military confirms killing one soldier injury four soldiers attack by,2,1,-1,3,0.6666666666666666,-0.3333333333333333,1
16211566,MattNavarra,4504,51648,2230,102836,2,1,0,0,social media industry commentator consultant prev self-confessed geek my new podcast,snapchat shutting selfie lens store friday^rt sources cond nast shutting vogue wired gq channels snapchat letting go employees brought in^find much politicians lie political tv ad archive,2,1,-1,3,0.6666666666666666,-0.3333333333333333,1
15249171,tubefilter,396,50048,1371,41199,0,0,2,1,tubefilter trusted widely read source youtube online video news got story email us news.com,appearing 'live with kelly and ryan week^facebook watch unveils trailers launch dates for shows starring catherine zeta jones^the red carpet hubbub upcoming live streamed twitter,2,1,-1,3,0.6666666666666666,-0.3333333333333333,1
529242882,MDPSecretariat,612,49262,74,33710,0,1,2,0,the official twitter account maldivian democratic party mdp mdp largest political party maldives,gulhifaivaa partythakun dhevvaa varah khaassa press briefing eh miadhu 22/7 haveeru :30 ga salt vana fangifilaage room ga onnaane^raees nasheed ge qaanoonee team ge press conference mirey 5/10 :15 gai salt cafe th floor gai onnaane^raees ge qaanoony vakeelunge press conference miadhu 16/7 :30 gai salt th floor gai live tv amp tv,2,1,-1,3,0.6666666666666666,-0.3333333333333333,1
2733320850,ConversationUS,4932,45229,1587,51416,0,1,2,0,a nonprofit news website dedicated democratizing knowledge we bring eertise academics public free read republish,the american society civil engineers gives u.s. infrastructure d+^black america 'bleaching syndrome^black america 'bleaching syndrome,2,1,-1,3,0.6666666666666666,-0.3333333333333333,1
59048747,AaronGleeman,175,41514,1743,45487,0,1,2,0,writer co-host,mntwins traded four impending free agents reliever one season team control whether got en^big congratulations brad pitt angelina jolie getting married now finally sex^imagine much time jennifer aniston justin theroux spend talking working i watched new the leftovers episode,2,1,-1,3,0.6666666666666666,-0.3333333333333333,1
15358891,ErikDavis,972,41238,849,59038,0,1,2,0,managing editor i talk movies i like pizza as seen tv,the first debate alma mater hofstra university also hosted debate last presidential electio^more updates big fall movies coen bros theballadofbusterscruggs astarisborn firstman^i know lot going right busy yelling stuff pause minute,2,1,-1,3,0.6666666666666666,-0.3333333333333333,1
22302678,betsy_klein,3096,40549,1084,30760,1,1,1,0,covering white house team roadtripper human swiss army knife snack ninja storyteller,breaking melania trump undergoes kidney surgery walter reed medical center dc^rust one four remaining original cnn employees says idea many items ha^ivanka trump cover week headline why i disagree dad,2,1,-1,3,0.6666666666666666,-0.3333333333333333,1
252173791,WindyCityLIVE,4926,38224,511,47172,0,0,2,1,chicago daytime talk show hosts watch us p.m. every day windycitylive,the reason kate middleton leaves the hospital right after giving birth makes a lot of sense^brad pitt is absolutely smitten with mit professor neri oxman^kim kardashian shares first photo daughter chicago west,2,1,-1,3,0.6666666666666666,-0.3333333333333333,1
17018765,Info_Activism,997,37233,2211,45834,1,1,1,0,we international ngo engages citizens civil-society organisations elore impacts technology society t/rt/like endorsement,inside fake news sausage factory this is all about income^one four europeans vote populist exclusive research shows populists tripled vote past two d^someone used algorithm paste face 'wonder woman star gal gadot onto porn video implication,2,1,-1,3,0.6666666666666666,-0.3333333333333333,1
2976824781,NRT_English,568,36322,371,63831,2,1,0,0,your source independent news kurdistan region iraq kri,us house representatives approves 290 million peshmerga nrtnews twitterkurds^us house representatives approves 290 million peshmerga nrtnews ndaa iraq^darbaz mohammed we thank int community supported idp situation early without help would catastrophe suliforum,2,1,-1,3,0.6666666666666666,-0.3333333333333333,1
17268437,FanSided,3358,36143,799,144179,0,1,2,0,everyone fan something sports entertainment lifestyle,just time america nd birthday rundown american movie set state un^richard gere turns today favorite gere movie^looks like agree pretty woman richard gere best film officer gentleman trailing fa,2,1,-1,3,0.6666666666666666,-0.3333333333333333,1
19196615,PageSixEmily,4097,34061,391,5549,0,0,2,1,editor page six gossip column new york post opinions email tips esmith.com,page six tv exclusive still haunted strahan kelly ripa demands co host ryan seacrest cancel 'gma appearance^everybody calm robert pattinson dating katy perry dinner group hot la eaterie^jessica simpson i 'm quitting dieting pregnant via,2,1,-1,3,0.6666666666666666,-0.3333333333333333,1
13220962,TheFrisky,14364,33864,1295,47564,0,1,2,0,news life sex entertainment,the most popular baby names a state by state comparison^rt did get secretly married^teresa giudice proves just how broke she really is,2,1,-1,3,0.6666666666666666,-0.3333333333333333,1
361321755,unitehere,11770,30338,539,47704,1,1,1,0,unite here represents workers throughout u.s. canada work hotel gaming food service airport industries,the bill passed us house representatives large margins early including support p^vocal critic walt disney co. since presidential campaign coming anaheim to^now magazine silence breakers testifying california assembly select committee hearing sexual harassmen,2,1,-1,3,0.6666666666666666,-0.3333333333333333,1
15137097,js_newswatch,157,29705,903,133100,0,1,2,0,automatic updates milwaukee journal sentinel breaking news desk **note** this account fed robots,league conservation voters boosts tammy baldwin ad great lakes^kanye west returns twitter 'mind control rant one week hiatus^we ask londoners prince harry meghan markle their responses may surprise,2,1,-1,3,0.6666666666666666,-0.3333333333333333,1
17491445,AndyGlockner,501,27768,1396,281452,1,1,1,0,i play money my kids eat aglockner gmail,to read interesting absurd number criminal activity started it stag^maybe notably one russia croatia denmark final four^also classy brad wanamaker handle qs locker room crushing loss ended pitt career he emotional,2,1,-1,3,0.6666666666666666,-0.3333333333333333,1
29522397,AM570LASports,1363,27622,468,56700,0,0,2,1,home welovela,report kim kardashian is having 'divorce docs drawn up is 'miserable with kanye west read^ryan lochte charge dropped in rio robbery case^here how help victims las vegas mass shooting,2,1,-1,3,0.6666666666666666,-0.3333333333333333,1
171244964,Fandor,3577,27265,745,23160,0,0,2,1,we movie fanatics follow us watch share go deeper movies know love. need hand tweet help,graceful enigmatic often frightening 'dogtooth ingenious dark comedy prix un certain rega^here top films far spoiler alert 'gotti one^sag awards the complete winners list icymi awardsseason,2,1,-1,3,0.6666666666666666,-0.3333333333333333,1
373604983,TheRyanParker,1364,25997,763,59495,0,0,2,1,senior staff writer the hollywood reporter colorado native best twitter feeds member pulitzer breaking-news team,charlie murphy heard responding heckler yelled eddie mr. robinson snl h^asks starwars fans lobby carrie fisher star time episode ix^amy schumer hospitalized horrible kidney infection,2,1,-1,3,0.6666666666666666,-0.3333333333333333,1
17161241,TexasDeptofAg,659,25297,403,4734,2,1,0,0,texas department agriculture txagmatters,today texas department agriculture responded complaint location amp found credit card ski^texas ag commissioner sid miller calls on congress to lift federal restrictions on industrial hemp production hemp^the u.s. department agriculture announced recall wednesday chicken salad shipped texas if recently,2,1,-1,3,0.6666666666666666,-0.3333333333333333,1
293065451,OliviaMesser,11941,24389,563,52159,2,0,0,1,reporter unofficial senior texas correspondent actual texan feminist olivia.messer.com,regulators fine texas ag chief sid miller who case forgot called clinton cunt for sloppy accounting.^here daily reminder sid miller commissioner agriculture great state texas called hillar^pregnant april giraffe calf due march,2,1,-1,3,0.6666666666666666,-0.3333333333333333,1
266031138,TamEdwards6abc,10795,23011,197,11756,0,0,2,1,tam edwards anchors morning news abc philadelphia she writes reads eats travels loves laughs tries,happy news start day meghan markle prince harry announce pregnancy news^taylor swift trouble selling reputation world tour but might dem^poor meghan markle after embarrassing uproar staged photos father attend royal wedding or,2,1,-1,3,0.6666666666666666,-0.3333333333333333,1
2497139118,YahooBeauty,969,22650,223,22271,0,0,2,1,visit latest news beauty style wellness one place,things selena gomez did get body she has now^people are not happy with way vanity fair described margot robbie^lena headey recalls battling postpartum depression while filming 'game thrones,2,1,-1,3,0.6666666666666666,-0.3333333333333333,1
119750943,msncl,360,22603,100,108935,0,0,2,1,twitter oficial de msn chile noticias de chile el mundo deportes entretenimiento m s,protagoniza el viral de la semana^emma stone concibe su vida sin ryan gosling^april giraffe finally gives birth,2,1,-1,3,0.6666666666666666,-0.3333333333333333,1
309354920,WPJohnWagner,4653,22091,934,11230,1,1,1,0,washington post national political breaking news reporter previously white house campaigns sanders clinton md statehouse stanford grad stl native,"in scathing facebook post romney calls trump address nation apologize charlottesville comments^bernie sanders draws ,200 rally north las vegas according campaign^go buy ivanka stuff kellyanne conway said then first daughter fashion sales eloded via",2,1,-1,3,0.6666666666666666,-0.3333333333333333,1
19930164,melaniebromley,1434,21406,129,6318,0,0,2,1,chief news correspondent e news live from e daily pop,here robert pattinson kristen stewart reunite los angeles after spending over two months apart^an even horrifying thought jennifer aniston brad pitt getting back together ... if angelina jolie j^the torment meghanmarkle must going thanks ex best friend jealous family members former spo,2,1,-1,3,0.6666666666666666,-0.3333333333333333,1
855318254,RyanGirdusky,881,20290,270,57903,0,1,2,0,native new yorker sign newsletter national populism,speech national federation independent business finest he campaign mode loves^taylorswift going make heart break song cry world conquer lookwhatyoumademedo^if hillary worth grain salt 'll hold actual press conference take questions,2,1,-1,3,0.6666666666666666,-0.3333333333333333,1
74750907,showbizshelly,1927,20277,175,15874,0,0,2,1,entertainment reporter/ radio tv personality midday host kiss fm catch showbiz shelly showdown :45am weekday mornings fred angi,just ran stedman graham super nice nbd^looks like wedding^ren e zellweger why i disappeared from hollywood,2,1,-1,3,0.6666666666666666,-0.3333333333333333,1
22641165,samanthabarry,2354,20030,522,7409,0,1,2,0,editor-in-chief previously,a powerfully personal piece leive abortion asking one four american women the^a special moment absolute favorites amp honor key moments for^unveiling glamourwoty amp special moment,2,1,-1,3,0.6666666666666666,-0.3333333333333333,1
18209478,ayeletw,1521,19938,698,44973,0,1,2,0,i rarely read notifications on occasion i check direct tweets for wga election related questions ayelet4wga.com,on no los angeles times restaurant critic jonathan gold dies^this sounds lot like conspiracy silence nbc news matt lauer firing nbc theatre accountabilit^fucking animal gwyneth paltrow angelina jolie others say weinstein harassed them,2,1,-1,3,0.6666666666666666,-0.3333333333333333,1
39180746,mathewrodriguez,2749,19424,302,65039,0,0,2,1,afro-boricua/ love laughing // editor fr rep he/they // would wan na know,figured might case ... thing lot asian communities wer^figured might case ... thing lot asian communities wer^lcd soundsystem gavin russom comes out as transgender,2,1,-1,3,0.6666666666666666,-0.3333333333333333,1
3056391,andelman,13844,19336,313,128496,0,1,2,0,est -million+ served rts appreciated subscribe free,meetrickscott beatrickscott rick scott campaign dismissive criticism league conservation voters flor^happy birthday late carrie fisher video interview mark clark author faq^i uploaded new episode brian frazer author hyper chondriac spreaker angeles anger brian,2,1,-1,3,0.6666666666666666,-0.3333333333333333,1
30513520,DanaZkat,1244,19131,193,22394,2,1,0,0,director jordan information bureau embassy jordan washington d.c. -- views eressed rts endorsements jordan,his majesty king abdullah sunday received us house representatives delegation headed representative dar^his majesty king abdullah ii received us house representatives delegation earlier today headed democratic^video jordan press statement stressing urgency establishing ceasefire mechanisms protect c,2,1,-1,3,0.6666666666666666,-0.3333333333333333,1
33137450,NBCSAthletics,507,19105,434,25115,0,1,2,0,your home a baseball nbc sports california,congrats bob melvin th win a becomes one four managers wins a hist^ranking australians named liam liam hendriks liam hemsworth the ones^ranking australians named liam liam hendriks liam hemsworth the ones,2,1,-1,3,0.6666666666666666,-0.3333333333333333,1
291951344,FindLawConsumer,1076,18454,511,45754,0,0,2,1,findlaw consumers making law easy access tweeting interesting entertaining informative legal news our newsletters,bradpitt wins custody battle with ex angelinajolie via reuters^bradpitt wins custody battle with ex angelinajolie via reuters^rapper geazy arrested sweden cocaine possession assault,2,1,-1,3,0.6666666666666666,-0.3333333333333333,1
77281745,swankmotron,861,17201,389,85096,2,1,0,0,storyteller writer repped he/him,there three maces us house representatives the first use inception war^you 'll always know congress session mace us house representatives rests green^this column paul krugman tax burden class warfare must read,2,1,-1,3,0.6666666666666666,-0.3333333333333333,1
78369108,RulesReps,1367,16973,666,3022,2,1,0,0,the official twitter page house rules committee republicans ranking republican,rt /6 the first volume precedents us house representatives available printed copies distri^rt /6 the parliamentarian published first volume new series house precedents this new series follows work^rules committee meet tues. may st :30pm h.r department homeland security appropriations act,2,1,-1,3,0.6666666666666666,-0.3333333333333333,1
73229381,YMCbuzz,6147,16499,481,90407,0,0,2,1,ymc motherhood unfiltered sharing collective eerience motherhood unfiltered,amal george clooney welcome twins clinch perfect life award gt^icymi amal george clooney welcome twins thank god good news internet gt^six side box gift ideas everyone toddler hostess mostest,2,1,-1,3,0.6666666666666666,-0.3333333333333333,1
192281072,Stephen_Stanton,732,16168,293,22600,0,0,2,1,actor monstersatwork rogueone starwarsresistance starwarsrebels theclonewars disneyparks psychonauts2 bioshock autographs,emily blunt dwayne johnson talk smack each other while working out video^icymi tony awards complete winners list via^creative arts emmys the complete list night winners updating live,2,1,-1,3,0.6666666666666666,-0.3333333333333333,1
30732696,DamonaHoffman,9086,16106,194,7602,0,0,2,1,love eert tv host producer writer bet fyi hln access live blacklove the dates mates podcast date lab,hollywood news jennifer lawrence darren aronofsky split is big age difference maybe one reasons^one hottest hollywood news days dakota johnson chris martin dating they make a^hollywood news jennifer lawrence darren aronofsky split is big age difference maybe one reasons,2,1,-1,3,0.6666666666666666,-0.3333333333333333,1
84156655,GizmodoUK,1372,15842,563,88227,0,0,2,1,not ordinary tech site celebrating things geeky hefty doses serious silly talk along way,robert pattinson was almost fired from twilight acting miserable we felt^robert pattinson was almost fired from twilight acting miserable we felt^the biggest winners losers san diego comic con,2,1,-1,3,0.6666666666666666,-0.3333333333333333,1
17505533,oldfilmsflicker,4763,15406,505,191297,0,0,2,1,editorial formerly // alum noirvember ayearwithwomen femalefilmmakerfriday gayoldhollywood opinions mine,this favorite photo richard gere i cubicle work^gwyneth paltrow angelina jolie others say weinstein harassed them^janelle mon e comes pansexual rolling stone cover story,2,1,-1,3,0.6666666666666666,-0.3333333333333333,1
14075981,gelles,1578,15162,328,18461,1,1,1,0,executive producer cnn political special events programming,breaking melania trump undergoes kidney surgery walter reed medical center^in negotiation must willing walk the iran deal like many worst agreements result of^inside melania trump complicated white house life separate schedule different priorities,2,1,-1,3,0.6666666666666666,-0.3333333333333333,1
18493147,GPollowitz,5834,15055,552,163508,0,1,2,0,editor rts complicated politics sarcasticon,i 'm record saying romney release taxes why wo n't obama release transcripts^idea reboot golden girls cindy crawford elizabeth hurley christie brinkley^jealous,2,1,-1,3,0.6666666666666666,-0.3333333333333333,1
21782597,ZackFinkNews,2829,14705,466,27840,0,1,2,0,reporter/journalist zack.fink.com retweets do imply endorsements ... kidding,touts progressive credentials post speech gaggle convention floor^not nothin i think beats brad pitt angelina jolie governor race unless cours^says saw story potentially running governor heard observation,2,1,-1,3,0.6666666666666666,-0.3333333333333333,1
117445602,AtlanticLIVE,473,14325,350,37282,0,1,2,0,we bring journalism life building editorial legacy gather top thinkers leaders engage audiences person online,the aca strongly opposed political polarization forever changed deba^has metoo surprising asks i surprised heartbroken matt lauer allegations says^has metoo surprising asks i surprised heartbroken matt lauer allegations says,2,1,-1,3,0.6666666666666666,-0.3333333333333333,1
16242309,Ohio_Politics,1501,14142,510,49722,0,0,2,1,your source news heated world ohio politics reporters dayton daily news whio tv radio political team,what kanye west said slavery mental health obama new interviews^oprah 'intrigued idea running president friend gayle king says^former ceo roger ailes dead,2,1,-1,3,0.6666666666666666,-0.3333333333333333,1
56641453,alyssavingan,755,13925,227,16155,0,1,2,0,editorial director prev eic com likes fashion snacks music models anna wintour bella hadid ex-emo kid leche stan account,this southern charm reunion one hundred percent going give stress dreams^she also dating cindy crawford son lol^she also dating cindy crawford son lol,2,1,-1,3,0.6666666666666666,-0.3333333333333333,1
431719095,JoshMeyerDC,7102,13254,358,4736,0,1,2,0,national global security muckraker ex la times politico nbc medill author the hunt for ksm ire fan reach joshmeyerdc.com,jonathan gold n't elevate art food writing restaurant criticism helped fractured region un^friends say president pays close attention poll numbers also fixates percent^i one would love someone ask n't done much like obama w. bush dismantle,2,1,-1,3,0.6666666666666666,-0.3333333333333333,1
3165057163,virginradiojkt,192,13111,17,17319,0,0,2,1,facebook youtube,kim kardashian katanya mau dijadiin juri american idol setuju nggak sih call^going bald wdyt^tasya cutie n't ben affleck lindsay shookus totally twinning date,2,1,-1,3,0.6666666666666666,-0.3333333333333333,1
16493612,NineDaves,913,12715,163,58636,0,1,2,0,journalist anxiety-ridden homosexual i write real housewives broadway i suppose could say i thing drama,i 'm glad hillary clinton mentioned orlando shooting worst mass shooting history us debatenight^do think matt lauer drag withdrawals today^nothing ever beat aretha franklin singing c line dion mariah carey gloria estefan shania twain caro,2,1,-1,3,0.6666666666666666,-0.3333333333333333,1
17903666,nyusteinhardt,1347,12624,333,23844,0,1,2,0,the steinhardt school culture education human development,congratulations music education alumna irantzu agirre selected one four summer artist i^remember access hollywood tapes featuring donald trump billy bush our verbatim performance lab elores w^what would happen donald trump billy bush women verbatim performance lab elores what,2,1,-1,3,0.6666666666666666,-0.3333333333333333,1
562967099,RAlexJimenez,694,12121,2089,90856,2,1,0,0,chief strategy officer fintech payments insurtech digitalmarketing innovation bsme mba| fintechmafia views,a bill currently house representatives calls report use crypto financing terrorism la^a bill currently house representatives calls report use crypto financing terrorism la^fintech shaking financial industry transcript via finserv,2,1,-1,3,0.6666666666666666,-0.3333333333333333,1
299917756,live955,16,11946,194,83027,0,0,2,1,sounds like portland -733-0955,jessica simpson shows big baby bump bridesmaid friend wedding^reports morning rihanna might pregnant ... do think would mother ...^ariana grande confirmed to open the billboard music awards,2,1,-1,3,0.6666666666666666,-0.3333333333333333,1
35094823,PaulineChiou,1928,11525,461,5065,1,1,1,0,assistant news director news12 westchester/hudson valley alum contributor biz mentor,melania trump undergoes kidney surgery walter reed medical center^cnn reporting law enforcement combing social media robert bowers pittsburghsynagogue shooting suspect^gwyneth paltrow angelina jolie others say weinstein harassed them via,2,1,-1,3,0.6666666666666666,-0.3333333333333333,1
713041854,CelebrityPageTV,2698,10913,109,7900,0,0,2,1,we positive pop culture late nights set dvr p/pt a/et select local broadcast stations go,w/ amp latest amp jennifergarner amp and^it 's britney b*tch pop icon announced returning second home las vegas her^what going and ready forgive,2,1,-1,3,0.6666666666666666,-0.3333333333333333,1
38860524,DaniellaNBCLA,783,10437,225,8003,0,0,2,1,bilingual time emmy award winning journalist golden mike recipient morning anchor proud mother believer wife prankster super competitive,interviewed new set today season premiering tuesday /4 we laughed lot he^interviewed new set today season premiering tuesday /4 we laughed lot he^royal wedding update prince charles walk meghan markle aisle father revealed attend,2,1,-1,3,0.6666666666666666,-0.3333333333333333,1
15488528,pfikac,6692,10208,447,33510,2,1,0,0,writer/editor former hearst ap,controversial texas ag commish sid miller reportedly eyed trump cabinet post via^texas ag chief sid miller interviewing usda post friday via^re governor debate called texas democratic party adds never sponsored statewide d,2,1,-1,3,0.6666666666666666,-0.3333333333333333,1
6489102,arctictony,2813,10077,525,13355,0,1,2,0,ceo founding ceo history cold places white oceans `` glib non-journalist '' merchants truth jill abramson,if 're engineer likes combine hard technical problems good work democracy 're hiring^i wish i lived world werner herzog famous heidi klum^who famous living german i 10 heidi klum,2,1,-1,3,0.6666666666666666,-0.3333333333333333,1
1219676953,ACEurasia,1260,9953,317,15075,2,1,0,0,official feed eurasia center,planting seeds hope ukraine spring read longest ser^in decisive vote us house representatives passed legislation boost cyber security cooperation^donald trump sets conditions defending nato allies against attack russia,2,1,-1,3,0.6666666666666666,-0.3333333333333333,1
43385867,elliotwagland,2701,9881,217,19865,0,0,2,1,evening standard head pictures avid participant elliot.wagland.co.uk,prince william catherine duchess cambridge prince harry meghan duchess sussex join raf personnel t^prince william catherine duchess cambridge prince harry meghan duchess sussex join raf personnel t^another one harry ex girlfriends actress cressida bonas arrives wedding ceremony prince harry and,2,1,-1,3,0.6666666666666666,-0.3333333333333333,1
24679455,HeartNWNews,1074,9647,150,36184,1,0,1,1,we team heart north west news northwest.news.com,us federal prosecutors charged new york subway bomb suspect akayed ullah saying wrote facebook tr^david beckham n't going prosecuted speeding charge lawyer known mr loophole fought th^details released going make cake prince harry meghan markle wedding,2,1,-1,3,0.6666666666666666,-0.3333333333333333,1
1158271938,ReginaMobley757,8300,9290,123,19144,0,0,2,1,realtor exit realty central,what covfefe trump tweet unites bewildered nation via^gwyneth paltrow angelina jolie others say weinstein harassed them^does this photo prove amelia earhart survived her final flight,2,1,-1,3,0.6666666666666666,-0.3333333333333333,1
3195390296,TheCruzShow,10180,9270,79,17094,0,0,2,1,-7 pm weekday afternoons thecruzshow instagram,thecruzshow called drake amp j.lo might low key hooking more info^kardashian jenner edition we know know it hard pick one but kardashian/jenner your^cardi b khloe kardashian i really feel ... this woman pregnant bring type stress a,2,1,-1,3,0.6666666666666666,-0.3333333333333333,1
154713841,DPD_,1302,8515,245,13703,0,0,2,1,chief television critic variety,noted post reputation world taylor swift wants tinashe and care^i turned last ten minutes good morning america michael strahan interviewing greta gerwig hannah^pauley perrette leaving ncis seasons,2,1,-1,3,0.6666666666666666,-0.3333333333333333,1
16167714,HeartNewsEast,2785,8504,129,42555,0,1,2,0,we newsteam heart east covering news across east england got story get contact east.news.com,a jacket worn harrison ford played han solo star wars eected sell million pounds the^harry styles dua lipa the queen made list best dressed people britain tatler magazine say^the baftas list winners tonight heartnews,2,1,-1,3,0.6666666666666666,-0.3333333333333333,1
58868322,jdubs88,999,8399,431,178453,0,1,2,0,john walters sports illustrated nbc sports newsweek the athletic email trumansparks88.com,in nation million people going come people house senate supreme court decide^admirable buffs solid team gpa trouble w/law chris rock says that 're supposed to do^everyone talk sean spicer bit weekend update almost went totally rails did che disappear,2,1,-1,3,0.6666666666666666,-0.3333333333333333,1
27573842,ChrisJonesTrib,997,8358,298,11067,0,1,2,0,critic/columnist live friday director national critics institute author `` rise up '' bloomsbury phd ohio state,los angeles times restaurant critic jonathan gold dies^no touring hello dolly and betty buckley different kind actress^'hello dolly betty buckley talks dogs dance shoes perils following bette midler,2,1,-1,3,0.6666666666666666,-0.3333333333333333,1
52844843,brandonwenerd,4085,7701,124,42642,0,1,2,0,publisher phish dead philly sports faceplant rock brandon.com,just got couple minutes the admiral noted fan patron symphonic arts waxing favorite clas^shots fired rt want thank neophitou using face next plastic surgery^man ... imagine crazy keeping up with the kardashians x oj simpson reunion episode gon na,2,1,-1,3,0.6666666666666666,-0.3333333333333333,1
45830077,WDHN,370,6874,221,28102,1,1,1,0,wdhn abc affiliate television station dothan al,breaking abc news special report president donald j. trump address nation white house watch live^the patient protection affordable care act under review this week supreme court conclude oral argum ...^channing tatum wife jenna dewan tatum announce split,2,1,-1,3,0.6666666666666666,-0.3333333333333333,1
11659232,roburban,4770,6601,200,32872,1,1,1,0,bloomberg news senior editor global finance/real estate opinions retweets endorsements,tornado carries mobile home miles family inside unharmed^trump tough talk hedge fund taxes does n't match his plan via^what covfefe trump tweet unites bewildered nation,2,1,-1,3,0.6666666666666666,-0.3333333333333333,1
395110569,KoltenParker,3186,6356,292,20270,2,1,0,0,digital executive producer formerly koparker.com,controversial texas ag commish sid miller reportedly eyed trump cabinet post^gop primary race texas ag commissioner far incumbent sid miller blasts challenger trey blocker stumping^to pull largest gotv effort state history turned top architects bernie sanders,2,1,-1,3,0.6666666666666666,-0.3333333333333333,1
68485969,i1067fm,3298,6347,132,20893,0,0,2,1,we nashville new hit music facebook instagram,amp officially official read iblog cori^so justinbieber haileesteinfeld dating rumors ...^did know robert pattinson nearly fired twilight,2,1,-1,3,0.6666666666666666,-0.3333333333333333,1
19980054,digitalspymusic,128,6184,172,29075,0,0,2,1,music news interviews features,taylor swift secretly helped kanye west write 'famous claims kim kardashian west^noel gallagher slams harry styles solo debut 'my cat could 've written minutes^katy perry announces huge uk arena tour dates new album witness 're year away,2,1,-1,3,0.6666666666666666,-0.3333333333333333,1
216989103,danielle_binks,990,6092,210,65749,0,0,2,1,author dimase agent theyearthemapschanged loveozmg june,how about we do n't eect meghan markle amp kate middleton to get along via^i mean ... i also thinking keen i see 'the crown casts diana i n't think th^i going eeriences i 'm going pay attention reality life audacity drea,2,1,-1,3,0.6666666666666666,-0.3333333333333333,1
34822750,JBedellWHIO,991,5543,110,22952,0,0,2,1,emmy award winning reporter anchor postgame host grad just kid akron,about five months royalwedding prince harry meghan markle another royalbaby wa^about five months royalwedding prince harry meghan markle another royalbaby wa^judge declares mistrial billcosby sexual assault case jury says ca n't reach verdict,2,1,-1,3,0.6666666666666666,-0.3333333333333333,1
103972238,Moon_Melanie,1165,5514,209,45032,0,0,2,1,st. louis tv newsanchor harpist these tweets not reflect opinions kplr ktvi,baby girl already crushing brad pitt brad pitt via^jamesbond^tmz 'happy days star erin moran dead,2,1,-1,3,0.6666666666666666,-0.3333333333333333,1
1833570096,FionaOdlum,1813,5407,105,17706,0,1,2,0,i wife daughter bruce olva jill trades cbc saskatchewan truly obsessed dogs working adventures,it noted i took highland dance classes asked return bec^osgoode as non royalty princess and yes called prince harry duke sussex you check i^so dakota johnson melanie griffith like old diva vs new diva caught camera oscarsredcarpet,2,1,-1,3,0.6666666666666666,-0.3333333333333333,1
101627442,RamonaHolloway,756,5218,117,18226,0,0,2,1,co-host matt ramona show link wlnk tv commentator speaker author jesus take fork,a great big world live kelly ryan morning click details meet band c^a great big world live kelly ryan morning click details meet band c^best super bowl halftime show ever beyonc gets vote hear top list the link min superbowl,2,1,-1,3,0.6666666666666666,-0.3333333333333333,1
1340997858,schwartzbCNBC,5824,5134,148,17669,2,1,0,0,political finance reporter dickinson college grad thoughts retweets endorsements,breaking jim jordan statement tells should american people entrust us majority the^fox news shepard smith 'why lie lie lie russia meeting via^new wall street journal/nbc news poll points energized electorate buffeted dynamics bring great uncerta,2,1,-1,3,0.6666666666666666,-0.3333333333333333,1
18064237,SkylarJordan,897,5039,142,43043,2,1,0,0,curious american,nancy pelosi speaking daca floor us house representatives since :00 am morni^ah yes pesky democrats control the white house the supreme court the house representatives^nancy pelosi speaking daca floor us house representatives since :00 am morni,2,1,-1,3,0.6666666666666666,-0.3333333333333333,1
36057442,JasontheScott,2057,4776,87,112780,0,0,2,1,halloween sorcerer nonbinary eic words etc jason.com,gossip miranda lambert blake shelton war 'the voice winner cassadee pope gt countrymusic^julianne hough 'cut footloose 'dancing with stars countrymusic footloose dwts^very pregnant jessica simpson i 'm not having twins video hollywood,2,1,-1,3,0.6666666666666666,-0.3333333333333333,1
3991108098,dt_next,408,4653,730,93661,2,1,0,0,english language newspaper daily thanthi group,on november americans vote members chambers congress us house representatives and^us president wednesday hailed big day republicans party lost control the^rajinikanth paid tribute legendary tamil poet bharathiar occasion th birth anniversary in vi,2,1,-1,3,0.6666666666666666,-0.3333333333333333,1
79563086,N3xtN3ws,2659,4355,195,129337,0,0,2,1,espacio de tecnolog a redessociales gadgets con,solange tweets serious shade grammys beyonc snub^kim kardashian donald trump talked prison reform rails^courtney love warned women harvey weinstein,2,1,-1,3,0.6666666666666666,-0.3333333333333333,1
26535379,ashleyhalsey3rd,1658,4201,194,8819,0,1,2,0,ashley halsey transportation writer washington post triathlon cycling coach,in interview fox news president dismissed william mcraven hillary clinton fan asked to^obama largely commutes sentence chelsea manning u.s. soldier convicted leaking classified information^what covfefe trump tweet unites bewildered nation the new york times,2,1,-1,3,0.6666666666666666,-0.3333333333333333,1
58601435,LynnHulseyDDN,3917,3992,196,12859,1,1,1,0,investigative political reporter-cox media group my stories,inside fake news sausage factory this is all about income via^in cincinnati president said democrats treasonous applauding touted^actir bradpitt pulls girl crushing spanish crowd see video,2,1,-1,3,0.6666666666666666,-0.3333333333333333,1
23557585,CassieFambro,2073,3768,95,48422,0,1,2,0,personal account journo passionate fan perpetually angry texas-bama my eyebrows fake news i,here transcript trump/pence minutes interview really read^may force usa children women celebrate star wars day via^if excited reality show good i like bachelor paradise you let others,2,1,-1,3,0.6666666666666666,-0.3333333333333333,1
305624398,AmySherman1,1185,3104,176,11533,2,1,0,0,staff writer previously,breitbart wrote food stamp enrollment drops four million one month mostly true^facebook users flagged claim trump removing marines from navy hoax the claim ridiculous ra^marco rubio says ted cruz voted defense cuts rand paul budget mostly false,2,1,-1,3,0.6666666666666666,-0.3333333333333333,1
974708869,LATgeoffmohan,1973,3092,147,16330,2,1,0,0,covering agriculture food los angeles times biased toward fact freedom demanding fair contract,"i willing cut deal nasa not real nasa will pay you 18,000 to stay in bed and smoke weed for straight^i willing cut deal nasa not real nasa will pay you 18,000 to stay in bed and smoke weed for straight^i think european union foe trump says ahead putin meeting helsinki via",2,1,-1,3,0.6666666666666666,-0.3333333333333333,1
25466881,desireemurphy_,993,3061,68,13889,0,0,2,1,senior writer/reporter covering dwts /dance/style/music on-air host former gamecocks dancer,wants jennifer garner i 'm read thinks would p^discuss sexy salsa i 'm too sexy amp scores received judge^receive michael jackson video vanguard award mtv video music awards vmas,2,1,-1,3,0.6666666666666666,-0.3333333333333333,1
15981436,nickhautman,1120,2897,109,39121,0,0,2,1,associate editor alum,exclusive tristan thompson gave khlo kardashian firm asked whether wanted watch cheatin^carlson miss ashlee simpson show^surprise mindy kaling pregnant first child,2,1,-1,3,0.6666666666666666,-0.3333333333333333,1
1178558672,JenandTimShow,637,2710,39,19052,0,0,2,1,we morning show mixing pop knowledge humorous one radio show,icymi our top at thread named year sexiestmanalive his girlfriend^the emotional story behind perfor^singer actor david cassidy fight life the one time teen idol critical condition a,2,1,-1,3,0.6666666666666666,-0.3333333333333333,1
133023240,danielmwoodruff,265,1879,114,15070,0,0,2,1,nan,in political news former miss utah trump accuser hold press conference today salt lake city^gwyneth paltrow angelina jolie others say weinstein harassed them^former fox news ceo roger ailes dead,2,1,-1,3,0.6666666666666666,-0.3333333333333333,1
74526631,WQMG971,685,1800,29,13718,0,0,2,1,the best r b old school qmg,billboard music awards nominations see full list via^icymi complete list grammy winners^billboard music awards nominations see full list via,2,1,-1,3,0.6666666666666666,-0.3333333333333333,1
2609177200,kellywynne23,708,1560,18,3711,0,0,2,1,writing creator just cut the bullshit mental health advocate,are hailey baldwin justin bieber married already a timeline rumors surrounding possible nuptials^will bachelorinparadise favorite joe amabile sent home week dancingwiththestars what eect c^a woman charged selena gomez email hack resulted leaked nude photos justin bieber,2,1,-1,3,0.6666666666666666,-0.3333333333333333,1
190491132,averynpowell,714,1192,32,13750,0,1,2,0,morning noon anchor fmr va vt alum pop culture junkie dog dad runner story tips powell.com,my ringtone longest time theme ...^lol like i watching the dark knight lik3 oh katie holmes great^lol like i watching the dark knight lik3 oh katie holmes great,2,1,-1,3,0.6666666666666666,-0.3333333333333333,1
730885745712336897,Joe_Manchik,122,413,90,1634,2,1,0,0,i candidate running united states house representatives ohio th congressional district oh12,| please join line fundraiser tonight facebook :00 pm eastern time :00 p^unfortunately not support u.s. house resolution h.r.676 whic^that response accused stoned chat,2,1,-1,3,0.6666666666666666,-0.3333333333333333,1
